"","age_A","age_B","height_A","height_B","reach_A","reach_B","weight_A","weight_B","won_A","won_B","lost_A","lost_B","kos_A","kos_B","result","AdvAgeA","AdvHeightA","AdvReachA","AdvWgtA","Over35AgeA","Over35AgeB","Over15lbA","Over15lbB","WinPA","WinPB","KoAPer","KoBPer","binaryresult","stance"
"4341",31,31,188,189,198,208,241,246,38,35,5,4,27,29,"win_A",0,-1,-10,-5,0,0,0,0,0.883720930232558,0.897435897435897,0.627906976744186,0.743589743589744,0,"orthodox"
"1116",18,26,168,175,175,193,123,122,3,4,0,9,3,1,"win_A",-8,-7,-18,1,0,0,0,0,1,0.307692307692308,1,0.0769230769230769,0,"orthodox"
"5251",33,38,193,187,189,185,176,177,37,18,6,3,29,6,"win_A",-5,6,4,-1,0,1,0,0,0.86046511627907,0.857142857142857,0.674418604651163,0.285714285714286,0,"orthodox"
"1419",19,26,170,170,178,173,145,141,17,12,1,5,10,9,"win_A",-7,0,5,4,0,0,0,0,0.944444444444444,0.705882352941177,0.555555555555556,0.529411764705882,0,"orthodox"
"2217",26,28,175,178,179,185,135,135,22,14,2,2,18,7,"win_A",-2,-3,-6,0,0,0,0,0,0.916666666666667,0.875,0.75,0.4375,0,"Unknown"
"1885",28,26,170,170,170,170,139,139,24,29,1,2,13,18,"win_A",2,0,0,0,0,0,0,0,0.96,0.935483870967742,0.52,0.580645161290323,0,"orthodox"
"2735",25,25,177,180,191,193,160,160,48,51,2,15,40,32,"win_A",0,-3,-2,0,0,0,0,0,0.96,0.772727272727273,0.8,0.484848484848485,0,"southpaw"
"2845",23,25,178,173,188,175,151,153,22,30,0,4,13,21,"win_A",-2,5,13,-2,0,0,0,0,1,0.882352941176471,0.590909090909091,0.617647058823529,0,"orthodox"
"1788",26,27,198,188,203,193,230,223,12,6,1,0,6,4,"win_A",-1,10,10,7,0,0,0,0,0.923076923076923,1,0.461538461538462,0.666666666666667,0,"orthodox"
"3089",31,34,170,175,170,188,125,126,43,37,2,4,33,26,"win_A",-3,-5,-18,-1,0,0,0,0,0.955555555555556,0.902439024390244,0.733333333333333,0.634146341463415,0,"orthodox"
"5238",38,24,171,171,180,178,139,146,134,78,41,14,29,51,"win_A",14,0,2,-7,1,0,0,0,0.765714285714286,0.847826086956522,0.165714285714286,0.554347826086957,0,"orthodox"
"1385",30,39,191,185,193,201,234,224,29,41,1,21,21,35,"win_A",-9,6,-8,10,0,1,0,0,0.966666666666667,0.661290322580645,0.7,0.564516129032258,0,"orthodox"
"5230",24,34,171,160,173,152,115,115,22,30,1,15,10,20,"win_A",-10,11,21,0,0,0,0,0,0.956521739130435,0.666666666666667,0.434782608695652,0.444444444444444,0,"southpaw"
"3762",21,33,193,179,203,175,194,205,17,52,3,17,15,35,"win_A",-12,14,28,-11,0,0,0,0,0.85,0.753623188405797,0.75,0.507246376811594,0,"Unknown"
"3697",26,23,168,172,169,175,135,135,38,20,3,1,34,11,"win_A",3,-4,-6,0,0,0,0,0,0.926829268292683,0.952380952380952,0.829268292682927,0.523809523809524,0,"orthodox"
"4739",24,23,160,165,168,168,108,108,15,12,0,1,12,9,"win_A",1,-5,0,0,0,0,0,0,1,0.923076923076923,0.8,0.692307692307692,0,"southpaw"
"3652",25,23,161,165,171,169,134,134,25,10,0,3,14,9,"win_A",2,-4,2,0,0,0,0,0,1,0.769230769230769,0.56,0.692307692307692,0,"Unknown"
"1831",31,24,173,178,178,182,145,145,18,7,5,13,5,2,"win_A",7,-5,-4,0,0,0,0,0,0.782608695652174,0.35,0.217391304347826,0.1,0,"orthodox"
"1811",25,33,173,168,178,173,140,139,8,22,0,32,3,10,"win_A",-8,5,5,1,0,0,0,0,1,0.407407407407407,0.375,0.185185185185185,0,"southpaw"
"5082",31,27,160,160,150,178,105,108,55,25,5,12,28,9,"win_A",4,0,-28,-3,0,0,0,0,0.916666666666667,0.675675675675676,0.466666666666667,0.243243243243243,0,"orthodox"
"4747",25,34,171,170,173,170,140,140,32,27,1,4,16,19,"win_A",-9,1,3,0,0,0,0,0,0.96969696969697,0.870967741935484,0.484848484848485,0.612903225806452,0,"orthodox"
"2892",20,33,173,166,183,173,132,130,4,9,0,9,3,2,"win_A",-13,7,10,2,0,0,0,0,1,0.5,0.75,0.111111111111111,0,"orthodox"
"3256",23,26,185,180,193,188,185,190,40,50,4,23,28,15,"win_A",-3,5,5,-5,0,0,0,0,0.909090909090909,0.684931506849315,0.636363636363636,0.205479452054795,0,"orthodox"
"1253",23,29,162,157,162,165,107,106,26,15,3,6,19,11,"win_A",-6,5,-3,1,0,0,0,0,0.896551724137931,0.714285714285714,0.655172413793103,0.523809523809524,0,"orthodox"
"3534",20,26,170,171,174,178,132,132,12,23,6,9,3,14,"win_A",-6,-1,-4,0,0,0,0,0,0.666666666666667,0.71875,0.166666666666667,0.4375,0,"Unknown"
"2016",19,38,170,180,183,183,147,147,15,60,1,57,14,49,"win_A",-19,-10,0,0,0,1,0,0,0.9375,0.512820512820513,0.875,0.418803418803419,0,"orthodox"
"5911",20,22,173,165,175,165,126,122,13,3,0,2,11,1,"win_A",-2,8,10,4,0,0,0,0,1,0.6,0.846153846153846,0.2,0,"orthodox"
"3042",43,27,170,173,168,173,167,166,92,25,10,4,65,10,"win_A",16,-3,-5,1,1,0,0,0,0.901960784313726,0.862068965517241,0.637254901960784,0.344827586206897,0,"orthodox"
"4864",21,25,188,180,198,196,171,171,14,16,0,0,14,15,"win_A",-4,8,2,0,0,0,0,0,1,1,1,0.9375,0,"southpaw"
"3903",37,27,170,174,173,173,151,158,71,34,29,23,25,16,"win_A",10,-4,0,-7,1,0,0,0,0.71,0.596491228070175,0.25,0.280701754385965,0,"Unknown"
"3282",26,21,179,185,182,193,178,184,166,25,31,4,13,19,"win_A",5,-6,-11,-6,0,0,0,0,0.842639593908629,0.862068965517241,0.065989847715736,0.655172413793103,0,"orthodox"
"2293",25,25,173,165,188,178,130,132,14,15,1,8,11,13,"win_A",0,8,10,-2,0,0,0,0,0.933333333333333,0.652173913043478,0.733333333333333,0.565217391304348,0,"orthodox"
"3679",38,35,170,183,180,185,193,190,36,22,8,8,21,16,"win_A",3,-13,-5,3,1,1,0,0,0.818181818181818,0.733333333333333,0.477272727272727,0.533333333333333,0,"orthodox"
"2351",21,20,171,168,171,168,128,128,1,1,0,0,0,0,"win_A",1,3,3,0,0,0,0,0,1,1,0,0,0,"orthodox"
"4511",27,30,170,168,173,165,122,122,24,45,0,5,15,25,"win_A",-3,2,8,0,0,0,0,0,1,0.9,0.625,0.5,0,"orthodox"
"2843",23,25,178,178,188,185,146,147,24,28,0,5,15,9,"win_A",-2,0,3,-1,0,0,0,0,1,0.848484848484849,0.625,0.272727272727273,0,"orthodox"
"3944",30,33,168,163,170,165,115,115,18,35,3,6,9,25,"win_A",-3,5,5,0,0,0,0,0,0.857142857142857,0.853658536585366,0.428571428571429,0.609756097560976,0,"orthodox"
"2510",31,32,196,180,216,188,208,258,10,3,0,14,6,2,"win_A",-1,16,28,-50,0,0,0,1,1,0.176470588235294,0.6,0.117647058823529,0,"orthodox"
"3206",28,32,190,183,206,201,210,210,26,54,0,6,19,52,"win_A",-4,7,5,0,0,0,0,0,1,0.9,0.730769230769231,0.866666666666667,0,"orthodox"
"954",27,21,165,162,169,166,112,112,19,18,1,1,11,6,"win_A",6,3,3,0,0,0,0,0,0.95,0.947368421052632,0.55,0.315789473684211,0,"orthodox"
"4962",29,30,183,182,173,188,154,154,30,29,0,2,22,20,"win_A",-1,1,-15,0,0,0,0,0,1,0.935483870967742,0.733333333333333,0.645161290322581,0,"southpaw"
"3612",28,24,168,168,173,171,135,132,62,54,13,24,24,24,"win_A",4,0,2,3,0,0,0,0,0.826666666666667,0.692307692307692,0.32,0.307692307692308,0,"orthodox"
"707",19,22,174,170,175,173,144,144,8,8,0,3,3,6,"win_A",-3,4,2,0,0,0,0,0,1,0.727272727272727,0.375,0.545454545454545,0,"southpaw"
"2321",19,25,157,163,160,159,108,109,8,0,1,5,6,0,"win_A",-6,-6,1,-1,0,0,0,0,0.888888888888889,0,0.666666666666667,0,0,"orthodox"
"1006",17,28,175,175,178,178,137,138,2,2,0,1,1,2,"win_A",-11,0,0,-1,0,0,0,0,1,0.666666666666667,0.5,0.666666666666667,0,"southpaw"
"5246",38,32,191,191,191,198,210,257,19,24,2,4,14,18,"win_A",6,0,-7,-47,1,0,0,1,0.904761904761905,0.857142857142857,0.666666666666667,0.642857142857143,0,"orthodox"
"4226",28,35,170,170,177,168,120,122,55,27,3,5,35,18,"win_A",-7,0,9,-2,0,1,0,0,0.948275862068966,0.84375,0.603448275862069,0.5625,0,"orthodox"
"3258",24,30,192,156,201,165,148,205,24,84,7,11,11,51,"win_A",-6,36,36,-57,0,0,0,1,0.774193548387097,0.884210526315789,0.354838709677419,0.536842105263158,0,"orthodox"
"4574",34,28,190,196,201,208,234,233,32,14,4,0,19,10,"win_A",6,-6,-7,1,0,0,0,0,0.888888888888889,1,0.527777777777778,0.714285714285714,0,"orthodox"
"2923",28,28,191,179,198,185,212,204,30,46,0,6,24,37,"win_A",0,12,13,8,0,0,0,0,1,0.884615384615385,0.8,0.711538461538462,0,"orthodox"
"3390",26,29,182,185,185,193,205,201,24,27,0,5,21,12,"win_A",-3,-3,-8,4,0,0,0,0,1,0.84375,0.875,0.375,0,"orthodox"
"3368",25,32,185,175,196,183,160,159,32,46,0,3,22,26,"win_A",-7,10,13,1,0,0,0,0,1,0.938775510204082,0.6875,0.530612244897959,0,"southpaw"
"1901",26,31,178,180,183,196,175,175,46,21,2,3,31,20,"win_A",-5,-2,-13,0,0,0,0,0,0.958333333333333,0.875,0.645833333333333,0.833333333333333,0,"orthodox"
"4107",39,31,182,183,191,183,185,198,126,27,19,36,78,19,"win_A",8,-1,8,-13,1,0,0,0,0.868965517241379,0.428571428571429,0.537931034482759,0.301587301587302,0,"orthodox"
"5997",32,34,168,173,168,178,136,135,38,25,3,5,23,22,"win_A",-2,-5,-10,1,0,0,0,0,0.926829268292683,0.833333333333333,0.560975609756098,0.733333333333333,0,"orthodox"
"5201",32,38,191,183,193,196,195,214,20,96,1,8,17,58,"win_A",-6,8,-3,-19,0,1,0,1,0.952380952380952,0.923076923076923,0.80952380952381,0.557692307692308,0,"orthodox"
"5435",30,33,175,168,178,170,130,134,28,25,2,4,23,19,"win_A",-3,7,8,-4,0,0,0,0,0.933333333333333,0.862068965517241,0.766666666666667,0.655172413793103,0,"orthodox"
"267",23,34,180,175,184,188,153,153,14,30,0,6,8,20,"win_A",-11,5,-4,0,0,0,0,0,1,0.833333333333333,0.571428571428571,0.555555555555556,0,"orthodox"
"5369",23,27,175,172,175,173,151,145,34,54,10,10,18,11,"win_A",-4,3,2,6,0,0,0,0,0.772727272727273,0.84375,0.409090909090909,0.171875,0,"orthodox"
"953",22,27,179,175,188,183,140,138,8,16,0,2,7,7,"win_A",-5,4,5,2,0,0,0,0,1,0.888888888888889,0.875,0.388888888888889,0,"orthodox"
"81",29,27,164,170,168,166,128,131,27,25,1,4,14,15,"win_A",2,-6,2,-3,0,0,0,0,0.964285714285714,0.862068965517241,0.5,0.517241379310345,0,"orthodox"
"2769",32,27,170,179,170,182,176,178,123,176,20,35,56,13,"win_A",5,-9,-12,-2,0,0,0,0,0.86013986013986,0.834123222748815,0.391608391608392,0.0616113744075829,0,"orthodox"
"492",26,33,172,172,176,171,122,122,13,24,1,7,4,7,"win_A",-7,0,5,0,0,0,0,0,0.928571428571429,0.774193548387097,0.285714285714286,0.225806451612903,0,"orthodox"
"1545",28,31,187,183,198,191,198,198,17,22,0,5,14,12,"win_A",-3,4,7,0,0,0,0,0,1,0.814814814814815,0.823529411764706,0.444444444444444,0,"orthodox"
"3977",32,29,169,165,178,175,153,154,71,15,5,9,48,4,"win_A",3,4,3,-1,0,0,0,0,0.934210526315789,0.625,0.631578947368421,0.166666666666667,0,"orthodox"
"3179",23,25,178,173,188,175,151,153,22,30,0,4,13,21,"win_A",-2,5,13,-2,0,0,0,0,1,0.882352941176471,0.590909090909091,0.617647058823529,0,"orthodox"
"2711",24,29,178,170,188,168,146,146,27,72,1,1,18,56,"win_A",-5,8,20,0,0,0,0,0,0.964285714285714,0.986301369863014,0.642857142857143,0.767123287671233,0,"orthodox"
"2742",28,25,165,157,165,160,104,105,40,30,0,2,30,19,"win_A",3,8,5,-1,0,0,0,0,1,0.9375,0.75,0.59375,0,"orthodox"
"1950",23,31,178,173,178,178,140,140,19,18,5,1,15,8,"win_A",-8,5,0,0,0,0,0,0,0.791666666666667,0.947368421052632,0.625,0.421052631578947,0,"orthodox"
"4761",31,27,177,178,185,189,160,159,23,19,3,0,19,11,"win_A",4,-1,-4,1,0,0,0,0,0.884615384615385,1,0.730769230769231,0.578947368421053,0,"southpaw"
"4626",28,40,185,188,191,203,196,191,21,40,1,12,11,28,"win_A",-12,-3,-12,5,0,1,0,0,0.954545454545455,0.769230769230769,0.5,0.538461538461538,0,"orthodox"
"2763",23,27,170,162,170,163,125,126,19,20,1,5,14,11,"win_A",-4,8,7,-1,0,0,0,0,0.95,0.8,0.7,0.44,0,"orthodox"
"5926",33,36,175,173,191,183,159,160,30,12,6,35,16,4,"win_A",-3,2,8,-1,0,1,0,0,0.833333333333333,0.25531914893617,0.444444444444444,0.0851063829787234,0,"orthodox"
"1917",25,23,173,171,173,173,135,135,19,1,2,0,10,1,"win_A",2,2,0,0,0,0,0,0,0.904761904761905,1,0.476190476190476,1,0,"southpaw"
"403",26,30,169,170,175,173,124,124,36,29,6,19,30,20,"win_A",-4,-1,2,0,0,0,0,0,0.857142857142857,0.604166666666667,0.714285714285714,0.416666666666667,0,"orthodox"
"4161",31,23,168,170,178,170,147,148,101,83,24,16,60,40,"win_A",8,-2,8,-1,0,0,0,0,0.808,0.838383838383838,0.48,0.404040404040404,0,"orthodox"
"875",25,23,175,178,177,180,142,141,11,6,0,8,9,2,"win_A",2,-3,-3,1,0,0,0,0,1,0.428571428571429,0.818181818181818,0.142857142857143,0,"orthodox"
"3393",34,35,164,163,168,168,126,126,63,41,7,9,48,27,"win_A",-1,1,0,0,0,1,0,0,0.9,0.82,0.685714285714286,0.54,0,"orthodox"
"166",24,24,168,165,175,169,126,126,22,28,2,6,14,20,"win_A",0,3,6,0,0,0,0,0,0.916666666666667,0.823529411764706,0.583333333333333,0.588235294117647,0,"orthodox"
"1533",21,22,170,168,165,183,133,133,24,23,1,3,17,15,"win_A",-1,2,-18,0,0,0,0,0,0.96,0.884615384615385,0.68,0.576923076923077,0,"Unknown"
"1566",25,21,170,173,168,180,122,120,23,20,2,1,6,15,"win_A",4,-3,-12,2,0,0,0,0,0.92,0.952380952380952,0.24,0.714285714285714,0,"orthodox"
"1920",21,23,173,173,184,173,132,132,2,16,0,0,1,10,"win_A",-2,0,11,0,0,0,0,0,1,1,0.5,0.625,0,"orthodox"
"4925",22,22,173,168,170,173,132,133,10,9,0,6,7,2,"win_A",0,5,-3,-1,0,0,0,0,1,0.6,0.7,0.133333333333333,0,"orthodox"
"3831",30,28,183,177,185,175,150,151,32,18,0,4,25,11,"win_A",2,6,10,-1,0,0,0,0,1,0.818181818181818,0.78125,0.5,0,"orthodox"
"4324",26,27,163,168,165,161,118,117,29,29,1,6,23,20,"win_A",-1,-5,4,1,0,0,0,0,0.966666666666667,0.828571428571429,0.766666666666667,0.571428571428571,0,"orthodox"
"1874",35,41,178,178,178,189,168,166,26,22,8,26,24,16,"win_A",-6,0,-11,2,1,1,0,0,0.764705882352941,0.458333333333333,0.705882352941177,0.333333333333333,0,"orthodox"
"152",27,35,160,161,163,170,111,112,42,51,0,8,36,30,"win_A",-8,-1,-7,-1,0,1,0,0,1,0.864406779661017,0.857142857142857,0.508474576271186,0,"orthodox"
"590",21,37,178,170,185,178,144,143,11,37,0,17,10,22,"win_A",-16,8,7,1,0,1,0,0,1,0.685185185185185,0.909090909090909,0.407407407407407,0,"orthodox"
"2894",26,27,180,180,184,178,152,148,79,30,1,20,53,4,"win_A",-1,0,6,4,0,0,0,0,0.9875,0.6,0.6625,0.08,0,"orthodox"
"339",39,27,181,182,181,179,167,166,48,22,3,0,35,15,"win_A",12,-1,2,1,1,0,0,0,0.941176470588235,1,0.686274509803922,0.681818181818182,0,"southpaw"
"4676",22,36,165,170,175,178,128,126,12,41,0,8,9,22,"win_A",-14,-5,-3,2,0,1,0,0,1,0.836734693877551,0.75,0.448979591836735,0,"orthodox"
"5489",22,30,193,185,203,183,219,235,18,13,0,28,15,8,"win_A",-8,8,20,-16,0,0,0,1,1,0.317073170731707,0.833333333333333,0.195121951219512,0,"orthodox"
"5025",28,33,173,175,180,178,141,142,25,16,2,6,5,9,"win_A",-5,-2,2,-1,0,0,0,0,0.925925925925926,0.727272727272727,0.185185185185185,0.409090909090909,0,"orthodox"
"4882",22,30,179,183,185,196,204,186,14,48,1,4,13,23,"win_A",-8,-4,-11,18,0,0,1,0,0.933333333333333,0.923076923076923,0.866666666666667,0.442307692307692,0,"orthodox"
"3063",27,22,169,168,180,178,133,133,123,3,7,1,81,1,"win_A",5,1,2,0,0,0,0,0,0.946153846153846,0.75,0.623076923076923,0.25,0,"orthodox"
"3576",26,22,170,175,170,177,142,138,128,27,10,6,27,17,"win_A",4,-5,-7,4,0,0,0,0,0.927536231884058,0.818181818181818,0.195652173913043,0.515151515151515,0,"Unknown"
"5046",34,35,173,184,193,188,185,200,178,85,53,18,108,48,"win_A",-1,-11,5,-15,0,1,0,1,0.770562770562771,0.825242718446602,0.467532467532468,0.466019417475728,0,"southpaw"
"2946",29,38,188,189,198,198,217,227,36,37,4,4,27,25,"win_A",-9,-1,0,-10,0,1,0,0,0.9,0.902439024390244,0.675,0.609756097560976,0,"orthodox"
"9",18,28,175,173,179,183,147,147,22,16,0,1,15,15,"win_A",-10,2,-4,0,0,0,0,0,1,0.941176470588235,0.681818181818182,0.882352941176471,0,"orthodox"
"2432",26,28,193,183,188,188,249,224,18,32,7,12,9,19,"win_A",-2,10,0,25,0,0,1,0,0.72,0.727272727272727,0.36,0.431818181818182,0,"orthodox"
"1187",24,33,206,191,216,208,240,248,19,28,0,2,14,13,"win_A",-9,15,8,-8,0,0,0,0,1,0.933333333333333,0.736842105263158,0.433333333333333,0,"orthodox"
"5048",29,30,173,179,193,183,165,181,157,10,40,1,94,8,"win_A",-1,-6,10,-16,0,0,0,1,0.796954314720812,0.909090909090909,0.477157360406091,0.727272727272727,0,"southpaw"
"1376",23,38,168,175,188,180,163,160,8,6,2,22,5,3,"win_A",-15,-7,8,3,0,1,0,0,0.8,0.214285714285714,0.5,0.107142857142857,0,"orthodox"
"3269",22,30,180,197,178,208,175,208,62,4,14,10,15,3,"win_A",-8,-17,-30,-33,0,0,0,1,0.815789473684211,0.285714285714286,0.197368421052632,0.214285714285714,0,"orthodox"
"3915",27,25,163,165,165,165,115,114,39,12,2,3,26,9,"win_A",2,-2,0,1,0,0,0,0,0.951219512195122,0.8,0.634146341463415,0.6,0,"southpaw"
"2272",23,26,183,181,186,185,158,162,7,5,2,4,4,0,"win_A",-3,2,1,-4,0,0,0,0,0.777777777777778,0.555555555555556,0.444444444444444,0,0,"orthodox"
"3178",23,27,178,179,188,188,147,147,23,45,0,3,14,28,"win_A",-4,-1,0,0,0,0,0,0,1,0.9375,0.608695652173913,0.583333333333333,0,"orthodox"
"3205",28,34,190,191,206,203,209,220,27,40,0,4,19,32,"win_A",-6,-1,3,-11,0,0,0,0,1,0.909090909090909,0.703703703703704,0.727272727272727,0,"orthodox"
"1049",23,24,163,161,168,166,115,115,16,9,2,1,8,3,"win_A",-1,2,2,0,0,0,0,0,0.888888888888889,0.9,0.444444444444444,0.3,0,"orthodox"
"4370",26,26,183,193,183,203,198,207,38,37,5,9,23,19,"win_A",0,-10,-20,-9,0,0,0,0,0.883720930232558,0.804347826086957,0.534883720930233,0.41304347826087,0,"orthodox"
"5412",26,30,178,171,185,173,140,140,25,32,0,4,10,9,"win_A",-4,7,12,0,0,0,0,0,1,0.888888888888889,0.4,0.25,0,"orthodox"
"4609",26,34,175,175,188,180,143,143,22,30,2,8,12,17,"win_A",-8,0,8,0,0,0,0,0,0.916666666666667,0.789473684210526,0.5,0.447368421052632,0,"orthodox"
"5179",27,22,169,160,175,160,126,126,79,43,27,6,29,12,"win_A",5,9,15,0,0,0,0,0,0.745283018867924,0.877551020408163,0.273584905660377,0.244897959183673,0,"orthodox"
"2944",32,40,187,189,188,198,220,214,35,38,2,5,20,25,"win_A",-8,-2,-10,6,0,1,0,0,0.945945945945946,0.883720930232558,0.540540540540541,0.581395348837209,0,"southpaw"
"4843",28,32,168,168,175,168,117,117,9,35,0,28,7,18,"win_A",-4,0,7,0,0,0,0,0,1,0.555555555555556,0.777777777777778,0.285714285714286,0,"orthodox"
"3655",23,33,165,172,157,175,126,126,26,45,2,9,23,24,"win_A",-10,-7,-18,0,0,0,0,0,0.928571428571429,0.833333333333333,0.821428571428571,0.444444444444444,0,"orthodox"
"2517",27,25,188,168,193,175,170,170,9,8,0,22,8,3,"win_A",2,20,18,0,0,0,0,0,1,0.266666666666667,0.888888888888889,0.1,0,"orthodox"
"4856",39,35,188,180,198,185,250,239,47,25,4,10,37,13,"win_A",4,8,13,11,1,1,0,0,0.92156862745098,0.714285714285714,0.725490196078431,0.371428571428571,0,"southpaw"
"2985",28,25,188,198,193,206,210,230,62,19,6,21,34,12,"win_A",3,-10,-13,-20,0,0,0,1,0.911764705882353,0.475,0.5,0.3,0,"orthodox"
"3188",27,33,166,156,170,163,130,134,67,187,11,38,39,70,"win_A",-6,10,7,-4,0,0,0,0,0.858974358974359,0.831111111111111,0.5,0.311111111111111,0,"orthodox"
"3734",28,26,170,185,188,194,181,188,42,21,4,5,31,18,"win_A",2,-15,-6,-7,0,0,0,0,0.91304347826087,0.807692307692308,0.673913043478261,0.692307692307692,0,"orthodox"
"27",26,31,171,175,175,180,147,147,24,32,0,2,21,18,"win_A",-5,-4,-5,0,0,0,0,0,1,0.941176470588235,0.875,0.529411764705882,0,"orthodox"
"910",19,21,160,161,165,170,109,107,6,5,0,0,4,2,"win_A",-2,-1,-5,2,0,0,0,0,1,1,0.666666666666667,0.4,0,"orthodox"
"2362",22,23,173,168,185,175,135,135,14,20,0,7,9,17,"win_A",-1,5,10,0,0,0,0,0,1,0.740740740740741,0.642857142857143,0.62962962962963,0,"orthodox"
"5616",36,34,185,180,196,181,153,154,35,23,3,6,22,17,"win_A",2,5,15,-1,1,0,0,0,0.921052631578947,0.793103448275862,0.578947368421053,0.586206896551724,0,"southpaw"
"3215",32,26,168,165,178,175,130,129,62,25,4,2,42,18,"win_A",6,3,3,1,0,0,0,0,0.939393939393939,0.925925925925926,0.636363636363636,0.666666666666667,0,"orthodox"
"1764",20,23,170,170,188,175,132,132,1,6,0,0,1,3,"win_A",-3,0,13,0,0,0,0,0,1,1,1,0.5,0,"orthodox"
"5000",28,33,173,175,180,178,141,142,25,16,2,6,5,9,"win_A",-5,-2,2,-1,0,0,0,0,0.925925925925926,0.727272727272727,0.185185185185185,0.409090909090909,0,"orthodox"
"4875",25,24,175,165,183,178,127,125,24,15,4,3,16,7,"win_A",1,10,5,2,0,0,0,0,0.857142857142857,0.833333333333333,0.571428571428571,0.388888888888889,0,"southpaw"
"170",21,37,165,159,169,160,124,124,20,49,0,19,14,29,"win_A",-16,6,9,0,0,1,0,0,1,0.720588235294118,0.7,0.426470588235294,0,"orthodox"
"1882",33,31,183,175,187,180,159,160,20,14,1,8,13,6,"win_A",2,8,7,-1,0,0,0,0,0.952380952380952,0.636363636363636,0.619047619047619,0.272727272727273,0,"orthodox"
"4343",27,28,188,183,198,198,234,212,33,21,3,1,24,16,"win_A",-1,5,0,22,0,0,1,0,0.916666666666667,0.954545454545455,0.666666666666667,0.727272727272727,0,"orthodox"
"4052",31,34,180,165,187,169,122,121,27,34,2,7,18,22,"win_A",-3,15,18,1,0,0,0,0,0.931034482758621,0.829268292682927,0.620689655172414,0.536585365853659,0,"orthodox"
"3328",21,27,166,173,169,170,122,122,21,52,0,0,21,51,"win_A",-6,-7,-1,0,0,0,0,0,1,1,1,0.980769230769231,0,"orthodox"
"4228",24,28,170,160,168,160,118,118,14,36,0,14,12,19,"win_A",-4,10,8,0,0,0,0,0,1,0.72,0.857142857142857,0.38,0,"orthodox"
"1852",31,24,179,166,170,173,131,130,29,14,6,19,15,11,"win_A",7,13,-3,1,0,0,0,0,0.828571428571429,0.424242424242424,0.428571428571429,0.333333333333333,0,"orthodox"
"1899",28,40,178,182,183,189,181,182,53,49,3,4,35,36,"win_A",-12,-4,-6,-1,0,1,0,0,0.946428571428571,0.924528301886792,0.625,0.679245283018868,0,"orthodox"
"1561",26,24,175,170,182,180,143,137,12,6,0,10,6,2,"win_A",2,5,2,6,0,0,0,0,1,0.375,0.5,0.125,0,"southpaw"
"4908",24,28,188,193,196,208,247,232,21,12,0,1,18,8,"win_A",-4,-5,-12,15,0,0,1,0,1,0.923076923076923,0.857142857142857,0.615384615384615,0,"orthodox"
"113",30,23,180,182,178,185,160,159,16,20,0,0,13,17,"win_A",7,-2,-7,1,0,0,0,0,1,1,0.8125,0.85,0,"orthodox"
"3824",21,27,168,154,168,160,118,118,57,86,17,11,17,73,"win_A",-6,14,8,0,0,0,0,0,0.77027027027027,0.88659793814433,0.22972972972973,0.752577319587629,0,"orthodox"
"126",20,28,168,165,173,168,130,130,10,5,0,3,8,0,"win_A",-8,3,5,0,0,0,0,0,1,0.625,0.8,0,0,"orthodox"
"2051",21,28,165,157,170,168,117,117,6,3,0,16,4,0,"win_A",-7,8,2,0,0,0,0,0,1,0.157894736842105,0.666666666666667,0,0,"orthodox"
"63",23,39,174,170,174,178,139,140,20,33,0,7,14,25,"win_A",-16,4,-4,-1,0,1,0,0,1,0.825,0.7,0.625,0,"orthodox"
"1785",20,23,170,170,188,175,132,132,1,6,0,0,1,3,"win_A",-3,0,13,0,0,0,0,0,1,1,1,0.5,0,"orthodox"
"5752",33,36,191,185,206,201,248,217,37,42,1,9,22,38,"win_A",-3,6,5,31,0,1,1,0,0.973684210526316,0.823529411764706,0.578947368421053,0.745098039215686,0,"orthodox"
"3159",27,29,173,175,183,170,130,129,44,37,1,5,33,23,"win_A",-2,-2,13,1,0,0,0,0,0.977777777777778,0.880952380952381,0.733333333333333,0.547619047619048,0,"orthodox"
"67",23,31,165,165,169,170,115,115,10,38,0,7,8,18,"win_A",-8,0,-1,0,0,0,0,0,1,0.844444444444444,0.8,0.4,0,"orthodox"
"1470",40,35,170,170,178,170,133,135,41,28,22,18,25,11,"win_A",5,0,8,-2,1,1,0,0,0.650793650793651,0.608695652173913,0.396825396825397,0.239130434782609,0,"southpaw"
"4067",29,30,170,164,175,170,129,128,24,27,0,3,15,7,"win_A",-1,6,5,1,0,0,0,0,1,0.9,0.625,0.233333333333333,0,"southpaw"
"6079",19,39,170,163,175,157,138,139,15,23,0,14,11,11,"win_A",-20,7,18,-1,0,1,0,0,1,0.621621621621622,0.733333333333333,0.297297297297297,0,"orthodox"
"1762",36,26,166,170,178,188,131,131,29,25,4,1,14,15,"win_A",10,-4,-10,0,1,0,0,0,0.878787878787879,0.961538461538462,0.424242424242424,0.576923076923077,0,"orthodox"
"5930",25,26,171,170,170,183,135,131,32,19,2,6,24,15,"win_A",-1,1,-13,4,0,0,0,0,0.941176470588235,0.76,0.705882352941177,0.6,0,"orthodox"
"59",29,33,180,180,196,182,167,167,5,12,0,12,5,4,"win_A",-4,0,14,0,0,0,0,0,1,0.5,1,0.166666666666667,0,"southpaw"
"599",19,28,170,157,180,165,123,121,2,9,0,14,1,6,"win_A",-9,13,15,2,0,0,0,0,1,0.391304347826087,0.5,0.260869565217391,0,"orthodox"
"749",19,26,170,182,173,178,118,118,11,13,0,7,9,11,"win_A",-7,-12,-5,0,0,0,0,0,1,0.65,0.818181818181818,0.55,0,"orthodox"
"1511",21,22,173,173,188,183,148,139,3,2,0,11,2,0,"win_A",-1,0,5,9,0,0,0,0,1,0.153846153846154,0.666666666666667,0,0,"southpaw"
"3495",27,22,178,179,188,191,208,185,12,12,10,4,6,12,"win_A",5,-1,-3,23,0,0,1,0,0.545454545454545,0.75,0.272727272727273,0.75,0,"orthodox"
"997",23,38,175,170,178,178,140,139,26,33,2,5,21,25,"win_A",-15,5,0,1,0,1,0,0,0.928571428571429,0.868421052631579,0.75,0.657894736842105,0,"southpaw"
"2092",29,37,188,185,190,191,251,223,21,29,10,21,14,16,"win_A",-8,3,-1,28,0,1,1,0,0.67741935483871,0.58,0.451612903225806,0.32,0,"southpaw"
"78",23,31,170,175,177,182,144,146,17,25,0,4,13,14,"win_A",-8,-5,-5,-2,0,0,0,0,1,0.862068965517241,0.764705882352941,0.482758620689655,0,"orthodox"
"784",27,22,180,171,185,175,130,127,11,5,0,4,6,0,"win_A",5,9,10,3,0,0,0,0,1,0.555555555555556,0.545454545454545,0,0,"southpaw"
"1605",22,21,168,170,175,175,125,125,10,3,1,5,5,2,"win_A",1,-2,0,0,0,0,0,0,0.909090909090909,0.375,0.454545454545455,0.25,0,"Unknown"
"5183",27,20,165,169,165,175,124,128,48,25,11,10,20,10,"win_A",7,-4,-10,-4,0,0,0,0,0.813559322033898,0.714285714285714,0.338983050847458,0.285714285714286,0,"Unknown"
"2171",31,38,157,154,165,161,109,108,24,15,8,10,14,7,"win_A",-7,3,4,1,0,1,0,0,0.75,0.6,0.4375,0.28,0,"orthodox"
"1902",24,30,178,175,183,180,173,172,36,24,0,1,25,13,"win_A",-6,3,3,1,0,0,0,0,1,0.96,0.694444444444444,0.52,0,"orthodox"
"2929",42,34,171,175,169,178,143,143,106,32,5,9,86,12,"win_A",8,-4,-9,0,1,0,0,0,0.954954954954955,0.780487804878049,0.774774774774775,0.292682926829268,0,"orthodox"
"4731",24,26,172,168,175,173,130,130,33,15,5,9,19,11,"win_A",-2,4,2,0,0,0,0,0,0.868421052631579,0.625,0.5,0.458333333333333,0,"orthodox"
"2456",22,22,165,160,173,170,124,122,2,2,0,3,0,1,"win_A",0,5,3,2,0,0,0,0,1,0.4,0,0.2,0,"southpaw"
"3893",26,22,173,170,180,183,160,159,105,75,14,12,25,45,"win_A",4,3,-3,1,0,0,0,0,0.882352941176471,0.862068965517241,0.210084033613445,0.517241379310345,0,"Unknown"
"746",21,30,170,169,173,169,120,120,18,11,1,0,15,5,"win_A",-9,1,4,0,0,0,0,0,0.947368421052632,1,0.789473684210526,0.454545454545455,0,"orthodox"
"4114",23,29,182,183,191,193,177,208,7,27,2,11,7,17,"win_A",-6,-1,-2,-31,0,0,0,1,0.777777777777778,0.710526315789474,0.777777777777778,0.447368421052632,0,"orthodox"
"4329",33,20,161,168,168,164,112,112,47,15,1,1,20,11,"win_A",13,-7,4,0,0,0,0,0,0.979166666666667,0.9375,0.416666666666667,0.6875,0,"orthodox"
"2350",31,19,179,180,180,180,159,159,4,0,4,3,4,0,"win_A",12,-1,0,0,0,0,0,0,0.5,0,0.5,0,0,"southpaw"
"5552",31,26,177,175,185,183,165,165,26,26,4,5,21,20,"win_A",5,2,2,0,0,0,0,0,0.866666666666667,0.838709677419355,0.7,0.645161290322581,0,"southpaw"
"5521",25,26,188,188,196,198,225,254,19,23,0,11,17,23,"win_A",-1,0,-2,-29,0,0,0,1,1,0.676470588235294,0.894736842105263,0.676470588235294,0,"orthodox"
"3683",23,21,173,171,173,180,137,135,45,26,16,1,30,16,"win_A",2,2,-7,2,0,0,0,0,0.737704918032787,0.962962962962963,0.491803278688525,0.592592592592593,0,"orthodox"
"2869",29,28,190,185,206,198,215,202,30,19,0,8,21,13,"win_A",1,5,8,13,0,0,0,0,1,0.703703703703704,0.7,0.481481481481481,0,"orthodox"
"6024",26,34,183,175,175,183,154,154,14,42,0,5,6,39,"win_A",-8,8,-8,0,0,0,0,0,1,0.893617021276596,0.428571428571429,0.829787234042553,0,"orthodox"
"957",27,35,193,180,193,193,244,231,23,11,4,14,22,9,"win_A",-8,13,0,13,0,1,0,0,0.851851851851852,0.44,0.814814814814815,0.36,0,"southpaw"
"1575",19,30,173,163,178,173,131,125,9,7,0,26,5,0,"win_A",-11,10,5,6,0,0,0,0,1,0.212121212121212,0.555555555555556,0,0,"Unknown"
"5649",28,33,191,171,201,173,239,218,11,23,2,6,7,17,"win_A",-5,20,28,21,0,0,1,0,0.846153846153846,0.793103448275862,0.538461538461538,0.586206896551724,0,"orthodox"
"5003",26,32,178,188,188,201,174,174,18,41,0,5,17,25,"win_A",-6,-10,-13,0,0,0,0,0,1,0.891304347826087,0.944444444444444,0.543478260869565,0,"orthodox"
"2573",28,31,180,178,191,189,162,166,72,55,9,12,55,27,"win_A",-3,2,2,-4,0,0,0,0,0.888888888888889,0.82089552238806,0.679012345679012,0.402985074626866,0,"orthodox"
"2204",19,25,173,163,174,173,127,127,5,5,0,9,2,2,"win_A",-6,10,1,0,0,0,0,0,1,0.357142857142857,0.4,0.142857142857143,0,"Unknown"
"4532",33,39,192,198,198,201,238,226,34,19,3,2,22,14,"win_A",-6,-6,-3,12,0,1,0,0,0.918918918918919,0.904761904761905,0.594594594594595,0.666666666666667,0,"orthodox"
"4467",27,37,178,178,178,183,154,154,25,58,2,5,22,40,"win_A",-10,0,-5,0,0,1,0,0,0.925925925925926,0.920634920634921,0.814814814814815,0.634920634920635,0,"orthodox"
"5681",35,33,180,180,187,192,173,173,35,18,10,1,19,13,"win_A",2,0,-5,0,1,0,0,0,0.777777777777778,0.947368421052632,0.422222222222222,0.684210526315789,0,"Unknown"
"1796",23,31,160,165,163,165,119,119,6,9,0,12,5,3,"win_A",-8,-5,-2,0,0,0,0,0,1,0.428571428571429,0.833333333333333,0.142857142857143,0,"orthodox"
"4826",24,23,165,163,168,159,118,118,25,23,1,0,16,16,"win_A",1,2,9,0,0,0,0,0,0.961538461538462,1,0.615384615384615,0.695652173913043,0,"southpaw"
"797",18,22,179,165,178,170,123,123,3,1,0,2,1,0,"win_A",-4,14,8,0,0,0,0,0,1,0.333333333333333,0.333333333333333,0,0,"Unknown"
"1643",29,23,168,168,175,178,138,135,29,16,1,8,16,7,"win_A",6,0,-3,3,0,0,0,0,0.966666666666667,0.666666666666667,0.533333333333333,0.291666666666667,0,"southpaw"
"5125",27,26,166,159,170,160,119,118,33,36,1,5,25,25,"win_A",1,7,10,1,0,0,0,0,0.970588235294118,0.878048780487805,0.735294117647059,0.609756097560976,0,"orthodox"
"3791",27,25,171,171,187,179,140,140,33,25,5,2,23,20,"win_A",2,0,8,0,0,0,0,0,0.868421052631579,0.925925925925926,0.605263157894737,0.740740740740741,0,"orthodox"
"2746",32,26,182,182,182,188,165,180,52,104,6,4,45,81,"win_A",6,0,-6,-15,0,0,0,1,0.896551724137931,0.962962962962963,0.775862068965517,0.75,0,"orthodox"
"2262",29,38,180,170,185,169,164,171,5,16,3,19,3,10,"win_A",-9,10,16,-7,0,1,0,0,0.625,0.457142857142857,0.375,0.285714285714286,0,"orthodox"
"2989",30,22,179,188,191,193,206,217,59,23,10,2,53,19,"win_A",8,-9,-2,-11,0,0,0,0,0.855072463768116,0.92,0.768115942028985,0.76,0,"orthodox"
"1486",28,34,193,177,193,185,164,164,25,11,2,6,21,9,"win_A",-6,16,8,0,0,0,0,0,0.925925925925926,0.647058823529412,0.777777777777778,0.529411764705882,0,"orthodox"
"5094",31,34,187,183,185,188,175,175,41,31,3,2,7,21,"win_A",-3,4,-3,0,0,0,0,0,0.931818181818182,0.939393939393939,0.159090909090909,0.636363636363636,0,"Unknown"
"4019",24,31,175,175,185,175,159,158,9,34,0,10,7,17,"win_A",-7,0,10,1,0,0,0,0,1,0.772727272727273,0.777777777777778,0.386363636363636,0,"Unknown"
"102",43,22,165,180,168,178,148,150,26,15,15,0,17,14,"win_B",21,-15,-10,-2,1,0,0,0,0.634146341463415,1,0.414634146341463,0.933333333333333,1,"orthodox"
"670",28,25,185,185,198,188,168,168,18,34,4,0,16,26,"win_B",3,0,10,0,0,0,0,0,0.818181818181818,1,0.727272727272727,0.764705882352941,1,"orthodox"
"1016",28,23,165,170,168,170,122,122,21,18,2,4,13,8,"win_B",5,-5,-2,0,0,0,0,0,0.91304347826087,0.818181818181818,0.565217391304348,0.363636363636364,1,"orthodox"
"735",26,29,183,178,191,188,158,155,22,42,6,5,7,26,"win_B",-3,5,3,3,0,0,0,0,0.785714285714286,0.893617021276596,0.25,0.553191489361702,1,"orthodox"
"516",33,26,185,179,182,178,175,169,82,68,21,6,22,34,"win_B",7,6,4,6,0,0,0,0,0.796116504854369,0.918918918918919,0.213592233009709,0.459459459459459,1,"orthodox"
"939",28,28,166,170,168,173,122,122,34,26,1,0,17,16,"win_B",0,-4,-5,0,0,0,0,0,0.971428571428571,1,0.485714285714286,0.615384615384615,1,"orthodox"
"623",28,25,154,157,160,160,121,125,91,95,18,29,78,18,"win_B",3,-3,0,-4,0,0,0,0,0.834862385321101,0.766129032258065,0.715596330275229,0.145161290322581,1,"Unknown"
"92",32,31,171,170,182,168,139,140,18,16,2,0,7,10,"win_B",1,1,14,-1,0,0,0,0,0.9,1,0.35,0.625,1,"orthodox"
"576",32,26,161,160,168,163,119,119,63,28,16,4,30,8,"win_B",6,1,5,0,0,0,0,0,0.79746835443038,0.875,0.379746835443038,0.25,1,"orthodox"
"441",29,22,170,179,170,185,135,134,36,16,3,0,26,15,"win_B",7,-9,-15,1,0,0,0,0,0.923076923076923,1,0.666666666666667,0.9375,1,"orthodox"
"1012",24,26,185,185,193,188,163,168,10,11,7,1,2,6,"win_B",-2,0,5,-5,0,0,0,0,0.588235294117647,0.916666666666667,0.117647058823529,0.5,1,"orthodox"
"105",28,35,173,180,171,188,146,148,23,30,1,9,7,19,"win_B",-7,-7,-17,-2,0,1,0,0,0.958333333333333,0.769230769230769,0.291666666666667,0.487179487179487,1,"southpaw"
"750",32,25,183,198,191,208,192,199,47,36,5,4,29,18,"win_B",7,-15,-17,-7,0,0,0,0,0.903846153846154,0.9,0.557692307692308,0.45,1,"orthodox"
"31",29,26,163,165,168,168,108,108,26,20,2,4,15,14,"win_B",3,-2,0,0,0,0,0,0,0.928571428571429,0.833333333333333,0.535714285714286,0.583333333333333,1,"orthodox"
"279",21,27,170,165,170,175,130,130,16,29,2,8,11,17,"win_B",-6,5,-5,0,0,0,0,0,0.888888888888889,0.783783783783784,0.611111111111111,0.459459459459459,1,"orthodox"
"88",27,26,171,171,179,170,125,125,35,15,1,0,21,8,"win_B",1,0,9,0,0,0,0,0,0.972222222222222,1,0.583333333333333,0.533333333333333,1,"orthodox"
"54",32,32,190,187,208,191,197,198,21,35,1,1,11,24,"win_B",0,3,17,-1,0,0,0,0,0.954545454545455,0.972222222222222,0.5,0.666666666666667,1,"orthodox"
"280",25,25,168,168,175,163,127,127,4,3,3,3,1,1,"win_B",0,0,12,0,0,0,0,0,0.571428571428571,0.5,0.142857142857143,0.166666666666667,1,"orthodox"
"615",21,25,168,169,169,163,135,135,24,87,0,5,21,73,"win_B",-4,-1,6,0,0,0,0,0,1,0.945652173913043,0.875,0.793478260869565,1,"orthodox"
"890",34,24,160,168,168,168,112,112,31,22,10,18,27,12,"win_B",10,-8,0,0,0,0,0,0,0.75609756097561,0.55,0.658536585365854,0.3,1,"Unknown"
"991",33,22,180,180,175,178,148,149,28,14,2,1,21,9,"win_B",11,0,-3,-1,0,0,0,0,0.933333333333333,0.933333333333333,0.7,0.6,1,"orthodox"
"1040",31,35,180,179,175,188,158,158,36,26,8,5,29,16,"win_B",-4,1,-13,0,0,1,0,0,0.818181818181818,0.838709677419355,0.659090909090909,0.516129032258065,1,"orthodox"
"632",23,21,175,171,191,175,148,148,56,49,12,3,33,18,"win_B",2,4,16,0,0,0,0,0,0.823529411764706,0.942307692307692,0.485294117647059,0.346153846153846,1,"orthodox"
"415",31,29,191,191,198,203,221,210,41,29,1,1,31,23,"win_B",2,0,-5,11,0,0,0,0,0.976190476190476,0.966666666666667,0.738095238095238,0.766666666666667,1,"orthodox"
"992",34,31,179,170,185,175,140,140,20,22,3,5,18,13,"win_B",3,9,10,0,0,0,0,0,0.869565217391304,0.814814814814815,0.782608695652174,0.481481481481481,1,"orthodox"
"691",23,27,173,163,180,160,125,127,33,18,1,18,22,11,"win_B",-4,10,20,-2,0,0,0,0,0.970588235294118,0.5,0.647058823529412,0.305555555555556,1,"orthodox"
"593",27,20,164,157,166,160,128,133,75,37,20,6,35,21,"win_B",7,7,6,-5,0,0,0,0,0.789473684210526,0.86046511627907,0.368421052631579,0.488372093023256,1,"Unknown"
"872",21,27,165,160,173,163,108,108,23,25,0,5,15,13,"win_B",-6,5,10,0,0,0,0,0,1,0.833333333333333,0.652173913043478,0.433333333333333,1,"orthodox"
"513",22,29,180,184,183,196,175,175,21,36,3,1,20,19,"win_B",-7,-4,-13,0,0,0,0,0,0.875,0.972972972972973,0.833333333333333,0.513513513513513,1,"orthodox"
"334",24,35,180,189,193,198,217,231,31,35,1,3,25,25,"win_B",-11,-9,-5,-14,0,1,0,0,0.96875,0.921052631578947,0.78125,0.657894736842105,1,"orthodox"
"627",24,22,175,175,185,180,139,147,23,30,8,0,9,14,"win_B",2,0,5,-8,0,0,0,0,0.741935483870968,1,0.290322580645161,0.466666666666667,1,"orthodox"
"685",35,28,164,178,174,183,133,134,41,28,4,4,18,18,"win_B",7,-14,-9,-1,1,0,0,0,0.911111111111111,0.875,0.4,0.5625,1,"southpaw"
"869",24,26,175,189,183,185,216,206,49,36,16,21,32,16,"win_B",-2,-14,-2,10,0,0,0,0,0.753846153846154,0.631578947368421,0.492307692307692,0.280701754385965,1,"orthodox"
"172",26,25,178,181,180,183,154,156,0,4,3,0,0,3,"win_B",1,-3,-3,-2,0,0,0,0,0,1,0,0.75,1,"orthodox"
"311",35,29,170,173,173,183,146,147,43,36,9,0,13,24,"win_B",6,-3,-10,-1,1,0,0,0,0.826923076923077,1,0.25,0.666666666666667,1,"orthodox"
"636",34,28,188,185,196,183,190,190,30,37,4,1,26,24,"win_B",6,3,13,0,0,0,0,0,0.882352941176471,0.973684210526316,0.764705882352941,0.631578947368421,1,"orthodox"
"34",27,30,166,168,175,170,126,125,30,35,0,11,27,23,"win_B",-3,-2,5,1,0,0,0,0,1,0.760869565217391,0.9,0.5,1,"southpaw"
"794",21,22,182,182,187,187,166,172,68,56,4,11,23,35,"win_B",-1,0,0,-6,0,0,0,0,0.944444444444444,0.835820895522388,0.319444444444444,0.522388059701492,1,"Unknown"
"433",31,33,179,171,191,188,202,220,66,119,12,15,54,70,"win_B",-2,8,3,-18,0,0,0,1,0.846153846153846,0.888059701492537,0.692307692307692,0.522388059701492,1,"orthodox"
"680",33,27,169,182,178,183,146,153,73,14,5,3,48,6,"win_B",6,-13,-5,-7,0,0,0,0,0.935897435897436,0.823529411764706,0.615384615384615,0.352941176470588,1,"orthodox"
"911",30,39,170,171,178,180,138,133,37,137,7,45,8,29,"win_B",-9,-1,-2,5,0,1,0,0,0.840909090909091,0.752747252747253,0.181818181818182,0.159340659340659,1,"Unknown"
"450",35,22,171,178,183,187,157,159,77,42,14,2,21,37,"win_B",13,-7,-4,-2,1,0,0,0,0.846153846153846,0.954545454545455,0.230769230769231,0.840909090909091,1,"orthodox"
"494",27,24,173,179,178,182,135,134,79,39,17,2,18,12,"win_B",3,-6,-4,1,0,0,0,0,0.822916666666667,0.951219512195122,0.1875,0.292682926829268,1,"orthodox"
"692",23,25,173,170,180,175,118,118,32,17,0,4,22,13,"win_B",-2,3,5,0,0,0,0,0,1,0.80952380952381,0.6875,0.619047619047619,1,"orthodox"
"506",20,23,179,178,182,180,168,168,57,46,12,5,7,14,"win_B",-3,1,2,0,0,0,0,0,0.826086956521739,0.901960784313726,0.101449275362319,0.274509803921569,1,"orthodox"
"173",23,23,165,164,164,170,118,118,28,42,1,1,20,27,"win_B",0,1,-6,0,0,0,0,0,0.96551724137931,0.976744186046512,0.689655172413793,0.627906976744186,1,"southpaw"
"804",18,34,168,171,180,165,147,146,17,21,0,12,10,13,"win_B",-16,-3,15,1,0,0,0,0,1,0.636363636363636,0.588235294117647,0.393939393939394,1,"orthodox"
"751",31,31,185,178,188,183,172,174,24,36,0,5,21,23,"win_B",0,7,5,-2,0,0,0,0,1,0.878048780487805,0.875,0.560975609756098,1,"southpaw"
"507",20,26,179,187,182,193,168,172,55,54,10,12,7,21,"win_B",-6,-8,-11,-4,0,0,0,0,0.846153846153846,0.818181818181818,0.107692307692308,0.318181818181818,1,"orthodox"
"738",24,26,189,178,191,180,178,172,36,68,8,12,22,21,"win_B",-2,11,11,6,0,0,0,0,0.818181818181818,0.85,0.5,0.2625,1,"orthodox"
"1028",40,25,175,175,183,178,165,165,49,6,10,0,46,2,"win_B",15,0,5,0,1,0,0,0,0.830508474576271,1,0.779661016949153,0.333333333333333,1,"orthodox"
"29",36,26,164,163,177,163,112,112,17,21,0,3,5,13,"win_B",10,1,14,0,1,0,0,0,1,0.875,0.294117647058824,0.541666666666667,1,"orthodox"
"395",25,21,166,164,170,174,129,130,32,65,5,9,15,14,"win_B",4,2,-4,-1,0,0,0,0,0.864864864864865,0.878378378378378,0.405405405405405,0.189189189189189,1,"orthodox"
"343",34,25,170,189,180,198,187,190,28,16,4,0,17,12,"win_B",9,-19,-18,-3,0,0,0,0,0.875,1,0.53125,0.75,1,"orthodox"
"676",27,24,178,178,184,189,166,165,65,16,25,4,18,9,"win_B",3,0,-5,1,0,0,0,0,0.722222222222222,0.8,0.2,0.45,1,"Unknown"
"941",28,23,173,180,173,170,141,140,29,9,4,0,16,9,"win_B",5,-7,3,1,0,0,0,0,0.878787878787879,1,0.484848484848485,1,1,"orthodox"
"119",36,21,162,163,163,163,108,108,13,8,6,0,7,5,"win_B",15,-1,0,0,1,0,0,0,0.684210526315789,1,0.368421052631579,0.625,1,"southpaw"
"462",30,33,185,182,185,182,167,184,10,53,0,7,4,46,"win_B",-3,3,3,-17,0,0,0,1,1,0.883333333333333,0.4,0.766666666666667,1,"orthodox"
"906",30,27,160,178,173,183,139,137,30,24,1,1,20,22,"win_B",3,-18,-10,2,0,0,0,0,0.967741935483871,0.96,0.645161290322581,0.88,1,"orthodox"
"153",30,25,179,175,182,176,139,138,6,7,0,0,1,6,"win_B",5,4,6,1,0,0,0,0,1,1,0.166666666666667,0.857142857142857,1,"southpaw"
"920",25,22,189,193,191,209,194,180,37,50,11,6,22,24,"win_B",3,-4,-18,14,0,0,0,0,0.770833333333333,0.892857142857143,0.458333333333333,0.428571428571429,1,"orthodox"
"724",27,26,179,179,184,184,166,175,68,56,16,6,40,22,"win_B",1,0,0,-9,0,0,0,0,0.80952380952381,0.903225806451613,0.476190476190476,0.354838709677419,1,"orthodox"
"9101",30,38,187,191,203,193,218,225,25,36,6,5,17,25,"win_B",-8,-4,10,-7,0,1,0,0,0.806451612903226,0.878048780487805,0.548387096774194,0.609756097560976,1,"orthodox"
"867",21,27,165,160,173,163,108,108,23,25,0,5,15,13,"win_B",-6,5,10,0,0,0,0,0,1,0.833333333333333,0.652173913043478,0.433333333333333,1,"orthodox"
"424",30,34,178,189,180,198,215,222,45,32,1,3,39,23,"win_B",-4,-11,-18,-7,0,0,0,0,0.978260869565217,0.914285714285714,0.847826086956522,0.657142857142857,1,"orthodox"
"370",27,28,163,168,165,170,137,145,122,53,17,11,39,21,"win_B",-1,-5,-5,-8,0,0,0,0,0.877697841726619,0.828125,0.280575539568345,0.328125,1,"orthodox"
"458",24,23,163,163,165,170,133,136,95,59,11,5,30,4,"win_B",1,0,-5,-3,0,0,0,0,0.89622641509434,0.921875,0.283018867924528,0.0625,1,"orthodox"
"60",17,27,180,174,185,173,147,147,8,13,1,0,4,6,"win_B",-10,6,12,0,0,0,0,0,0.888888888888889,1,0.444444444444444,0.461538461538462,1,"orthodox"
"244",26,19,164,155,163,157,110,112,5,1,2,0,1,0,"win_B",7,9,6,-2,0,0,0,0,0.714285714285714,1,0.142857142857143,0,1,"orthodox"
"775",27,25,171,184,175,185,161,162,43,25,14,4,24,13,"win_B",2,-13,-10,-1,0,0,0,0,0.754385964912281,0.862068965517241,0.421052631578947,0.448275862068966,1,"orthodox"
"5991",27,21,171,164,172,166,133,128,47,46,14,3,30,23,"win_B",6,7,6,5,0,0,0,0,0.770491803278688,0.938775510204082,0.491803278688525,0.469387755102041,1,"Unknown"
"537",18,23,164,156,168,152,108,108,14,22,1,8,11,11,"win_B",-5,8,16,0,0,0,0,0,0.933333333333333,0.733333333333333,0.733333333333333,0.366666666666667,1,"orthodox"
"290",17,18,178,170,178,173,139,139,1,1,0,0,0,0,"win_B",-1,8,5,0,0,0,0,0,1,1,0,0,1,"orthodox"
"116",38,23,166,165,178,168,127,130,34,15,6,0,15,9,"win_B",15,1,10,-3,1,0,0,0,0.85,1,0.375,0.6,1,"orthodox"
"774",27,33,170,171,174,175,160,154,43,57,6,16,32,35,"win_B",-6,-1,-1,6,0,0,0,0,0.877551020408163,0.780821917808219,0.653061224489796,0.479452054794521,1,"orthodox"
"555",30,26,170,189,180,193,173,174,19,22,1,0,12,16,"win_B",4,-19,-13,-1,0,0,0,0,0.95,1,0.6,0.727272727272727,1,"orthodox"
"1010",29,22,170,170,175,173,128,136,39,4,7,1,20,4,"win_B",7,0,2,-8,0,0,0,0,0.847826086956522,0.8,0.434782608695652,0.8,1,"Unknown"
"783",34,27,193,189,196,208,245,225,36,32,1,2,26,26,"win_B",7,4,-12,20,0,0,1,0,0.972972972972973,0.941176470588235,0.702702702702703,0.764705882352941,1,"southpaw"
"924",19,23,166,169,170,170,122,123,26,18,1,2,15,4,"win_B",-4,-3,0,-1,0,0,0,0,0.962962962962963,0.9,0.555555555555556,0.2,1,"orthodox"
"50",28,28,192,191,193,193,242,225,20,15,2,0,15,12,"win_B",0,1,0,17,0,0,1,0,0.909090909090909,1,0.681818181818182,0.8,1,"southpaw"
"118",36,29,191,198,194,211,238,231,31,19,12,1,15,15,"win_B",7,-7,-17,7,1,0,0,0,0.720930232558139,0.95,0.348837209302326,0.75,1,"orthodox"
"592",23,20,157,168,160,178,133,133,70,57,15,4,25,8,"win_B",3,-11,-18,0,0,0,0,0,0.823529411764706,0.934426229508197,0.294117647058824,0.131147540983607,1,"Unknown"
"765",30,24,185,192,196,185,200,206,53,12,4,1,30,10,"win_B",6,-7,11,-6,0,0,0,0,0.929824561403509,0.923076923076923,0.526315789473684,0.769230769230769,1,"orthodox"
"998",34,34,180,183,193,185,194,190,31,21,8,8,18,15,"win_B",0,-3,8,4,0,0,0,0,0.794871794871795,0.724137931034483,0.461538461538462,0.517241379310345,1,"Unknown"
"549",28,21,179,178,183,178,154,154,39,17,2,0,24,17,"win_B",7,1,5,0,0,0,0,0,0.951219512195122,1,0.585365853658537,1,1,"southpaw"
"1022",28,28,168,169,173,173,134,135,34,28,1,1,19,20,"win_B",0,-1,0,-1,0,0,0,0,0.971428571428571,0.96551724137931,0.542857142857143,0.689655172413793,1,"Unknown"
"134",22,21,168,163,175,173,118,120,9,5,0,1,4,0,"win_B",1,5,2,-2,0,0,0,0,1,0.833333333333333,0.444444444444444,0,1,"Unknown"
"858",34,31,187,193,192,203,190,188,23,26,10,1,22,13,"win_B",3,-6,-11,2,0,0,0,0,0.696969696969697,0.962962962962963,0.666666666666667,0.481481481481481,1,"orthodox"
"123",32,25,178,178,180,183,145,147,28,31,3,8,20,21,"win_B",7,0,-3,-2,0,0,0,0,0.903225806451613,0.794871794871795,0.645161290322581,0.538461538461538,1,"southpaw"
"566",31,48,195,192,203,199,253,230,36,75,0,4,30,68,"win_B",-17,3,4,23,0,1,1,0,1,0.949367088607595,0.833333333333333,0.860759493670886,1,"orthodox"
"322",37,41,188,185,191,191,174,174,24,46,3,4,18,32,"win_B",-4,3,0,0,1,1,0,0,0.888888888888889,0.92,0.666666666666667,0.64,1,"southpaw"
"868",24,22,175,187,183,222,216,185,49,46,17,13,32,15,"win_B",2,-12,-39,31,0,0,1,0,0.742424242424242,0.779661016949153,0.484848484848485,0.254237288135593,1,"orthodox"
"626",26,26,171,156,180,163,127,128,71,124,17,21,7,49,"win_B",0,15,17,-1,0,0,0,0,0.806818181818182,0.855172413793103,0.0795454545454545,0.337931034482759,1,"orthodox"
"816",33,27,177,175,183,175,156,155,22,19,22,5,12,12,"win_B",6,2,8,1,0,0,0,0,0.5,0.791666666666667,0.272727272727273,0.5,1,"Unknown"
"9541",19,24,168,165,171,174,125,125,17,24,6,4,7,7,"win_B",-5,3,-3,0,0,0,0,0,0.739130434782609,0.857142857142857,0.304347826086957,0.25,1,"orthodox"
"684",23,30,165,168,173,165,114,114,30,40,1,0,27,24,"win_B",-7,-3,8,0,0,0,0,0,0.967741935483871,1,0.870967741935484,0.6,1,"orthodox"
"362",36,21,171,171,183,175,158,158,79,26,16,1,21,11,"win_B",15,0,8,0,1,0,0,0,0.831578947368421,0.962962962962963,0.221052631578947,0.407407407407407,1,"orthodox"
"709",33,28,178,179,180,193,144,147,154,54,58,9,81,34,"win_B",5,-1,-13,-3,0,0,0,0,0.726415094339623,0.857142857142857,0.382075471698113,0.53968253968254,1,"orthodox"
"722",22,22,184,185,188,191,164,178,23,5,5,1,15,4,"win_B",0,-1,-3,-14,0,0,0,0,0.821428571428571,0.833333333333333,0.535714285714286,0.666666666666667,1,"Unknown"
"293",18,27,179,175,179,175,139,139,2,6,2,0,0,2,"win_B",-9,4,4,0,0,0,0,0,0.5,1,0,0.333333333333333,1,"southpaw"
"539",30,23,163,160,168,163,118,116,47,42,1,3,37,17,"win_B",7,3,5,2,0,0,0,0,0.979166666666667,0.933333333333333,0.770833333333333,0.377777777777778,1,"orthodox"
"77",25,25,170,180,170,183,138,139,15,13,0,6,7,5,"win_B",0,-10,-13,-1,0,0,0,0,1,0.684210526315789,0.466666666666667,0.263157894736842,1,"orthodox"
"456",29,28,185,185,198,188,160,160,45,24,2,4,38,15,"win_B",1,0,10,0,0,0,0,0,0.957446808510638,0.857142857142857,0.808510638297872,0.535714285714286,1,"orthodox"
"541",25,23,174,168,178,178,130,136,129,60,9,5,90,7,"win_B",2,6,0,-6,0,0,0,0,0.934782608695652,0.923076923076923,0.652173913043478,0.107692307692308,1,"orthodox"
"963",27,22,177,173,185,178,160,160,17,20,1,3,14,13,"win_B",5,4,7,0,0,0,0,0,0.944444444444444,0.869565217391304,0.777777777777778,0.565217391304348,1,"southpaw"
"548",27,18,189,180,191,192,172,184,41,22,18,2,24,14,"win_B",9,9,-1,-12,0,0,0,0,0.694915254237288,0.916666666666667,0.406779661016949,0.583333333333333,1,"orthodox"
"761",44,24,173,178,178,183,150,149,42,23,26,1,18,16,"win_B",20,-5,-5,1,1,0,0,0,0.617647058823529,0.958333333333333,0.264705882352941,0.666666666666667,1,"orthodox"
"616",32,28,177,178,180,188,158,158,43,40,4,4,31,25,"win_B",4,-1,-8,0,0,0,0,0,0.914893617021277,0.909090909090909,0.659574468085106,0.568181818181818,1,"orthodox"
"837",16,19,168,160,165,164,109,111,1,3,0,0,1,1,"win_B",-3,8,1,-2,0,0,0,0,1,1,1,0.333333333333333,1,"orthodox"
"894",35,38,177,175,183,178,168,152,24,16,28,5,13,15,"win_B",-3,2,5,16,1,1,1,0,0.461538461538462,0.761904761904762,0.25,0.714285714285714,1,"Unknown"
"437",29,27,180,179,191,185,147,147,34,31,1,1,24,25,"win_B",2,1,6,0,0,0,0,0,0.971428571428571,0.96875,0.685714285714286,0.78125,1,"orthodox"
"628",27,27,171,169,179,175,140,138,28,36,3,0,23,16,"win_B",0,2,4,2,0,0,0,0,0.903225806451613,1,0.741935483870968,0.444444444444444,1,"orthodox"
"653",48,29,174,180,178,183,148,148,31,27,3,3,19,18,"win_B",19,-6,-5,0,1,0,0,0,0.911764705882353,0.9,0.558823529411765,0.6,1,"orthodox"
"405",45,20,180,191,191,198,191,204,185,15,22,0,131,12,"win_B",25,-11,-7,-13,1,0,0,0,0.893719806763285,1,0.632850241545894,0.8,1,"orthodox"
"131",39,29,183,180,191,188,175,174,18,38,3,1,7,32,"win_B",10,3,3,1,1,0,0,0,0.857142857142857,0.974358974358974,0.333333333333333,0.82051282051282,1,"southpaw"
"439",26,23,174,179,173,185,140,140,41,22,0,0,31,20,"win_B",3,-5,-12,0,0,0,0,0,1,1,0.75609756097561,0.909090909090909,1,"orthodox"
"35",27,31,168,165,170,173,126,126,32,36,9,11,21,23,"win_B",-4,3,-3,0,0,0,0,0,0.780487804878049,0.765957446808511,0.51219512195122,0.48936170212766,1,"orthodox"
"697",33,27,166,167,171,171,130,130,61,37,5,6,43,27,"win_B",6,-1,0,0,0,0,0,0,0.924242424242424,0.86046511627907,0.651515151515151,0.627906976744186,1,"orthodox"
"748",30,26,171,182,168,183,151,151,34,13,4,3,19,6,"win_B",4,-11,-15,0,0,0,0,0,0.894736842105263,0.8125,0.5,0.375,1,"orthodox"
"833",35,22,171,171,176,175,139,136,110,34,54,9,14,21,"win_B",13,0,1,3,1,0,0,0,0.670731707317073,0.790697674418605,0.0853658536585366,0.488372093023256,1,"orthodox"
"508",19,26,179,180,182,187,167,171,41,57,8,7,6,31,"win_B",-7,-1,-5,-4,0,0,0,0,0.836734693877551,0.890625,0.122448979591837,0.484375,1,"orthodox"
"668",25,23,173,178,180,184,158,157,105,66,12,1,25,13,"win_B",2,-5,-4,1,0,0,0,0,0.897435897435897,0.985074626865672,0.213675213675214,0.194029850746269,1,"Unknown"
"851",34,30,185,178,193,191,215,201,18,19,9,6,11,16,"win_B",4,7,2,14,0,0,0,0,0.666666666666667,0.76,0.407407407407407,0.64,1,"orthodox"
"58",28,27,174,170,178,183,129,130,23,23,2,7,16,16,"win_B",1,4,-5,-1,0,0,0,0,0.92,0.766666666666667,0.64,0.533333333333333,1,"orthodox"
"202",40,23,191,192,201,195,229,243,36,14,6,2,27,9,"win_B",17,-1,6,-14,1,0,0,0,0.857142857142857,0.875,0.642857142857143,0.5625,1,"orthodox"
"89",36,26,191,187,201,188,244,273,41,12,8,0,31,7,"win_B",10,4,13,-29,1,0,0,1,0.836734693877551,1,0.63265306122449,0.583333333333333,1,"orthodox"
"762",36,27,173,180,188,183,152,149,38,23,19,2,24,14,"win_B",9,-7,5,3,1,0,0,0,0.666666666666667,0.92,0.421052631578947,0.56,1,"orthodox"
"907",25,25,179,193,183,188,184,189,13,2,2,0,7,1,"win_B",0,-14,-5,-5,0,0,0,0,0.866666666666667,1,0.466666666666667,0.5,1,"orthodox"
"1033",27,20,160,163,160,160,128,128,76,48,14,13,22,7,"win_B",7,-3,0,0,0,0,0,0,0.844444444444444,0.786885245901639,0.244444444444444,0.114754098360656,1,"orthodox"
"237",29,34,174,170,178,180,135,135,26,52,8,14,18,36,"win_B",-5,4,-2,0,0,0,0,0,0.764705882352941,0.787878787878788,0.529411764705882,0.545454545454545,1,"southpaw"
"389",21,28,183,178,185,189,168,165,30,38,3,7,15,23,"win_B",-7,5,-4,3,0,0,0,0,0.909090909090909,0.844444444444444,0.454545454545455,0.511111111111111,1,"orthodox"
"608",22,25,168,171,174,180,135,134,58,57,8,8,33,30,"win_B",-3,-3,-6,1,0,0,0,0,0.878787878787879,0.876923076923077,0.5,0.461538461538462,1,"orthodox"
"236",20,25,162,165,163,175,127,129,7,20,1,9,7,17,"win_B",-5,-3,-12,-2,0,0,0,0,0.875,0.689655172413793,0.875,0.586206896551724,1,"orthodox"
"438",27,26,176,179,183,185,147,147,48,30,2,0,28,24,"win_B",1,-3,-2,0,0,0,0,0,0.96,1,0.56,0.8,1,"orthodox"
"725",38,28,191,180,198,203,280,221,53,5,4,6,34,3,"win_B",10,11,-5,59,1,0,1,0,0.929824561403509,0.454545454545455,0.596491228070175,0.272727272727273,1,"orthodox"
"678",26,31,178,182,183,185,159,159,24,44,1,1,19,42,"win_B",-5,-4,-2,0,0,0,0,0,0.96,0.977777777777778,0.76,0.933333333333333,1,"orthodox"
"853",25,28,188,191,200,192,198,199,11,11,0,1,9,4,"win_B",-3,-3,8,-1,0,0,0,0,1,0.916666666666667,0.818181818181818,0.333333333333333,1,"orthodox"
"854",22,26,169,179,165,180,140,140,97,77,12,12,53,20,"win_B",-4,-10,-15,0,0,0,0,0,0.889908256880734,0.865168539325843,0.486238532110092,0.224719101123595,1,"orthodox"
"218",35,26,162,165,183,171,125,126,28,4,14,4,14,3,"win_B",9,-3,12,-1,1,0,0,0,0.666666666666667,0.5,0.333333333333333,0.375,1,"orthodox"
"979",42,29,185,191,196,201,233,216,11,14,29,2,4,10,"win_B",13,-6,-5,17,1,0,1,0,0.275,0.875,0.1,0.625,1,"orthodox"
"181",20,25,173,165,173,171,129,130,6,3,1,3,4,3,"win_B",-5,8,2,-1,0,0,0,0,0.857142857142857,0.5,0.571428571428571,0.5,1,"orthodox"
"192",19,26,175,170,175,188,135,135,22,25,0,2,18,15,"win_B",-7,5,-13,0,0,0,0,0,1,0.925925925925926,0.818181818181818,0.555555555555556,1,"southpaw"
"488",30,22,170,168,173,178,121,122,28,39,1,0,17,27,"win_B",8,2,-5,-1,0,0,0,0,0.96551724137931,1,0.586206896551724,0.692307692307692,1,"orthodox"
"333",30,30,169,171,175,169,140,140,40,81,1,0,17,68,"win_B",0,-2,6,0,0,0,0,0,0.975609756097561,1,0.414634146341463,0.839506172839506,1,"southpaw"
"915",29,24,180,185,190,196,169,168,5,9,0,0,4,3,"win_B",5,-5,-6,1,0,0,0,0,1,1,0.8,0.333333333333333,1,"Unknown"
"950",26,19,165,168,174,170,126,126,36,37,15,7,8,14,"win_B",7,-3,4,0,0,0,0,0,0.705882352941177,0.840909090909091,0.156862745098039,0.318181818181818,1,"orthodox"
"215",26,33,185,173,193,183,161,163,19,28,1,7,9,16,"win_B",-7,12,10,-2,0,0,0,0,0.95,0.8,0.45,0.457142857142857,1,"southpaw"
"388",30,37,183,183,185,188,182,194,71,49,5,16,39,31,"win_B",-7,0,-3,-12,0,1,0,0,0.934210526315789,0.753846153846154,0.513157894736842,0.476923076923077,1,"orthodox"
"922",31,34,171,173,180,178,140,139,22,34,0,9,17,25,"win_B",-3,-2,2,1,0,0,0,0,1,0.790697674418605,0.772727272727273,0.581395348837209,1,"orthodox"
"329",28,32,187,188,184,193,207,182,62,54,10,1,13,46,"win_B",-4,-1,-9,25,0,0,1,0,0.861111111111111,0.981818181818182,0.180555555555556,0.836363636363636,1,"orthodox"
"665",33,25,154,159,160,173,111,111,60,26,5,6,15,17,"win_B",8,-5,-13,0,0,0,0,0,0.923076923076923,0.8125,0.230769230769231,0.53125,1,"orthodox"
"511",22,26,171,179,175,182,141,142,147,67,19,5,41,14,"win_B",-4,-8,-7,-1,0,0,0,0,0.885542168674699,0.930555555555556,0.246987951807229,0.194444444444444,1,"Unknown"
"839",41,25,193,191,208,193,270,215,39,20,13,1,29,10,"win_B",16,2,15,55,1,0,1,0,0.75,0.952380952380952,0.557692307692308,0.476190476190476,1,"orthodox"
"426",25,31,196,189,206,198,217,246,34,29,0,1,29,22,"win_B",-6,7,8,-29,0,0,0,1,1,0.966666666666667,0.852941176470588,0.733333333333333,1,"orthodox"
"657",35,26,177,173,178,182,159,154,61,44,9,16,31,26,"win_B",9,4,-4,5,1,0,0,0,0.871428571428571,0.733333333333333,0.442857142857143,0.433333333333333,1,"orthodox"
"524",31,27,182,197,185,216,186,270,112,77,23,6,12,62,"win_B",4,-15,-31,-84,0,0,0,1,0.82962962962963,0.927710843373494,0.0888888888888889,0.746987951807229,1,"orthodox"
"107",27,25,168,175,165,178,131,131,8,8,0,1,3,4,"win_B",2,-7,-13,0,0,0,0,0,1,0.888888888888889,0.375,0.444444444444444,1,"orthodox"
"120",37,27,179,178,185,183,148,148,33,17,6,3,19,8,"win_B",10,1,2,0,1,0,0,0,0.846153846153846,0.85,0.487179487179487,0.4,1,"orthodox"
"701",26,28,179,173,191,188,174,172,52,101,11,23,25,42,"win_B",-2,6,3,2,0,0,0,0,0.825396825396825,0.814516129032258,0.396825396825397,0.338709677419355,1,"Unknown"
"82",38,29,173,182,178,182,158,157,39,21,4,9,22,13,"win_B",9,-9,-4,1,1,0,0,0,0.906976744186046,0.7,0.511627906976744,0.433333333333333,1,"orthodox"
"903",33,27,170,171,170,175,134,132,48,18,4,12,44,9,"win_B",6,-1,-5,2,0,0,0,0,0.923076923076923,0.6,0.846153846153846,0.3,1,"orthodox"
"452",33,26,169,171,180,172,132,132,157,43,10,14,100,26,"win_B",7,-2,8,0,0,0,0,0,0.940119760479042,0.754385964912281,0.598802395209581,0.456140350877193,1,"orthodox"
"145",28,22,165,160,165,171,115,115,20,17,0,2,16,12,"win_B",6,5,-6,0,0,0,0,0,1,0.894736842105263,0.8,0.631578947368421,1,"orthodox"
"622",22,24,175,179,191,180,148,155,26,64,3,7,15,26,"win_B",-2,-4,11,-7,0,0,0,0,0.896551724137931,0.901408450704225,0.517241379310345,0.366197183098592,1,"orthodox"
"935",36,27,152,168,165,160,105,105,40,25,5,3,30,11,"win_B",9,-16,5,0,1,0,0,0,0.888888888888889,0.892857142857143,0.666666666666667,0.392857142857143,1,"orthodox"
"327",30,32,182,191,185,198,212,209,30,43,1,2,25,31,"win_B",-2,-9,-13,3,0,0,0,0,0.967741935483871,0.955555555555556,0.806451612903226,0.688888888888889,1,"orthodox"
"810",26,33,179,178,203,193,166,190,65,119,24,16,44,51,"win_B",-7,1,10,-24,0,0,0,1,0.730337078651685,0.881481481481482,0.49438202247191,0.377777777777778,1,"Unknown"
"787",22,28,173,161,178,157,138,137,71,48,15,15,9,20,"win_B",-6,12,21,1,0,0,0,0,0.825581395348837,0.761904761904762,0.104651162790698,0.317460317460317,1,"Unknown"
"696",27,21,163,165,169,166,118,119,50,33,9,7,9,19,"win_B",6,-2,3,-1,0,0,0,0,0.847457627118644,0.825,0.152542372881356,0.475,1,"Unknown"
"446",38,33,170,178,168,188,158,160,85,35,7,1,61,25,"win_B",5,-8,-20,-2,1,0,0,0,0.923913043478261,0.972222222222222,0.66304347826087,0.694444444444444,1,"orthodox"
"504",25,22,179,182,182,187,179,177,129,52,26,11,11,34,"win_B",3,-3,-5,2,0,0,0,0,0.832258064516129,0.825396825396825,0.0709677419354839,0.53968253968254,1,"orthodox"
"52",25,22,157,160,160,152,112,112,22,29,1,2,17,22,"win_B",3,-3,8,0,0,0,0,0,0.956521739130435,0.935483870967742,0.739130434782609,0.709677419354839,1,"orthodox"
"376",19,26,165,165,175,173,130,128,46,72,16,7,16,15,"win_B",-7,0,2,2,0,0,0,0,0.741935483870968,0.911392405063291,0.258064516129032,0.189873417721519,1,"orthodox"
"641",27,37,183,183,185,185,154,154,21,40,0,3,5,29,"win_B",-10,0,0,0,0,1,0,0,1,0.930232558139535,0.238095238095238,0.674418604651163,1,"orthodox"
"296",32,28,188,188,196,188,251,289,8,4,4,1,6,4,"win_B",4,0,8,-38,0,0,0,1,0.666666666666667,0.8,0.5,0.8,1,"southpaw"
"512",20,22,171,163,175,165,129,130,123,32,13,12,40,14,"win_B",-2,8,10,-1,0,0,0,0,0.904411764705882,0.727272727272727,0.294117647058824,0.318181818181818,1,"Unknown"
"558",25,32,188,182,198,193,184,200,18,80,1,22,14,29,"win_B",-7,6,5,-16,0,0,0,1,0.947368421052632,0.784313725490196,0.736842105263158,0.284313725490196,1,"orthodox"
"176",22,28,171,170,182,180,135,135,14,17,2,3,13,15,"win_B",-6,1,2,0,0,0,0,0,0.875,0.85,0.8125,0.75,1,"orthodox"
"6",35,29,179,166,185,170,142,145,39,47,5,3,30,35,"win_B",6,13,15,-3,1,0,0,0,0.886363636363636,0.94,0.681818181818182,0.7,1,"orthodox"
"607",27,19,171,180,180,183,137,137,68,22,10,2,33,8,"win_B",8,-9,-3,0,0,0,0,0,0.871794871794872,0.916666666666667,0.423076923076923,0.333333333333333,1,"orthodox"
"440",29,22,180,179,183,185,135,133,32,18,0,0,16,16,"win_B",7,1,-2,2,0,0,0,0,1,1,0.5,0.888888888888889,1,"orthodox"
"785",29,24,191,189,201,208,230,225,28,23,1,0,19,20,"win_B",5,2,-7,5,0,0,0,0,0.96551724137931,1,0.655172413793103,0.869565217391304,1,"orthodox"
"753",27,40,180,170,185,178,139,139,27,34,2,9,19,25,"win_B",-13,10,7,0,0,1,0,0,0.931034482758621,0.790697674418605,0.655172413793103,0.581395348837209,1,"orthodox"
"474",26,32,188,183,198,185,190,201,21,83,2,10,16,46,"win_B",-6,5,13,-11,0,0,0,0,0.91304347826087,0.89247311827957,0.695652173913043,0.494623655913978,1,"orthodox"
"565",48,25,192,193,199,203,260,227,76,29,4,1,68,24,"win_B",23,-1,-4,33,1,0,1,0,0.95,0.966666666666667,0.85,0.8,1,"orthodox"
"246",28,26,183,185,175,196,159,159,25,18,1,3,9,17,"win_B",2,-2,-21,0,0,0,0,0,0.961538461538462,0.857142857142857,0.346153846153846,0.80952380952381,1,"orthodox"
"795",30,22,180,182,185,187,177,182,67,53,25,11,22,34,"win_B",8,-2,-2,-5,0,0,0,0,0.728260869565217,0.828125,0.239130434782609,0.53125,1,"orthodox"
"865",23,23,175,173,183,178,135,135,14,12,1,1,9,8,"win_B",0,2,5,0,0,0,0,0,0.933333333333333,0.923076923076923,0.6,0.615384615384615,1,"orthodox"
"83",29,25,175,182,180,182,154,154,12,15,7,5,6,8,"win_B",4,-7,-2,0,0,0,0,0,0.631578947368421,0.75,0.315789473684211,0.4,1,"orthodox"
"194",20,27,168,165,183,165,118,118,16,14,0,4,6,11,"win_B",-7,3,18,0,0,0,0,0,1,0.777777777777778,0.375,0.611111111111111,1,"orthodox"
"1030",26,30,170,178,173,175,152,156,35,21,6,7,15,15,"win_B",-4,-8,-2,-4,0,0,0,0,0.853658536585366,0.75,0.365853658536585,0.535714285714286,1,"Unknown"
"24",35,23,168,174,175,170,130,131,36,14,3,2,24,5,"win_B",12,-6,5,-1,1,0,0,0,0.923076923076923,0.875,0.615384615384615,0.3125,1,"orthodox"
"326",30,32,177,185,185,191,160,160,27,32,5,2,19,25,"win_B",-2,-8,-6,0,0,0,0,0,0.84375,0.941176470588235,0.59375,0.735294117647059,1,"Unknown"
"1019",23,26,165,168,178,168,133,132,10,23,0,1,5,13,"win_B",-3,-3,10,1,0,0,0,0,1,0.958333333333333,0.5,0.541666666666667,1,"Unknown"
"620",29,26,179,175,180,185,162,165,113,65,17,5,32,34,"win_B",3,4,-5,-3,0,0,0,0,0.869230769230769,0.928571428571429,0.246153846153846,0.485714285714286,1,"orthodox"
"905",22,21,165,166,165,170,119,119,13,10,1,0,11,10,"win_B",1,-1,-5,0,0,0,0,0,0.928571428571429,1,0.785714285714286,1,1,"orthodox"
"955",36,35,192,196,193,207,248,226,30,29,2,1,14,17,"win_B",1,-4,-14,22,1,1,1,0,0.9375,0.966666666666667,0.4375,0.566666666666667,1,"orthodox"
"934",28,23,170,169,178,170,122,123,28,19,1,2,20,5,"win_B",5,1,8,-1,0,0,0,0,0.96551724137931,0.904761904761905,0.689655172413793,0.238095238095238,1,"orthodox"
"827",26,21,169,163,177,173,121,116,66,64,15,1,52,24,"win_B",5,6,4,5,0,0,0,0,0.814814814814815,0.984615384615385,0.641975308641975,0.369230769230769,1,"orthodox"
"212",30,25,163,178,160,171,136,132,17,24,2,4,10,17,"win_B",5,-15,-11,4,0,0,0,0,0.894736842105263,0.857142857142857,0.526315789473684,0.607142857142857,1,"orthodox"
