"","age_A","age_B","height_A","height_B","reach_A","reach_B","weight_A","weight_B","won_A","won_B","lost_A","lost_B","kos_A","kos_B","result","AdvAgeA","AdvHeightA","AdvReachA","AdvWgtA","Over35AgeA","Over35AgeB","Over15lbA","Over15lbB","WinPA","WinPB","KoAPer","KoBPer","binaryresult","stance"
"1",26,31,175,185,179,185,164,164,48,50,1,2,34,32,"win_A",-5,-10,-6,0,0,0,0,0,0.979591836734694,0.961538461538462,0.693877551020408,0.615384615384615,0,"orthodox"
"3",25,29,175,174,179,180,155,155,46,31,1,3,32,19,"win_A",-4,1,-1,0,0,0,0,0,0.978723404255319,0.911764705882353,0.680851063829787,0.558823529411765,0,"orthodox"
"6",23,31,175,175,179,188,155,155,43,19,1,1,31,12,"win_A",-8,0,-9,0,0,0,0,0,0.977272727272727,0.95,0.704545454545455,0.6,0,"orthodox"
"10",22,28,175,177,179,175,154,153,40,30,0,4,29,18,"win_A",-6,-2,4,1,0,0,0,0,1,0.882352941176471,0.725,0.529411764705882,0,"orthodox"
"11",21,40,175,174,179,180,154,154,39,46,0,7,29,39,"win_A",-19,1,-1,0,0,1,0,0,1,0.867924528301887,0.743589743589744,0.735849056603774,0,"orthodox"
"12",21,32,175,180,179,188,154,154,38,33,0,4,28,28,"win_A",-11,-5,-9,0,0,0,0,0,1,0.891891891891892,0.736842105263158,0.756756756756757,0,"orthodox"
"19",19,32,175,167,179,173,150,149,31,31,0,1,23,23,"win_A",-13,8,6,1,0,0,0,0,1,0.96875,0.741935483870968,0.71875,0,"orthodox"
"25",18,26,175,180,179,188,147,147,25,23,0,2,18,21,"win_A",-8,-5,-9,0,0,0,0,0,1,0.92,0.72,0.84,0,"orthodox"
"28",18,28,175,173,179,183,147,147,22,16,0,1,15,15,"win_A",-10,2,-4,0,0,0,0,0,1,0.941176470588235,0.681818181818182,0.882352941176471,0,"orthodox"
"51",29,34,173,179,178,181,140,139,31,22,0,0,22,11,"win_A",-5,-6,-3,1,0,0,0,0,1,1,0.709677419354839,0.5,0,"orthodox"
"53",29,33,173,179,178,180,139,143,29,29,0,6,20,23,"win_A",-4,-6,-2,-4,0,0,0,0,1,0.828571428571429,0.689655172413793,0.657142857142857,0,"orthodox"
"56",28,33,173,169,178,183,140,140,26,29,0,1,18,20,"win_A",-5,4,-5,0,0,0,0,0,1,0.966666666666667,0.692307692307692,0.666666666666667,0,"orthodox"
"58",27,33,173,173,178,173,135,134,24,29,0,6,17,17,"win_A",-6,0,5,1,0,0,0,0,1,0.828571428571429,0.708333333333333,0.485714285714286,0,"orthodox"
"69",23,30,173,165,178,168,139,139,13,20,0,11,10,11,"win_A",-7,8,10,0,0,0,0,0,1,0.645161290322581,0.769230769230769,0.354838709677419,0,"orthodox"
"74",22,29,173,170,178,169,137,137,8,9,0,14,5,6,"win_A",-7,3,9,0,0,0,0,0,1,0.391304347826087,0.625,0.260869565217391,0,"orthodox"
"98",33,28,179,178,178,188,159,160,32,19,0,1,29,6,"win_A",5,1,-10,-1,0,0,0,0,1,0.95,0.90625,0.3,0,"orthodox"
"104",31,31,179,178,178,180,159,159,26,29,0,4,23,20,"win_A",0,1,-2,0,0,0,0,0,1,0.878787878787879,0.884615384615385,0.606060606060606,0,"orthodox"
"106",30,27,179,182,178,182,160,159,24,21,0,5,21,13,"win_A",3,-3,-4,1,0,0,0,0,1,0.807692307692308,0.875,0.5,0,"orthodox"
"107",30,27,179,180,178,178,159,159,23,28,0,1,20,21,"win_A",3,-1,0,0,0,0,0,0,1,0.96551724137931,0.869565217391304,0.724137931034483,0,"orthodox"
"110",29,32,179,173,178,180,160,158,20,27,0,7,17,17,"win_A",-3,6,-2,2,0,0,0,0,1,0.794117647058823,0.85,0.5,0,"orthodox"
"157",29,26,171,160,179,161,115,115,26,18,2,3,12,17,"win_B",3,11,18,0,0,0,0,0,0.928571428571429,0.857142857142857,0.428571428571429,0.80952380952381,1,"orthodox"
"182",26,30,198,201,208,207,243,255,16,17,0,0,16,15,"win_A",-4,-3,1,-12,0,0,0,0,1,1,1,0.882352941176471,0,"orthodox"
"183",29,26,196,198,203,208,244,245,23,15,0,0,21,15,"win_B",3,-2,-5,-1,0,0,0,0,1,1,0.91304347826087,1,1,"southpaw"
"184",26,27,198,193,208,198,245,247,14,16,0,0,14,13,"win_A",-1,5,10,-2,0,0,0,0,1,1,1,0.8125,0,"orthodox"
"187",25,34,198,193,208,191,248,236,11,36,0,10,11,28,"win_A",-9,5,17,12,0,0,0,0,1,0.782608695652174,1,0.608695652173913,0,"orthodox"
"188",25,37,198,188,208,193,245,244,10,26,0,19,10,11,"win_A",-12,10,15,1,0,1,0,0,1,0.577777777777778,1,0.244444444444444,0,"orthodox"
"212",21,36,170,165,180,173,132,132,19,40,0,14,16,24,"win_A",-15,5,7,0,0,1,0,0,1,0.740740740740741,0.842105263157895,0.444444444444444,0,"orthodox"
"233",27,28,171,170,175,177,146,147,26,26,0,1,22,16,"win_A",-1,1,-2,-1,0,0,0,0,1,0.962962962962963,0.846153846153846,0.592592592592593,0,"orthodox"
"235",26,31,171,175,175,180,147,147,24,32,0,2,21,18,"win_A",-5,-4,-5,0,0,0,0,0,1,0.941176470588235,0.875,0.529411764705882,0,"orthodox"
"251",20,25,171,173,175,178,152,149,8,26,0,36,8,6,"win_A",-5,-2,-3,3,0,0,0,0,1,0.419354838709677,1,0.0967741935483871,0,"orthodox"
"260",22,28,165,165,167,177,120,119,24,31,0,2,18,17,"win_A",-6,0,-10,1,0,0,0,0,1,0.939393939393939,0.75,0.515151515151515,0,"southpaw"
"261",22,34,165,170,167,174,118,118,23,27,0,0,17,19,"win_A",-12,-5,-7,0,0,0,0,0,1,1,0.739130434782609,0.703703703703704,0,"southpaw"
"265",21,24,165,163,167,168,118,118,19,29,0,3,13,22,"win_A",-3,2,-1,0,0,0,0,0,1,0.90625,0.684210526315789,0.6875,0,"southpaw"
"292",27,37,175,180,173,178,146,146,10,31,0,2,8,14,"win_A",-10,-5,-5,0,0,1,0,0,1,0.939393939393939,0.8,0.424242424242424,0,"orthodox"
"304",29,28,165,171,157,175,125,125,23,32,0,1,14,18,"win_B",1,-6,-18,0,0,0,0,0,1,0.96969696969697,0.608695652173913,0.545454545454545,1,"orthodox"
"310",26,26,171,170,175,168,121,122,27,17,0,2,15,6,"win_A",0,1,7,-1,0,0,0,0,1,0.894736842105263,0.555555555555556,0.315789473684211,0,"orthodox"
"311",25,32,171,168,175,173,122,122,26,49,0,7,15,24,"win_A",-7,3,2,0,0,0,0,0,1,0.875,0.576923076923077,0.428571428571429,0,"orthodox"
"314",24,34,171,166,175,174,122,121,23,36,0,4,13,28,"win_A",-10,5,1,1,0,0,0,0,1,0.9,0.565217391304348,0.7,0,"orthodox"
"317",24,36,171,169,175,178,117,118,20,46,0,3,11,23,"win_A",-12,2,-3,-1,0,1,0,0,1,0.938775510204082,0.55,0.469387755102041,0,"orthodox"
"318",23,32,171,170,175,180,117,117,19,20,0,3,11,12,"win_A",-9,1,-5,0,0,0,0,0,1,0.869565217391304,0.578947368421053,0.521739130434783,0,"orthodox"
"323",21,22,168,171,171,175,117,117,20,14,2,0,10,6,"win_B",-1,-3,-4,0,0,0,0,0,0.909090909090909,1,0.454545454545455,0.428571428571429,1,"orthodox"
"324",22,28,171,168,175,178,119,121,13,4,0,1,5,2,"win_A",-6,3,-3,-2,0,0,0,0,1,0.8,0.384615384615385,0.4,0,"orthodox"
"329",20,21,171,161,175,168,119,118,8,6,0,1,2,4,"win_A",-1,10,7,1,0,0,0,0,1,0.857142857142857,0.25,0.571428571428571,0,"orthodox"
"330",20,38,171,160,175,168,119,117,7,27,0,14,2,18,"win_A",-18,11,7,2,0,1,0,0,1,0.658536585365854,0.285714285714286,0.439024390243902,0,"orthodox"
"332",19,22,171,163,175,173,117,117,5,5,0,2,2,2,"win_A",-3,8,2,0,0,0,0,0,1,0.714285714285714,0.4,0.285714285714286,0,"orthodox"
"333",19,24,171,165,175,173,117,117,4,7,0,8,2,5,"win_A",-5,6,2,0,0,0,0,0,1,0.466666666666667,0.5,0.333333333333333,0,"orthodox"
"336",19,25,171,165,175,173,112,116,1,2,0,0,1,1,"win_A",-6,6,2,-4,0,0,0,0,1,1,1,0.5,0,"orthodox"
"358",25,30,177,173,183,173,149,152,16,26,0,1,13,14,"win_A",-5,4,10,-3,0,0,0,0,1,0.962962962962963,0.8125,0.518518518518518,0,"southpaw"
"377",38,36,173,166,183,170,145,146,47,57,0,5,26,38,"win_A",2,7,13,-1,1,1,0,0,1,0.919354838709677,0.553191489361702,0.612903225806452,0,"orthodox"
"381",33,39,166,170,170,170,147,143,54,54,4,6,38,39,"win_B",-6,-4,0,4,0,1,0,0,0.931034482758621,0.9,0.655172413793103,0.65,1,"southpaw"
"382",28,33,168,166,175,170,147,146,28,54,0,3,12,38,"win_A",-5,2,5,1,0,0,0,0,1,0.947368421052632,0.428571428571429,0.666666666666667,0,"orthodox"
"383",32,38,166,170,170,170,143,142,53,53,3,5,38,39,"win_A",-6,-4,0,1,0,1,0,0,0.946428571428571,0.913793103448276,0.678571428571429,0.672413793103448,0,"southpaw"
"384",32,39,166,174,170,180,145,147,52,46,3,6,38,39,"win_A",-7,-8,-10,-2,0,1,0,0,0.945454545454545,0.884615384615385,0.690909090909091,0.75,0,"southpaw"
"387",30,29,166,170,170,170,144,145,49,34,3,1,37,27,"win_A",1,-4,0,-1,0,0,0,0,0.942307692307692,0.971428571428571,0.711538461538462,0.771428571428571,0,"southpaw"
"388",30,30,166,171,170,165,138,140,48,45,3,1,36,32,"win_A",0,-5,5,-2,0,0,0,0,0.941176470588235,0.978260869565217,0.705882352941177,0.695652173913043,0,"southpaw"
"389",35,29,179,166,185,170,142,145,39,47,5,3,30,35,"win_B",6,13,15,-3,1,0,0,0,0.886363636363636,0.94,0.681818181818182,0.7,1,"orthodox"
"391",29,34,166,170,170,170,129,130,45,48,3,3,34,35,"win_A",-5,-4,0,-1,0,0,0,0,0.9375,0.941176470588235,0.708333333333333,0.686274509803922,0,"southpaw"
"392",28,33,166,168,170,178,130,130,44,63,3,5,34,42,"win_A",-5,-2,-8,0,0,0,0,0,0.936170212765957,0.926470588235294,0.723404255319149,0.617647058823529,0,"southpaw"
"394",27,30,166,173,170,183,129,129,42,48,3,4,32,34,"win_A",-3,-7,-13,0,0,0,0,0,0.933333333333333,0.923076923076923,0.711111111111111,0.653846153846154,0,"southpaw"
"397",26,30,166,170,170,170,130,130,39,42,3,10,30,31,"win_A",-4,-4,0,0,0,0,0,0,0.928571428571429,0.807692307692308,0.714285714285714,0.596153846153846,0,"southpaw"
"400",24,29,166,168,170,178,125,126,37,57,2,3,28,40,"win_A",-5,-2,-8,-1,0,0,0,0,0.948717948717949,0.95,0.717948717948718,0.666666666666667,0,"southpaw"
"404",23,33,166,166,170,170,120,122,33,44,2,3,24,32,"win_A",-10,0,0,-2,0,0,0,0,0.942857142857143,0.936170212765957,0.685714285714286,0.680851063829787,0,"southpaw"
"405",22,29,166,168,170,175,121,122,32,33,2,1,23,22,"win_A",-7,-2,-5,-1,0,0,0,0,0.941176470588235,0.970588235294118,0.676470588235294,0.647058823529412,0,"southpaw"
"415",28,19,159,166,160,170,112,112,32,23,1,1,23,14,"win_B",9,-7,-10,0,0,0,0,0,0.96969696969697,0.958333333333333,0.696969696969697,0.583333333333333,1,"Unknown"
"454",33,24,180,180,196,193,168,168,14,11,1,1,11,6,"win_A",9,0,3,0,0,0,0,0,0.933333333333333,0.916666666666667,0.733333333333333,0.5,0,"southpaw"
"456",32,30,180,171,196,184,168,164,13,16,0,15,10,6,"win_B",2,9,12,4,0,0,0,0,1,0.516129032258065,0.769230769230769,0.193548387096774,1,"southpaw"
"464",29,33,180,180,196,182,167,167,5,12,0,12,5,4,"win_A",-4,0,14,0,0,0,0,0,1,0.5,1,0.166666666666667,0,"southpaw"
"470",30,27,165,168,157,165,127,127,23,33,1,3,14,24,"win_A",3,-3,-8,0,0,0,0,0,0.958333333333333,0.916666666666667,0.583333333333333,0.666666666666667,0,"orthodox"
"499",25,30,174,169,174,175,140,140,26,34,0,2,16,32,"win_A",-5,5,-1,0,0,0,0,0,1,0.944444444444444,0.615384615384615,0.888888888888889,0,"orthodox"
"502",24,25,174,174,174,180,139,139,23,26,0,2,14,18,"win_A",-1,0,-6,0,0,0,0,0,1,0.928571428571429,0.608695652173913,0.642857142857143,0,"orthodox"
"505",23,39,174,170,174,178,139,140,20,33,0,7,14,25,"win_A",-16,4,-4,-1,0,1,0,0,1,0.825,0.7,0.625,0,"orthodox"
"511",21,27,174,175,174,183,140,139,14,28,0,6,9,24,"win_A",-6,-1,-9,1,0,0,0,0,1,0.823529411764706,0.642857142857143,0.705882352941177,0,"orthodox"
"517",20,28,174,170,174,170,143,145,8,14,0,5,7,5,"win_A",-8,4,4,-2,0,0,0,0,1,0.736842105263158,0.875,0.263157894736842,0,"orthodox"
"529",23,36,165,167,169,172,115,115,11,32,0,9,9,13,"win_A",-13,-2,-3,0,0,1,0,0,1,0.780487804878049,0.818181818181818,0.317073170731707,0,"orthodox"
"530",23,31,165,165,169,170,115,115,10,38,0,7,8,18,"win_A",-8,0,-1,0,0,0,0,0,1,0.844444444444444,0.8,0.4,0,"orthodox"
"531",23,25,165,163,169,168,115,114,9,20,0,2,8,8,"win_A",-2,2,1,1,0,0,0,0,1,0.909090909090909,0.888888888888889,0.363636363636364,0,"orthodox"
"532",22,32,165,165,169,170,115,114,8,24,0,6,7,21,"win_A",-10,0,-1,1,0,0,0,0,1,0.8,0.875,0.7,0,"orthodox"
"535",20,28,165,162,169,163,108,108,5,29,0,2,4,18,"win_A",-8,3,6,0,0,0,0,0,1,0.935483870967742,0.8,0.580645161290323,0,"orthodox"
"537",20,26,165,168,169,171,108,108,3,18,0,1,3,8,"win_A",-6,-3,-2,0,0,0,0,0,1,0.947368421052632,1,0.421052631578947,0,"orthodox"
"551",23,28,164,170,163,175,127,127,17,32,0,3,10,30,"win_A",-5,-6,-12,0,0,0,0,0,1,0.914285714285714,0.588235294117647,0.857142857142857,0,"southpaw"
"552",23,23,164,173,163,178,126,128,16,9,0,1,10,3,"win_A",0,-9,-15,-2,0,0,0,0,1,0.9,0.625,0.3,0,"southpaw"
"554",22,31,164,168,163,173,128,128,14,21,0,18,9,10,"win_A",-9,-4,-10,0,0,0,0,0,1,0.538461538461538,0.642857142857143,0.256410256410256,0,"southpaw"
"564",21,20,164,170,163,173,126,127,4,4,0,3,2,4,"win_A",1,-6,-10,-1,0,0,0,0,1,0.571428571428571,0.5,0.571428571428571,0,"southpaw"
"576",25,33,170,173,177,173,147,147,21,40,0,8,14,29,"win_A",-8,-3,4,0,0,0,0,0,1,0.833333333333333,0.666666666666667,0.604166666666667,0,"orthodox"
"577",25,28,170,173,177,173,150,150,20,25,0,0,14,14,"win_A",-3,-3,4,0,0,0,0,0,1,1,0.7,0.56,0,"orthodox"
"580",23,31,170,175,177,182,144,146,17,25,0,4,13,14,"win_A",-8,-5,-5,-2,0,0,0,0,1,0.862068965517241,0.764705882352941,0.482758620689655,0,"orthodox"
"598",31,24,164,168,168,170,126,126,30,35,2,1,15,25,"win_A",7,-4,-2,0,0,0,0,0,0.9375,0.972222222222222,0.46875,0.694444444444444,0,"orthodox"
"599",31,29,164,168,168,173,126,124,29,28,2,1,15,21,"win_A",2,-4,-5,2,0,0,0,0,0.935483870967742,0.96551724137931,0.483870967741935,0.724137931034483,0,"orthodox"
"601",29,27,164,170,168,166,128,131,27,25,1,4,14,15,"win_A",2,-6,2,-3,0,0,0,0,0.964285714285714,0.862068965517241,0.5,0.517241379310345,0,"orthodox"
"604",32,27,165,164,178,168,126,126,44,25,4,0,35,13,"win_B",5,1,10,0,0,0,0,0,0.916666666666667,1,0.729166666666667,0.52,1,"southpaw"
"612",23,22,164,165,168,175,119,120,17,14,0,5,10,11,"win_A",1,-1,-7,-1,0,0,0,0,1,0.736842105263158,0.588235294117647,0.578947368421053,0,"orthodox"
"618",21,33,164,173,168,170,116,117,11,30,0,5,7,20,"win_A",-12,-9,-2,-1,0,0,0,0,1,0.857142857142857,0.636363636363636,0.571428571428571,0,"orthodox"
"621",20,35,164,168,168,173,118,119,8,5,0,5,5,2,"win_A",-15,-4,-5,-1,0,1,0,0,1,0.5,0.625,0.2,0,"orthodox"
"622",20,26,164,164,168,168,121,121,7,14,0,5,5,10,"win_A",-6,0,0,0,0,0,0,0,1,0.736842105263158,0.714285714285714,0.526315789473684,0,"orthodox"
"624",19,33,164,157,168,157,120,121,5,3,0,0,4,2,"win_A",-14,7,11,-1,0,0,0,0,1,1,0.8,0.666666666666667,0,"orthodox"
"630",28,26,180,180,184,178,167,168,25,16,1,0,19,10,"win_A",2,0,6,-1,0,0,0,0,0.961538461538462,1,0.730769230769231,0.625,0,"orthodox"
"666",21,35,163,166,168,170,122,122,15,36,0,11,11,27,"win_A",-14,-3,-2,0,0,1,0,0,1,0.765957446808511,0.733333333333333,0.574468085106383,0,"southpaw"
"670",21,33,163,163,168,170,123,121,11,14,0,8,8,6,"win_A",-12,0,-2,2,0,0,0,0,1,0.636363636363636,0.727272727272727,0.272727272727273,0,"southpaw"
"672",20,30,163,165,168,175,122,122,9,12,0,4,6,5,"win_A",-10,-2,-7,0,0,0,0,0,1,0.75,0.666666666666667,0.3125,0,"southpaw"
"674",20,23,163,165,168,165,122,122,7,5,0,7,5,5,"win_A",-3,-2,3,0,0,0,0,0,1,0.416666666666667,0.714285714285714,0.416666666666667,0,"southpaw"
"675",20,25,163,160,168,170,121,123,6,5,0,1,4,1,"win_A",-5,3,-2,-2,0,0,0,0,1,0.833333333333333,0.666666666666667,0.166666666666667,0,"southpaw"
"683",33,34,183,183,180,184,175,175,31,30,0,1,15,26,"win_A",-1,0,-4,0,0,0,0,0,1,0.967741935483871,0.483870967741935,0.838709677419355,0,"orthodox"
"684",32,33,183,183,180,184,175,175,30,30,0,0,15,26,"win_A",-1,0,-4,0,0,0,0,0,1,1,0.5,0.866666666666667,0,"orthodox"
"690",31,27,183,185,184,188,174,174,24,19,0,0,22,6,"win_A",4,-2,-4,0,0,0,0,0,1,1,0.916666666666667,0.315789473684211,0,"orthodox"
"695",29,34,183,189,184,193,175,175,19,21,0,4,17,8,"win_A",-5,-6,-9,0,0,0,0,0,1,0.84,0.894736842105263,0.32,0,"orthodox"
"696",29,27,183,180,184,191,173,175,18,12,0,1,16,8,"win_A",2,3,-7,-2,0,0,0,0,1,0.923076923076923,0.888888888888889,0.615384615384615,0,"orthodox"
"701",27,39,183,183,184,185,174,173,13,15,0,6,11,10,"win_A",-12,0,-1,1,0,1,0,0,1,0.714285714285714,0.846153846153846,0.476190476190476,0,"orthodox"
"704",27,33,183,183,184,188,174,176,10,22,0,5,9,16,"win_A",-6,0,-4,-2,0,0,0,0,1,0.814814814814815,0.9,0.592592592592593,0,"orthodox"
"719",33,22,160,163,166,165,108,108,35,18,1,2,21,12,"win_A",11,-3,1,0,0,0,0,0,0.972222222222222,0.9,0.583333333333333,0.6,0,"orthodox"
"722",31,26,160,169,166,173,108,108,32,19,1,1,18,10,"win_A",5,-9,-7,0,0,0,0,0,0.96969696969697,0.95,0.545454545454545,0.5,0,"orthodox"
"723",31,27,160,160,166,156,108,108,31,33,1,9,17,23,"win_A",4,0,10,0,0,0,0,0,0.96875,0.785714285714286,0.53125,0.547619047619048,0,"orthodox"
"726",29,29,160,174,166,180,108,108,28,16,1,2,16,9,"win_A",0,-14,-14,0,0,0,0,0,0.96551724137931,0.888888888888889,0.551724137931034,0.5,0,"orthodox"
"729",27,20,160,162,166,162,107,107,25,15,1,1,14,12,"win_A",7,-2,4,0,0,0,0,0,0.961538461538462,0.9375,0.538461538461538,0.75,0,"orthodox"
"730",27,28,160,168,166,160,105,105,24,27,1,3,14,12,"win_A",-1,-8,6,0,0,0,0,0,0.96,0.9,0.56,0.4,0,"orthodox"
"733",25,29,160,157,166,160,105,105,21,20,1,0,13,15,"win_A",-4,3,6,0,0,0,0,0,0.954545454545455,1,0.590909090909091,0.75,0,"orthodox"
"744",22,22,162,160,183,166,108,114,13,11,3,0,9,8,"win_A",0,2,17,-6,0,0,0,0,0.8125,1,0.5625,0.727272727272727,0,"orthodox"
"746",21,22,156,160,165,166,108,108,6,9,2,0,4,6,"win_B",-1,-4,-1,0,0,0,0,0,0.75,1,0.5,0.666666666666667,1,"orthodox"
"759",24,36,189,175,191,183,168,168,33,44,0,4,24,29,"win_A",-12,14,8,0,0,1,0,0,1,0.916666666666667,0.727272727272727,0.604166666666667,0,"southpaw"
"761",24,35,189,177,191,183,168,168,31,27,0,4,24,14,"win_A",-11,12,8,0,0,1,0,0,1,0.870967741935484,0.774193548387097,0.451612903225806,0,"southpaw"
"765",22,33,189,183,191,191,168,167,27,33,0,6,21,25,"win_A",-11,6,0,1,0,0,0,0,1,0.846153846153846,0.777777777777778,0.641025641025641,0,"southpaw"
"767",22,29,189,168,191,188,165,165,25,20,0,10,20,13,"win_A",-7,21,3,0,0,0,0,0,1,0.666666666666667,0.8,0.433333333333333,0,"southpaw"
"801",26,36,182,183,185,203,161,161,24,15,1,7,21,10,"win_A",-10,-1,-18,0,0,1,0,0,0.96,0.681818181818182,0.84,0.454545454545455,0,"orthodox"
"806",30,23,180,182,178,185,160,159,16,20,0,0,13,17,"win_A",7,-2,-7,1,0,0,0,0,1,1,0.8125,0.85,0,"orthodox"
"810",22,35,182,171,185,184,162,162,16,20,0,3,14,12,"win_A",-13,11,1,0,0,1,0,0,1,0.869565217391304,0.875,0.521739130434783,0,"orthodox"
"811",22,30,182,170,185,178,163,162,15,19,0,1,14,12,"win_A",-8,12,7,1,0,0,0,0,1,0.95,0.933333333333333,0.6,0,"orthodox"
"814",21,31,182,175,185,183,162,165,12,14,0,3,11,3,"win_A",-10,7,2,-3,0,0,0,0,1,0.823529411764706,0.916666666666667,0.176470588235294,0,"orthodox"
"822",21,23,182,188,185,196,163,158,4,5,0,7,4,3,"win_A",-2,-6,-11,5,0,0,0,0,1,0.416666666666667,1,0.25,0,"orthodox"
"825",20,36,182,170,185,198,163,160,1,1,0,1,1,1,"win_A",-16,12,-13,3,0,1,0,0,1,0.5,1,0.5,0,"orthodox"
"854",42,25,168,183,183,187,153,153,34,21,5,0,19,16,"win_B",17,-15,-4,0,1,0,0,0,0.871794871794872,1,0.487179487179487,0.761904761904762,1,"orthodox"
"855",24,23,183,180,187,180,157,155,20,12,0,2,16,10,"win_A",1,3,7,2,0,0,0,0,1,0.857142857142857,0.8,0.714285714285714,0,"orthodox"
"856",24,37,183,174,187,180,154,154,19,22,0,2,15,9,"win_A",-13,9,7,0,0,1,0,0,1,0.916666666666667,0.789473684210526,0.375,0,"orthodox"
"858",23,35,183,173,187,177,158,158,17,22,0,12,13,14,"win_A",-12,10,10,0,0,1,0,0,1,0.647058823529412,0.764705882352941,0.411764705882353,0,"orthodox"
"870",19,21,183,183,187,196,150,150,5,3,0,5,2,3,"win_A",-2,0,-9,0,0,0,0,0,1,0.375,0.4,0.375,0,"orthodox"
"878",28,33,168,170,173,178,138,139,34,24,0,2,28,14,"win_A",-5,-2,-5,-1,0,0,0,0,1,0.923076923076923,0.823529411764706,0.538461538461538,0,"orthodox"
"892",22,26,168,168,173,163,126,126,20,22,0,6,17,14,"win_A",-4,0,10,0,0,0,0,0,1,0.785714285714286,0.85,0.5,0,"orthodox"
"898",20,32,168,168,173,183,127,127,14,34,0,6,12,23,"win_A",-12,0,-10,0,0,0,0,0,1,0.85,0.857142857142857,0.575,0,"orthodox"
"902",20,28,168,165,173,168,130,130,10,5,0,3,8,0,"win_A",-8,3,5,0,0,0,0,0,1,0.625,0.8,0,0,"orthodox"
"909",18,23,168,170,173,175,127,126,3,4,0,9,2,1,"win_A",-5,-2,-2,1,0,0,0,0,1,0.307692307692308,0.666666666666667,0.0769230769230769,0,"orthodox"
"914",26,27,178,175,183,178,130,130,17,16,0,1,15,6,"win_A",-1,3,5,0,0,0,0,0,1,0.941176470588235,0.882352941176471,0.352941176470588,0,"southpaw"
"915",26,30,178,170,183,175,130,130,16,26,0,3,14,18,"win_A",-4,8,8,0,0,0,0,0,1,0.896551724137931,0.875,0.620689655172414,0,"southpaw"
"917",25,22,178,173,183,178,131,129,14,18,0,5,12,9,"win_A",3,5,5,2,0,0,0,0,1,0.782608695652174,0.857142857142857,0.391304347826087,0,"southpaw"
"923",24,27,178,173,183,183,130,129,8,7,0,1,6,5,"win_A",-3,5,0,1,0,0,0,0,1,0.875,0.75,0.625,0,"southpaw"
"939",28,27,173,168,175,169,137,132,36,26,3,11,23,16,"win_A",1,5,6,5,0,0,0,0,0.923076923076923,0.702702702702703,0.58974358974359,0.432432432432432,0,"orthodox"
"943",27,30,173,180,175,188,135,135,32,16,3,7,20,7,"win_A",-3,-7,-13,0,0,0,0,0,0.914285714285714,0.695652173913043,0.571428571428571,0.304347826086957,0,"orthodox"
"948",25,37,173,165,175,165,133,133,29,44,1,7,18,30,"win_A",-12,8,10,0,0,1,0,0,0.966666666666667,0.862745098039216,0.6,0.588235294117647,0,"orthodox"
"950",24,38,173,166,175,178,130,129,27,34,1,7,18,15,"win_A",-14,7,-3,1,0,1,0,0,0.964285714285714,0.829268292682927,0.642857142857143,0.365853658536585,0,"orthodox"
"954",22,26,173,174,175,174,126,126,24,22,0,6,15,9,"win_A",-4,-1,1,0,0,0,0,0,1,0.785714285714286,0.625,0.321428571428571,0,"orthodox"
"955",21,30,173,170,175,177,126,126,23,59,0,5,14,37,"win_A",-9,3,-2,0,0,0,0,0,1,0.921875,0.608695652173913,0.578125,0,"orthodox"
"957",21,23,173,168,175,163,128,128,21,14,0,3,12,11,"win_A",-2,5,12,0,0,0,0,0,1,0.823529411764706,0.571428571428571,0.647058823529412,0,"orthodox"
"982",32,30,170,168,174,177,118,117,23,35,0,3,17,12,"win_A",2,2,-3,1,0,0,0,0,1,0.921052631578947,0.739130434782609,0.315789473684211,0,"southpaw"
"990",29,36,170,166,174,164,118,118,15,37,0,4,11,27,"win_A",-7,4,10,0,0,1,0,0,1,0.902439024390244,0.733333333333333,0.658536585365854,0,"southpaw"
"991",29,26,170,166,174,168,118,118,14,24,0,2,10,18,"win_A",3,4,6,0,0,0,0,0,1,0.923076923076923,0.714285714285714,0.692307692307692,0,"southpaw"
"993",28,31,170,163,174,170,119,119,12,11,0,2,8,4,"win_A",-3,7,4,0,0,0,0,0,1,0.846153846153846,0.666666666666667,0.307692307692308,0,"southpaw"
"1025",26,29,175,171,188,184,155,153,6,16,0,11,4,6,"win_A",-3,4,4,2,0,0,0,0,1,0.592592592592593,0.666666666666667,0.222222222222222,0,"southpaw"
"1062",24,28,174,170,175,165,125,126,11,22,1,8,3,9,"win_A",-4,4,10,-1,0,0,0,0,0.916666666666667,0.733333333333333,0.25,0.3,0,"orthodox"
"1074",24,31,192,191,193,203,199,200,25,22,0,0,18,21,"win_A",-7,1,-10,-1,0,0,0,0,1,1,0.72,0.954545454545455,0,"orthodox"
"1079",21,35,192,183,193,191,197,198,20,25,0,6,14,14,"win_A",-14,9,2,-1,0,1,0,0,1,0.806451612903226,0.7,0.451612903225806,0,"orthodox"
"1130",26,26,182,173,183,185,167,166,20,17,2,3,15,10,"win_A",0,9,-2,1,0,0,0,0,0.909090909090909,0.85,0.681818181818182,0.5,0,"orthodox"
"1191",34,30,177,185,183,185,168,168,26,16,3,0,13,11,"win_A",4,-8,-2,0,0,0,0,0,0.896551724137931,1,0.448275862068966,0.6875,0,"Unknown"
"1194",29,34,185,180,185,191,170,170,13,17,0,7,9,17,"win_A",-5,5,-6,0,0,0,0,0,1,0.708333333333333,0.692307692307692,0.708333333333333,0,"orthodox"
"1199",28,35,185,183,185,198,171,173,8,10,0,4,7,7,"win_A",-7,2,-13,-2,0,1,0,0,1,0.714285714285714,0.875,0.5,0,"orthodox"
"1256",27,34,188,196,191,193,226,255,10,37,0,11,8,15,"win_A",-7,-8,-2,-29,0,0,0,1,1,0.770833333333333,0.8,0.3125,0,"orthodox"
"1270",27,35,160,161,163,170,111,112,42,51,0,8,36,30,"win_A",-8,-1,-7,-1,0,1,0,0,1,0.864406779661017,0.857142857142857,0.508474576271186,0,"orthodox"
"1272",27,28,160,160,163,166,112,111,40,33,0,7,34,19,"win_A",-1,0,-3,1,0,0,0,0,1,0.825,0.85,0.475,0,"orthodox"
"1273",27,31,160,160,163,165,112,112,39,20,0,3,33,10,"win_A",-4,0,-2,0,0,0,0,0,1,0.869565217391304,0.846153846153846,0.434782608695652,0,"orthodox"
"1276",26,28,160,166,163,172,113,113,36,32,0,6,30,23,"win_A",-2,-6,-9,0,0,0,0,0,1,0.842105263157895,0.833333333333333,0.605263157894737,0,"orthodox"
"1285",23,29,160,168,163,160,108,108,27,30,0,7,23,15,"win_A",-6,-8,3,0,0,0,0,0,1,0.810810810810811,0.851851851851852,0.405405405405405,0,"orthodox"
"1320",23,28,180,182,185,182,153,154,22,21,0,7,11,13,"win_A",-5,-2,3,-1,0,0,0,0,1,0.75,0.5,0.464285714285714,0,"orthodox"
"1346",25,27,163,160,168,152,112,112,32,39,2,5,23,28,"win_A",-2,3,16,0,0,0,0,0,0.941176470588235,0.886363636363636,0.676470588235294,0.636363636363636,0,"orthodox"
"1349",24,32,163,160,168,168,112,112,29,32,2,3,21,28,"win_A",-8,3,0,0,0,0,0,0,0.935483870967742,0.914285714285714,0.67741935483871,0.8,0,"orthodox"
"1350",24,26,163,165,168,168,112,112,28,27,2,3,20,6,"win_A",-2,-2,0,0,0,0,0,0,0.933333333333333,0.9,0.666666666666667,0.2,0,"orthodox"
"1365",20,26,163,162,168,165,116,116,14,12,0,8,12,5,"win_A",-6,1,3,0,0,0,0,0,1,0.6,0.857142857142857,0.25,0,"orthodox"
"1389",29,32,165,172,169,178,135,135,49,23,11,5,37,19,"win_A",-3,-7,-9,0,0,0,0,0,0.816666666666667,0.821428571428571,0.616666666666667,0.678571428571429,0,"orthodox"
"1401",24,26,173,165,173,169,130,130,20,38,3,10,18,28,"win_A",-2,8,4,0,0,0,0,0,0.869565217391304,0.791666666666667,0.782608695652174,0.583333333333333,0,"orthodox"
"1406",25,28,165,164,169,170,135,136,35,25,8,10,27,17,"win_A",-3,1,-1,-1,0,0,0,0,0.813953488372093,0.714285714285714,0.627906976744186,0.485714285714286,0,"orthodox"
"1410",25,37,165,173,169,170,129,128,32,30,7,8,24,20,"win_A",-12,-8,-1,1,0,1,0,0,0.82051282051282,0.789473684210526,0.615384615384615,0.526315789473684,0,"orthodox"
"1415",24,24,168,165,175,169,126,126,22,28,2,6,14,20,"win_A",0,3,6,0,0,0,0,0,0.916666666666667,0.823529411764706,0.583333333333333,0.588235294117647,0,"orthodox"
"1416",20,24,170,165,165,169,126,126,21,28,0,5,15,20,"win_A",-4,5,-4,0,0,0,0,0,1,0.848484848484849,0.714285714285714,0.606060606060606,0,"Unknown"
"1421",24,22,170,165,168,169,127,127,22,25,3,3,16,17,"win_A",2,5,-1,0,0,0,0,0,0.88,0.892857142857143,0.64,0.607142857142857,0,"orthodox"
"1422",28,22,173,165,175,169,129,129,35,25,1,2,26,17,"win_A",6,8,6,0,0,0,0,0,0.972222222222222,0.925925925925926,0.722222222222222,0.62962962962963,0,"orthodox"
"1429",21,37,165,159,169,160,124,124,20,49,0,19,14,29,"win_A",-16,6,9,0,0,1,0,0,1,0.720588235294118,0.7,0.426470588235294,0,"orthodox"
"1433",20,34,165,168,169,171,125,124,16,56,0,16,12,40,"win_A",-14,-3,-2,1,0,0,0,0,1,0.777777777777778,0.75,0.555555555555556,0,"orthodox"
"1434",20,32,165,159,169,170,122,124,15,32,0,10,11,15,"win_A",-12,6,-1,-2,0,0,0,0,1,0.761904761904762,0.733333333333333,0.357142857142857,0,"orthodox"
"1441",19,34,165,159,169,160,124,122,8,48,0,17,5,28,"win_A",-15,6,9,2,0,0,0,0,1,0.738461538461539,0.625,0.430769230769231,0,"orthodox"
"1442",18,23,165,165,169,170,126,127,7,19,0,7,4,12,"win_A",-5,0,-1,-1,0,0,0,0,1,0.730769230769231,0.571428571428571,0.461538461538462,0,"orthodox"
"1474",35,32,188,193,185,201,178,177,18,8,1,1,13,4,"win_A",3,-5,-16,1,1,0,0,0,0.947368421052632,0.888888888888889,0.684210526315789,0.444444444444444,0,"orthodox"
"1476",32,34,183,188,180,185,174,175,28,17,0,0,15,12,"win_A",-2,-5,-5,-1,0,0,0,0,1,1,0.535714285714286,0.705882352941177,0,"orthodox"
"1477",33,32,188,179,185,178,172,174,16,27,0,2,11,17,"win_A",1,9,7,-2,0,0,0,0,1,0.931034482758621,0.6875,0.586206896551724,0,"orthodox"
"1480",32,35,188,180,185,183,175,174,13,18,0,4,8,12,"win_A",-3,8,2,1,0,1,0,0,1,0.818181818181818,0.615384615384615,0.545454545454545,0,"orthodox"
"1487",35,29,185,188,201,185,196,197,30,6,11,0,26,5,"win_B",6,-3,16,-1,1,0,0,0,0.731707317073171,1,0.634146341463415,0.833333333333333,1,"orthodox"
"1515",25,35,183,183,192,191,180,179,1,17,0,21,1,9,"win_A",-10,0,1,1,0,1,0,0,1,0.447368421052632,1,0.236842105263158,0,"orthodox"
"1636",30,24,168,164,171,169,108,108,25,18,2,1,11,12,"win_A",6,4,2,0,0,0,0,0,0.925925925925926,0.947368421052632,0.407407407407407,0.631578947368421,0,"orthodox"
"1637",29,28,168,156,171,159,108,108,24,24,2,1,11,15,"win_A",1,12,12,0,0,0,0,0,0.923076923076923,0.96,0.423076923076923,0.6,0,"orthodox"
"1641",28,39,168,155,171,157,108,108,20,32,2,8,8,13,"win_A",-11,13,14,0,0,1,0,0,0.909090909090909,0.8,0.363636363636364,0.325,0,"orthodox"
"1646",24,27,168,162,171,163,108,108,15,9,1,1,6,1,"win_A",-3,6,8,0,0,0,0,0,0.9375,0.9,0.375,0.1,0,"orthodox"
"1684",21,38,163,157,168,168,116,116,13,28,0,40,13,16,"win_A",-17,6,0,0,0,1,0,0,1,0.411764705882353,1,0.235294117647059,0,"orthodox"
"1704",24,45,185,177,194,178,153,157,14,23,0,11,8,11,"win_A",-21,8,16,-4,0,1,0,0,1,0.676470588235294,0.571428571428571,0.323529411764706,0,"orthodox"
"1709",23,36,185,180,194,182,157,158,9,14,0,10,5,11,"win_A",-13,5,12,-1,0,1,0,0,1,0.583333333333333,0.555555555555556,0.458333333333333,0,"orthodox"
"1734",22,32,180,170,193,178,135,135,5,11,0,8,5,4,"win_A",-10,10,15,0,0,0,0,0,1,0.578947368421053,1,0.210526315789474,0,"orthodox"
"1756",31,23,155,178,157,183,117,118,19,12,7,2,1,5,"win_B",8,-23,-26,-1,0,0,0,0,0.730769230769231,0.857142857142857,0.0384615384615385,0.357142857142857,1,"orthodox"
"1765",20,21,178,173,183,171,115,116,5,4,0,2,0,1,"win_A",-1,5,12,-1,0,0,0,0,1,0.666666666666667,0,0.166666666666667,0,"orthodox"
"1771",32,32,173,169,178,168,130,130,23,25,1,3,17,15,"win_A",0,4,10,0,0,0,0,0,0.958333333333333,0.892857142857143,0.708333333333333,0.535714285714286,0,"orthodox"
"1775",29,31,173,166,178,175,129,130,19,34,0,3,13,31,"win_A",-2,7,3,-1,0,0,0,0,1,0.918918918918919,0.684210526315789,0.837837837837838,0,"orthodox"
"1776",29,26,173,178,178,180,130,130,18,17,0,1,13,8,"win_A",3,-5,-2,0,0,0,0,0,1,0.944444444444444,0.722222222222222,0.444444444444444,0,"orthodox"
"1778",28,25,173,168,178,170,130,129,16,16,0,0,13,7,"win_A",3,5,8,1,0,0,0,0,1,1,0.8125,0.4375,0,"orthodox"
"1799",20,25,164,163,161,166,105,105,5,11,0,1,2,9,"win_A",-5,1,-5,0,0,0,0,0,1,0.916666666666667,0.4,0.75,0,"orthodox"
"1800",19,27,164,162,161,154,105,105,4,24,0,1,2,13,"win_A",-8,2,7,0,0,0,0,0,1,0.96,0.5,0.52,0,"orthodox"
"1802",19,21,164,160,161,165,105,105,2,17,0,7,0,4,"win_A",-2,4,-4,0,0,0,0,0,1,0.708333333333333,0,0.166666666666667,0,"orthodox"
"1835",31,34,201,198,211,208,222,239,37,18,0,0,36,12,"win_A",-3,3,3,-17,0,0,0,1,1,1,0.972972972972973,0.666666666666667,0,"orthodox"
"1840",29,36,201,188,211,196,219,239,32,24,0,1,32,21,"win_A",-7,13,15,-20,0,1,0,1,1,0.96,1,0.84,0,"orthodox"
"1841",28,37,201,188,211,193,224,247,31,25,0,16,31,11,"win_A",-9,13,18,-23,0,1,0,1,1,0.609756097560976,1,0.268292682926829,0,"orthodox"
"1842",28,33,201,193,211,206,227,238,30,36,0,1,30,13,"win_A",-5,8,5,-11,0,0,0,0,1,0.972972972972973,1,0.351351351351351,0,"orthodox"
"1844",27,37,201,193,211,189,224,232,28,25,0,5,28,16,"win_A",-10,8,22,-8,0,1,0,0,1,0.833333333333333,1,0.533333333333333,0,"orthodox"
"1846",27,35,201,188,211,188,225,240,26,15,0,8,26,13,"win_A",-8,13,23,-15,0,1,0,1,1,0.652173913043478,1,0.565217391304348,0,"orthodox"
"1850",26,36,201,187,211,198,217,243,22,29,0,10,22,20,"win_A",-10,14,13,-26,0,1,0,1,1,0.743589743589744,1,0.512820512820513,0,"orthodox"
"1860",24,34,201,189,211,213,217,222,12,17,0,20,12,11,"win_A",-10,12,-2,-5,0,0,0,0,1,0.459459459459459,1,0.297297297297297,0,"orthodox"
"1863",24,26,201,183,211,203,218,291,9,4,0,7,9,0,"win_A",-2,18,8,-73,0,0,0,1,1,0.363636363636364,1,0,0,"orthodox"
"1894",25,28,166,168,168,179,126,125,19,26,0,0,17,23,"win_A",-3,-2,-11,1,0,0,0,0,1,1,0.894736842105263,0.884615384615385,0,"orthodox"
"1904",23,33,166,168,168,175,129,130,9,10,0,4,9,1,"win_A",-10,-2,-7,-1,0,0,0,0,1,0.714285714285714,1,0.0714285714285714,0,"orthodox"
"1911",22,24,166,170,168,175,128,128,2,1,0,2,2,0,"win_A",-2,-4,-7,0,0,0,0,0,1,0.333333333333333,1,0,0,"orthodox"
"1923",23,30,178,175,180,180,148,147,19,18,0,1,9,4,"win_A",-7,3,0,1,0,0,0,0,1,0.947368421052632,0.473684210526316,0.210526315789474,0,"orthodox"
"1927",22,35,178,168,180,183,142,138,15,39,0,14,8,25,"win_A",-13,10,-3,4,0,1,0,0,1,0.735849056603774,0.533333333333333,0.471698113207547,0,"orthodox"
"1928",21,32,178,180,180,188,143,145,14,29,0,5,7,19,"win_A",-11,-2,-8,-2,0,0,0,0,1,0.852941176470588,0.5,0.558823529411765,0,"orthodox"
"1930",21,28,178,175,180,178,140,141,12,17,0,8,7,2,"win_A",-7,3,2,-1,0,0,0,0,1,0.68,0.583333333333333,0.08,0,"orthodox"
"1933",20,31,178,175,180,168,142,141,9,26,0,14,4,15,"win_A",-11,3,12,1,0,0,0,0,1,0.65,0.444444444444444,0.375,0,"orthodox"
"1937",20,20,178,168,180,178,140,141,5,6,0,1,2,2,"win_A",0,10,2,-1,0,0,0,0,1,0.857142857142857,0.4,0.285714285714286,0,"orthodox"
"1950",35,42,193,191,213,198,233,229,20,35,0,10,17,20,"win_A",-7,2,15,4,1,1,0,0,1,0.777777777777778,0.85,0.444444444444444,0,"southpaw"
"1956",32,36,193,185,213,201,236,215,14,32,0,13,12,28,"win_A",-4,8,12,21,0,1,1,0,1,0.711111111111111,0.857142857142857,0.622222222222222,0,"southpaw"
"1960",37,32,179,193,191,213,234,224,22,10,9,0,18,8,"win_B",5,-14,-22,10,1,0,0,0,0.709677419354839,1,0.580645161290323,0.8,1,"orthodox"
"1977",31,23,162,173,173,178,122,122,10,22,0,1,8,15,"win_A",8,-11,-5,0,0,0,0,0,1,0.956521739130435,0.8,0.652173913043478,0,"southpaw"
"1978",31,25,162,168,173,183,122,122,9,17,0,1,7,7,"win_A",6,-6,-10,0,0,0,0,0,1,0.944444444444444,0.777777777777778,0.388888888888889,0,"southpaw"
"1982",29,34,162,163,173,168,122,122,5,33,0,18,4,26,"win_A",-5,-1,5,0,0,0,0,0,1,0.647058823529412,0.8,0.509803921568627,0,"southpaw"
"1991",30,29,188,183,195,191,198,199,38,24,2,0,26,15,"win_B",1,5,4,-1,0,0,0,0,0.95,1,0.65,0.625,1,"orthodox"
"1998",26,23,183,193,191,196,198,200,17,14,0,1,11,9,"win_A",3,-10,-5,-2,0,0,0,0,1,0.933333333333333,0.647058823529412,0.6,0,"southpaw"
"2020",22,20,163,161,164,162,118,118,25,15,2,3,9,7,"win_A",2,2,2,0,0,0,0,0,0.925925925925926,0.833333333333333,0.333333333333333,0.388888888888889,0,"southpaw"
"2025",21,20,163,163,168,164,113,114,19,21,2,1,15,8,"win_A",1,0,4,-1,0,0,0,0,0.904761904761905,0.954545454545455,0.714285714285714,0.363636363636364,0,"orthodox"
"2030",19,23,163,163,164,163,114,113,16,4,1,4,5,3,"win_A",-4,0,1,1,0,0,0,0,0.941176470588235,0.5,0.294117647058824,0.375,0,"southpaw"
"2051",28,30,175,175,180,178,134,134,13,23,1,4,11,12,"win_A",-2,0,2,0,0,0,0,0,0.928571428571429,0.851851851851852,0.785714285714286,0.444444444444444,0,"southpaw"
"2077",28,21,180,178,187,175,141,143,17,15,0,1,9,9,"win_A",7,2,12,-2,0,0,0,0,1,0.9375,0.529411764705882,0.5625,0,"orthodox"
"2100",28,32,180,171,185,169,130,130,20,52,0,5,12,8,"win_A",-4,9,16,0,0,0,0,0,1,0.912280701754386,0.6,0.140350877192982,0,"orthodox"
"2106",25,21,180,170,185,170,130,130,14,15,0,0,11,3,"win_A",4,10,15,0,0,0,0,0,1,1,0.785714285714286,0.2,0,"orthodox"
"2127",31,27,191,187,188,188,199,199,22,28,2,1,14,14,"win_A",4,4,0,0,0,0,0,0,0.916666666666667,0.96551724137931,0.583333333333333,0.482758620689655,0,"orthodox"
"2205",32,25,165,155,166,155,108,108,23,16,5,8,15,11,"win_A",7,10,11,0,0,0,0,0,0.821428571428571,0.666666666666667,0.535714285714286,0.458333333333333,0,"southpaw"
"2209",25,30,160,165,163,166,105,105,30,20,4,4,20,14,"win_A",-5,-5,-3,0,0,0,0,0,0.882352941176471,0.833333333333333,0.588235294117647,0.583333333333333,0,"southpaw"
"2236",28,29,185,191,187,188,154,154,22,25,0,2,15,15,"win_A",-1,-6,-1,0,0,0,0,0,1,0.925925925925926,0.681818181818182,0.555555555555556,0,"southpaw"
"2245",23,40,185,178,187,185,157,156,13,28,0,12,9,16,"win_A",-17,7,2,1,0,1,0,0,1,0.7,0.692307692307692,0.4,0,"southpaw"
"2313",30,24,163,168,165,169,115,114,17,24,0,1,8,16,"win_B",6,-5,-4,1,0,0,0,0,1,0.96,0.470588235294118,0.64,1,"southpaw"
"2323",20,29,168,170,169,165,114,114,14,12,1,3,6,11,"win_A",-9,-2,4,0,0,0,0,0,0.933333333333333,0.8,0.4,0.733333333333333,0,"southpaw"
"2381",26,28,175,170,183,172,114,115,18,19,3,0,16,3,"win_A",-2,5,11,-1,0,0,0,0,0.857142857142857,1,0.761904761904762,0.157894736842105,0,"southpaw"
"2403",22,23,166,171,171,177,132,130,18,19,0,0,17,13,"win_A",-1,-5,-6,2,0,0,0,0,1,1,0.944444444444444,0.684210526315789,0,"southpaw"
"2404",22,31,166,171,171,168,130,130,17,21,0,0,16,14,"win_A",-9,-5,3,0,0,0,0,0,1,1,0.941176470588235,0.666666666666667,0,"southpaw"
"2425",25,27,187,185,192,173,159,163,24,22,0,0,12,7,"win_B",-2,2,19,-4,0,0,0,0,1,1,0.5,0.318181818181818,1,"orthodox"
"2452",30,29,169,175,175,183,141,140,33,31,2,1,31,16,"win_A",1,-6,-8,1,0,0,0,0,0.942857142857143,0.96875,0.885714285714286,0.5,0,"orthodox"
"2453",29,31,175,175,183,188,139,140,30,28,1,5,15,16,"win_A",-2,0,-5,-1,0,0,0,0,0.967741935483871,0.848484848484849,0.483870967741935,0.484848484848485,0,"orthodox"
"2454",25,27,174,175,180,183,140,139,26,29,1,1,18,15,"win_B",-2,-1,-3,1,0,0,0,0,0.962962962962963,0.966666666666667,0.666666666666667,0.5,1,"orthodox"
"2457",26,25,168,175,175,183,139,138,24,27,0,0,11,13,"win_A",1,-7,-8,1,0,0,0,0,1,1,0.458333333333333,0.481481481481481,0,"orthodox"
"2459",24,33,175,168,183,178,140,140,25,19,0,1,12,11,"win_A",-9,7,5,0,0,0,0,0,1,0.95,0.48,0.55,0,"orthodox"
"2460",24,31,175,173,183,183,141,141,24,24,0,13,11,8,"win_A",-7,2,0,0,0,0,0,0,1,0.648648648648649,0.458333333333333,0.216216216216216,0,"orthodox"
"2465",22,29,175,178,183,180,141,141,19,17,0,5,8,5,"win_A",-7,-3,3,0,0,0,0,0,1,0.772727272727273,0.421052631578947,0.227272727272727,0,"orthodox"
"2466",22,22,175,173,183,178,141,140,18,24,0,25,8,6,"win_A",0,2,5,1,0,0,0,0,1,0.489795918367347,0.444444444444444,0.122448979591837,0,"orthodox"
"2468",22,25,175,173,183,170,141,142,16,16,0,2,7,3,"win_A",-3,2,13,-1,0,0,0,0,1,0.888888888888889,0.4375,0.166666666666667,0,"orthodox"
"2471",21,25,175,170,183,183,144,146,13,11,0,3,6,1,"win_A",-4,5,0,-2,0,0,0,0,1,0.785714285714286,0.461538461538462,0.0714285714285714,0,"orthodox"
"2476",21,26,175,165,183,170,138,144,8,7,0,8,5,3,"win_A",-5,10,13,-6,0,0,0,0,1,0.466666666666667,0.625,0.2,0,"orthodox"
"2502",21,30,175,175,185,178,145,146,8,20,0,12,4,4,"win_A",-9,0,7,-1,0,0,0,0,1,0.625,0.5,0.125,0,"orthodox"
"2506",21,29,175,170,185,185,145,146,4,5,0,4,2,4,"win_A",-8,5,0,-1,0,0,0,0,1,0.555555555555556,0.5,0.444444444444444,0,"orthodox"
"2533",23,28,168,174,163,178,126,126,19,23,0,1,11,16,"win_A",-5,-6,-15,0,0,0,0,0,1,0.958333333333333,0.578947368421053,0.666666666666667,0,"southpaw"
"2544",21,23,168,163,163,169,124,122,8,5,0,3,6,4,"win_A",-2,5,-6,2,0,0,0,0,1,0.625,0.75,0.5,0,"southpaw"
"2545",21,30,168,162,163,165,122,121,7,18,0,12,5,10,"win_A",-9,6,-2,1,0,0,0,0,1,0.6,0.714285714285714,0.333333333333333,0,"southpaw"
"2554",26,35,187,180,192,184,174,174,19,28,0,0,14,17,"win_A",-9,7,8,0,0,1,0,0,1,1,0.736842105263158,0.607142857142857,0,"southpaw"
"2558",24,36,187,189,192,193,175,178,15,25,0,7,11,12,"win_A",-12,-2,-1,-3,0,1,0,0,1,0.78125,0.733333333333333,0.375,0,"southpaw"
"2657",21,23,168,170,170,183,128,127,11,17,1,1,2,11,"win_A",-2,-2,-13,1,0,0,0,0,0.916666666666667,0.944444444444444,0.166666666666667,0.611111111111111,0,"southpaw"
"2673",25,32,168,179,175,180,141,140,29,27,1,5,22,22,"win_A",-7,-11,-5,1,0,0,0,0,0.966666666666667,0.84375,0.733333333333333,0.6875,0,"orthodox"
"2681",22,25,168,168,175,178,130,130,22,23,0,0,18,7,"win_A",-3,0,-3,0,0,0,0,0,1,1,0.818181818181818,0.304347826086957,0,"orthodox"
"2687",21,22,168,175,175,180,138,134,16,11,0,1,13,5,"win_A",-1,-7,-5,4,0,0,0,0,1,0.916666666666667,0.8125,0.416666666666667,0,"orthodox"
"2688",20,22,168,165,175,173,130,129,15,10,0,4,12,3,"win_A",-2,3,2,1,0,0,0,0,1,0.714285714285714,0.8,0.214285714285714,0,"orthodox"
"2690",20,23,168,173,175,178,136,137,13,9,0,7,10,1,"win_A",-3,-5,-3,-1,0,0,0,0,1,0.5625,0.769230769230769,0.0625,0,"orthodox"
"2708",22,29,166,166,161,172,118,118,28,32,1,9,26,23,"win_A",-7,0,-11,0,0,0,0,0,0.96551724137931,0.780487804878049,0.896551724137931,0.560975609756098,0,"orthodox"
"2726",17,22,166,165,161,175,112,113,10,5,0,1,9,1,"win_A",-5,1,-14,-1,0,0,0,0,1,0.833333333333333,0.9,0.166666666666667,0,"orthodox"
"2749",35,35,166,168,165,174,133,133,26,23,1,12,17,13,"win_B",0,-2,-9,0,1,1,0,0,0.962962962962963,0.657142857142857,0.62962962962963,0.371428571428571,1,"orthodox"
"2752",24,32,170,168,180,174,127,128,23,21,0,11,10,12,"win_B",-8,2,6,-1,0,0,0,0,1,0.65625,0.434782608695652,0.375,1,"orthodox"
"2760",29,30,168,171,174,170,126,126,14,12,10,1,8,8,"win_A",-1,-3,4,0,0,0,0,0,0.583333333333333,0.923076923076923,0.333333333333333,0.615384615384615,0,"orthodox"
"2796",22,23,163,163,163,170,108,108,16,18,2,0,10,13,"win_A",-1,0,-7,0,0,0,0,0,0.888888888888889,1,0.555555555555556,0.722222222222222,0,"orthodox"
"2815",26,30,178,178,177,183,139,138,10,39,0,5,9,15,"win_A",-4,0,-6,1,0,0,0,0,1,0.886363636363636,0.9,0.340909090909091,0,"southpaw"
"2818",26,27,178,180,177,185,142,140,7,8,0,2,7,3,"win_A",-1,-2,-8,2,0,0,0,0,1,0.8,1,0.3,0,"southpaw"
"2834",34,30,173,171,175,182,134,134,18,27,0,8,15,23,"win_A",4,2,-7,0,0,0,0,0,1,0.771428571428571,0.833333333333333,0.657142857142857,0,"orthodox"
"2840",32,36,173,168,175,183,135,135,12,42,0,15,9,27,"win_A",-4,5,-8,0,0,1,0,0,1,0.736842105263158,0.75,0.473684210526316,0,"orthodox"
"2862",23,34,180,175,184,188,153,153,14,30,0,6,8,20,"win_A",-11,5,-4,0,0,0,0,0,1,0.833333333333333,0.571428571428571,0.555555555555556,0,"orthodox"
"2864",23,37,180,179,184,185,155,154,12,33,0,4,7,19,"win_A",-14,1,-1,1,0,1,0,0,1,0.891891891891892,0.583333333333333,0.513513513513513,0,"orthodox"
"2870",21,29,180,173,184,193,154,154,6,2,0,5,4,1,"win_A",-8,7,-9,0,0,0,0,0,1,0.285714285714286,0.666666666666667,0.142857142857143,0,"orthodox"
"2871",20,26,180,173,184,178,154,149,5,26,0,44,4,6,"win_A",-6,7,6,5,0,0,0,0,1,0.371428571428571,0.8,0.0857142857142857,0,"orthodox"
"2916",20,26,157,170,168,170,127,130,4,5,0,9,2,1,"win_A",-6,-13,-2,-3,0,0,0,0,1,0.357142857142857,0.5,0.0714285714285714,0,"orthodox"
"2965",28,31,166,163,173,169,118,118,25,44,1,2,17,34,"win_A",-3,3,4,0,0,0,0,0,0.961538461538462,0.956521739130435,0.653846153846154,0.739130434782609,0,"orthodox"
"2968",27,28,166,168,173,160,115,114,22,27,1,4,14,12,"win_A",-1,-2,13,1,0,0,0,0,0.956521739130435,0.870967741935484,0.608695652173913,0.387096774193548,0,"orthodox"
"2971",25,26,166,166,173,169,112,111,19,23,1,1,12,15,"win_A",-1,0,4,1,0,0,0,0,0.95,0.958333333333333,0.6,0.625,0,"orthodox"
"2972",25,29,166,166,173,170,111,111,18,35,1,2,11,26,"win_A",-4,0,3,0,0,0,0,0,0.947368421052632,0.945945945945946,0.578947368421053,0.702702702702703,0,"orthodox"
"2973",31,24,166,166,164,173,112,112,28,17,0,1,22,10,"win_B",7,0,-9,0,0,0,0,0,1,0.944444444444444,0.785714285714286,0.555555555555556,1,"southpaw"
"2974",24,36,166,168,173,173,115,116,16,5,1,9,9,2,"win_A",-12,-2,0,-1,0,1,0,0,0.941176470588235,0.357142857142857,0.529411764705882,0.142857142857143,0,"orthodox"
"2975",23,31,166,168,173,168,115,115,15,35,1,27,9,18,"win_A",-8,-2,5,0,0,0,0,0,0.9375,0.564516129032258,0.5625,0.290322580645161,0,"orthodox"
"3026",25,27,191,188,197,197,168,168,14,8,0,2,11,5,"win_A",-2,3,0,0,0,0,0,0,1,0.8,0.785714285714286,0.5,0,"orthodox"
"3028",24,23,191,185,197,183,168,167,12,10,0,2,10,6,"win_A",1,6,14,1,0,0,0,0,1,0.833333333333333,0.833333333333333,0.5,0,"orthodox"
"3036",23,28,191,180,197,188,168,170,4,3,0,8,4,2,"win_A",-5,11,9,-2,0,0,0,0,1,0.272727272727273,1,0.181818181818182,0,"orthodox"
"3039",23,34,191,185,197,185,165,165,1,0,0,3,1,0,"win_A",-11,6,12,0,0,0,0,0,1,0,1,0,0,"orthodox"
"3049",26,34,164,163,164,170,117,119,8,15,0,9,3,6,"win_A",-8,1,-6,-2,0,0,0,0,1,0.625,0.375,0.25,0,"southpaw"
"3060",30,42,175,175,171,182,159,159,8,44,0,13,6,18,"win_A",-12,0,-11,0,0,1,0,0,1,0.771929824561403,0.75,0.315789473684211,0,"orthodox"
"3061",30,34,175,173,171,173,168,167,7,8,0,1,5,4,"win_A",-4,2,-2,1,0,0,0,0,1,0.888888888888889,0.714285714285714,0.444444444444444,0,"orthodox"
"3063",29,34,175,180,171,187,159,160,5,28,0,6,4,12,"win_A",-5,-5,-16,-1,0,0,0,0,1,0.823529411764706,0.8,0.352941176470588,0,"orthodox"
"3072",33,25,166,170,165,170,133,133,24,16,1,1,17,3,"win_A",8,-4,-5,0,0,0,0,0,0.96,0.941176470588235,0.68,0.176470588235294,0,"orthodox"
"3075",30,28,166,169,165,173,130,130,21,34,0,3,16,26,"win_A",2,-3,-8,0,0,0,0,0,1,0.918918918918919,0.761904761904762,0.702702702702703,0,"orthodox"
"3076",29,31,166,165,165,178,127,127,20,41,0,3,16,34,"win_A",-2,1,-13,0,0,0,0,0,1,0.931818181818182,0.8,0.772727272727273,0,"orthodox"
"3078",28,29,166,168,165,170,126,126,18,35,0,10,15,23,"win_A",-1,-2,-5,0,0,0,0,0,1,0.777777777777778,0.833333333333333,0.511111111111111,0,"orthodox"
"3084",27,30,166,168,165,178,126,127,12,27,0,2,10,18,"win_A",-3,-2,-13,-1,0,0,0,0,1,0.931034482758621,0.833333333333333,0.620689655172414,0,"orthodox"
"3092",25,28,166,170,165,183,126,124,4,17,0,4,3,14,"win_A",-3,-4,-18,2,0,0,0,0,1,0.80952380952381,0.75,0.666666666666667,0,"orthodox"
"3102",30,32,183,174,188,179,160,162,8,24,0,10,5,10,"win_A",-2,9,9,-2,0,0,0,0,1,0.705882352941177,0.625,0.294117647058824,0,"orthodox"
"3105",28,27,183,177,188,173,161,162,5,24,0,4,4,8,"win_A",1,6,15,-1,0,0,0,0,1,0.857142857142857,0.8,0.285714285714286,0,"orthodox"
"3113",28,35,168,173,170,173,135,134,32,31,1,7,24,19,"win_B",-7,-5,-3,1,0,1,0,0,0.96969696969697,0.815789473684211,0.727272727272727,0.5,1,"orthodox"
"3115",34,23,173,168,173,170,137,138,29,16,7,2,17,8,"win_A",11,5,3,-1,0,0,0,0,0.805555555555556,0.888888888888889,0.472222222222222,0.444444444444444,0,"orthodox"
"3122",22,29,169,173,173,173,135,134,19,24,0,4,12,16,"win_A",-7,-4,0,1,0,0,0,0,1,0.857142857142857,0.631578947368421,0.571428571428571,0,"orthodox"
"3132",29,23,170,173,169,173,129,131,10,16,1,2,6,8,"win_A",6,-3,-4,-2,0,0,0,0,0.909090909090909,0.888888888888889,0.545454545454545,0.444444444444444,0,"southpaw"
"3139",21,25,173,168,173,180,126,126,9,8,2,2,6,6,"win_A",-4,5,-7,0,0,0,0,0,0.818181818181818,0.8,0.545454545454545,0.6,0,"orthodox"
"3161",25,28,174,174,170,173,135,135,23,29,2,6,9,15,"win_B",-3,0,-3,0,0,0,0,0,0.92,0.828571428571429,0.36,0.428571428571429,1,"orthodox"
"3170",35,23,168,174,175,170,130,131,36,14,3,2,24,5,"win_B",12,-6,5,-1,1,0,0,0,0.923076923076923,0.875,0.615384615384615,0.3125,1,"orthodox"
"3190",26,32,165,157,169,161,112,112,18,36,1,2,10,19,"win_A",-6,8,8,0,0,0,0,0,0.947368421052632,0.947368421052632,0.526315789473684,0.5,0,"orthodox"
"3192",26,31,165,157,169,161,112,112,16,35,1,1,10,19,"win_A",-5,8,8,0,0,0,0,0,0.941176470588235,0.972222222222222,0.588235294117647,0.527777777777778,0,"orthodox"
"3206",25,29,157,153,161,158,108,108,20,20,1,6,11,12,"win_A",-4,4,3,0,0,0,0,0,0.952380952380952,0.769230769230769,0.523809523809524,0.461538461538462,0,"orthodox"
"3232",26,34,189,188,196,201,176,176,24,26,2,7,14,23,"win_A",-8,1,-5,0,0,0,0,0,0.923076923076923,0.787878787878788,0.538461538461538,0.696969696969697,0,"orthodox"
"3233",25,34,189,189,196,193,173,175,23,22,2,5,13,9,"win_A",-9,0,3,-2,0,0,0,0,0.92,0.814814814814815,0.52,0.333333333333333,0,"orthodox"
"3243",22,23,189,185,196,185,173,175,13,15,2,1,4,8,"win_A",-1,4,11,-2,0,0,0,0,0.866666666666667,0.9375,0.266666666666667,0.5,0,"orthodox"
"3244",22,22,189,175,196,178,172,170,12,7,2,1,3,6,"win_A",0,14,18,2,0,0,0,0,0.857142857142857,0.875,0.214285714285714,0.75,0,"orthodox"
"3245",21,36,189,183,196,188,168,167,11,11,2,13,3,6,"win_A",-15,6,8,1,0,1,0,0,0.846153846153846,0.458333333333333,0.230769230769231,0.25,0,"orthodox"
"3247",24,20,168,189,188,196,159,160,11,10,2,1,6,3,"win_A",4,-21,-8,-1,0,0,0,0,0.846153846153846,0.909090909090909,0.461538461538462,0.272727272727273,0,"orthodox"
"3249",20,25,189,170,196,175,160,159,8,5,1,1,3,0,"win_A",-5,19,21,1,0,0,0,0,0.888888888888889,0.833333333333333,0.333333333333333,0,0,"orthodox"
"3261",27,25,168,170,174,183,133,132,30,17,1,0,22,12,"win_A",2,-2,-9,1,0,0,0,0,0.967741935483871,1,0.709677419354839,0.705882352941177,0,"southpaw"
"3264",26,31,168,175,174,178,130,130,28,19,0,1,20,12,"win_A",-5,-7,-4,0,0,0,0,0,1,0.95,0.714285714285714,0.6,0,"southpaw"
"3265",27,25,165,168,169,174,130,129,34,27,1,0,18,20,"win_B",2,-3,-5,1,0,0,0,0,0.971428571428571,1,0.514285714285714,0.740740740740741,1,"orthodox"
"3273",22,35,168,165,174,173,129,128,19,39,0,13,14,23,"win_A",-13,3,1,1,0,1,0,0,1,0.75,0.736842105263158,0.442307692307692,0,"southpaw"
"3278",21,22,168,168,174,175,126,124,13,8,0,1,10,2,"win_A",-1,0,-1,2,0,0,0,0,1,0.888888888888889,0.769230769230769,0.222222222222222,0,"southpaw"
"3286",20,32,168,168,174,180,126,126,5,10,0,20,5,7,"win_A",-12,0,-6,0,0,0,0,0,1,0.333333333333333,1,0.233333333333333,0,"southpaw"
"3309",28,33,183,176,185,178,159,160,20,25,0,2,7,21,"win_A",-5,7,7,-1,0,0,0,0,1,0.925925925925926,0.35,0.777777777777778,0,"orthodox"
"3315",26,28,183,178,185,173,169,166,14,7,0,2,5,4,"win_A",-2,5,12,3,0,0,0,0,1,0.777777777777778,0.357142857142857,0.444444444444444,0,"orthodox"
"3353",23,24,188,192,185,194,170,171,15,19,1,0,8,10,"win_A",-1,-4,-9,-1,0,0,0,0,0.9375,1,0.5,0.526315789473684,0,"orthodox"
"3373",24,26,161,161,162,166,105,104,8,30,0,2,6,17,"win_A",-2,0,-4,1,0,0,0,0,1,0.9375,0.75,0.53125,0,"orthodox"
"3407",26,30,170,175,170,178,141,140,8,16,0,1,6,12,"win_A",-4,-5,-8,1,0,0,0,0,1,0.941176470588235,0.75,0.705882352941177,0,"orthodox"
"3417",32,33,168,179,168,180,140,140,25,28,4,6,18,23,"win_B",-1,-11,-12,0,0,0,0,0,0.862068965517241,0.823529411764706,0.620689655172414,0.676470588235294,1,"orthodox"
"3429",26,27,170,179,173,180,135,135,18,20,0,1,10,16,"win_B",-1,-9,-7,0,0,0,0,0,1,0.952380952380952,0.555555555555556,0.761904761904762,1,"orthodox"
"3431",27,39,179,168,180,168,136,139,18,30,1,34,14,17,"win_A",-12,11,12,-3,0,1,0,0,0.947368421052632,0.46875,0.736842105263158,0.265625,0,"orthodox"
"3432",26,29,179,179,180,170,134,133,18,26,0,4,14,14,"win_B",-3,0,10,1,0,0,0,0,1,0.866666666666667,0.777777777777778,0.466666666666667,1,"orthodox"
"3433",26,37,179,175,180,175,136,137,17,30,0,6,13,17,"win_A",-11,4,5,-1,0,1,0,0,1,0.833333333333333,0.764705882352941,0.472222222222222,0,"orthodox"
"3434",26,33,179,169,180,168,132,128,16,25,0,6,12,14,"win_A",-7,10,12,4,0,0,0,0,1,0.806451612903226,0.75,0.451612903225806,0,"orthodox"
"3441",25,24,179,170,180,175,133,132,9,5,0,15,7,1,"win_A",1,9,5,1,0,0,0,0,1,0.25,0.777777777777778,0.05,0,"orthodox"
"3453",27,26,165,175,170,175,130,131,16,19,1,7,12,5,"win_A",1,-10,-5,-1,0,0,0,0,0.941176470588235,0.730769230769231,0.705882352941177,0.192307692307692,0,"orthodox"
"3455",27,26,165,165,170,165,132,133,14,12,1,11,10,9,"win_A",1,0,5,-1,0,0,0,0,0.933333333333333,0.521739130434783,0.666666666666667,0.391304347826087,0,"orthodox"
"3457",26,32,165,168,170,173,129,130,12,5,1,15,8,1,"win_A",-6,-3,-3,-1,0,0,0,0,0.923076923076923,0.25,0.615384615384615,0.05,0,"orthodox"
"3472",32,29,185,185,191,188,169,167,24,22,2,1,16,6,"win_A",3,0,3,2,0,0,0,0,0.923076923076923,0.956521739130435,0.615384615384615,0.260869565217391,0,"southpaw"
"3492",22,23,185,188,191,193,168,168,6,7,0,3,4,4,"win_A",-1,-3,-2,0,0,0,0,0,1,0.7,0.666666666666667,0.4,0,"southpaw"
"3513",27,31,183,175,180,183,167,168,23,32,0,2,13,26,"win_A",-4,8,-3,-1,0,0,0,0,1,0.941176470588235,0.565217391304348,0.764705882352941,0,"orthodox"
"3520",28,27,175,178,183,197,166,165,26,30,0,2,21,26,"win_A",1,-3,-14,1,0,0,0,0,1,0.9375,0.807692307692308,0.8125,0,"orthodox"
"3524",27,27,175,183,183,175,160,159,22,20,0,0,17,9,"win_A",0,-8,8,1,0,0,0,0,1,1,0.772727272727273,0.45,0,"orthodox"
"3549",36,26,164,163,177,163,112,112,17,21,0,3,5,13,"win_B",10,1,14,0,1,0,0,0,1,0.875,0.294117647058824,0.541666666666667,1,"orthodox"
"3550",35,25,164,163,177,163,112,112,15,21,0,2,5,13,"win_A",10,1,14,0,1,0,0,0,1,0.91304347826087,0.333333333333333,0.565217391304348,0,"orthodox"
"3558",20,27,163,174,163,180,107,108,14,12,0,1,8,8,"win_B",-7,-11,-17,-1,0,0,0,0,1,0.923076923076923,0.571428571428571,0.615384615384615,1,"orthodox"
"3582",24,32,166,182,171,178,123,123,13,24,2,15,5,19,"win_A",-8,-16,-7,0,0,0,0,0,0.866666666666667,0.615384615384615,0.333333333333333,0.487179487179487,0,"orthodox"
"3672",33,24,163,160,168,168,113,112,32,9,4,7,19,4,"win_A",9,3,0,1,0,0,0,0,0.888888888888889,0.5625,0.527777777777778,0.25,0,"orthodox"
"3674",31,36,163,160,168,164,112,112,30,31,3,4,17,13,"win_A",-5,3,4,0,0,1,0,0,0.909090909090909,0.885714285714286,0.515151515151515,0.371428571428571,0,"orthodox"
"3675",31,29,163,160,168,168,112,112,29,28,3,1,16,24,"win_A",2,3,0,0,0,0,0,0,0.90625,0.96551724137931,0.5,0.827586206896552,0,"orthodox"
"3679",29,26,163,165,168,168,108,108,26,20,2,4,15,14,"win_B",3,-2,0,0,0,0,0,0,0.928571428571429,0.833333333333333,0.535714285714286,0.583333333333333,1,"orthodox"
"3683",27,32,163,160,168,165,112,112,22,15,2,12,13,4,"win_A",-5,3,3,0,0,0,0,0,0.916666666666667,0.555555555555556,0.541666666666667,0.148148148148148,0,"orthodox"
"3687",26,27,163,161,168,170,108,108,19,26,1,5,12,14,"win_B",-1,2,-2,0,0,0,0,0,0.95,0.838709677419355,0.6,0.451612903225806,1,"orthodox"
"3688",25,30,163,160,168,164,108,108,19,24,0,2,12,11,"win_B",-5,3,4,0,0,0,0,0,1,0.923076923076923,0.631578947368421,0.423076923076923,1,"orthodox"
"3690",24,28,163,157,168,173,108,108,17,25,0,4,11,16,"win_A",-4,6,-5,0,0,0,0,0,1,0.862068965517241,0.647058823529412,0.551724137931034,0,"orthodox"
"3694",23,33,163,160,168,152,112,112,13,30,0,9,8,20,"win_A",-10,3,16,0,0,0,0,0,1,0.769230769230769,0.615384615384615,0.512820512820513,0,"orthodox"
"3702",21,26,163,159,168,157,113,114,5,22,0,26,3,10,"win_A",-5,4,11,-1,0,0,0,0,1,0.458333333333333,0.6,0.208333333333333,0,"orthodox"
"3708",39,27,181,182,181,179,167,166,48,22,3,0,35,15,"win_A",12,-1,2,1,1,0,0,0,0.941176470588235,1,0.686274509803922,0.681818181818182,0,"southpaw"
"3742",22,28,181,177,181,183,172,173,17,75,0,12,14,39,"win_A",-6,4,-2,-1,0,0,0,0,1,0.862068965517241,0.823529411764706,0.448275862068966,0,"southpaw"
"3810",33,33,168,165,170,164,130,130,42,53,12,4,29,33,"win_A",0,3,6,0,0,0,0,0,0.777777777777778,0.929824561403509,0.537037037037037,0.578947368421053,0,"orthodox"
"3816",27,30,166,168,175,170,126,125,30,35,0,11,27,23,"win_B",-3,-2,5,1,0,0,0,0,1,0.760869565217391,0.9,0.5,1,"southpaw"
"3820",27,31,168,165,170,173,126,126,32,36,9,11,21,23,"win_B",-4,3,-3,0,0,0,0,0,0.780487804878049,0.765957446808511,0.51219512195122,0.48936170212766,1,"orthodox"
"3823",27,35,168,168,170,173,126,126,29,41,9,3,19,38,"win_A",-8,0,-3,0,0,1,0,0,0.763157894736842,0.931818181818182,0.5,0.863636363636364,0,"orthodox"
"3829",31,23,170,168,170,170,126,126,42,23,2,8,33,15,"win_A",8,2,0,0,0,0,0,0,0.954545454545455,0.741935483870968,0.75,0.483870967741935,0,"orthodox"
"3830",23,24,168,164,170,168,127,126,22,14,8,4,14,10,"win_A",-1,4,2,1,0,0,0,0,0.733333333333333,0.777777777777778,0.466666666666667,0.555555555555556,0,"orthodox"
"3831",22,35,168,165,170,168,128,131,21,24,8,8,14,15,"win_A",-13,3,2,-3,0,1,0,0,0.724137931034483,0.75,0.482758620689655,0.46875,0,"orthodox"
"3832",22,31,168,170,170,173,128,127,20,17,8,1,13,12,"win_A",-9,-2,-3,1,0,0,0,0,0.714285714285714,0.944444444444444,0.464285714285714,0.666666666666667,0,"orthodox"
"3836",21,31,168,175,170,178,131,131,16,38,8,3,10,30,"win_A",-10,-7,-8,0,0,0,0,0,0.666666666666667,0.926829268292683,0.416666666666667,0.731707317073171,0,"orthodox"
"3838",21,31,168,169,170,175,131,130,14,17,8,0,9,10,"win_A",-10,-1,-5,1,0,0,0,0,0.636363636363636,1,0.409090909090909,0.588235294117647,0,"orthodox"
"3839",28,21,173,168,173,170,133,135,47,14,4,7,33,9,"win_A",7,5,3,-2,0,0,0,0,0.92156862745098,0.666666666666667,0.647058823529412,0.428571428571429,0,"orthodox"
"3855",20,16,170,168,175,170,119,118,5,4,0,1,3,1,"win_A",4,2,5,1,0,0,0,0,1,0.8,0.6,0.2,0,"orthodox"
"3861",27,34,171,175,185,180,146,146,26,33,0,5,18,18,"win_A",-7,-4,5,0,0,0,0,0,1,0.868421052631579,0.692307692307692,0.473684210526316,0,"orthodox"
"3862",25,29,171,178,185,180,151,149,25,31,0,5,18,23,"win_A",-4,-7,5,2,0,0,0,0,1,0.861111111111111,0.72,0.638888888888889,0,"orthodox"
"3866",23,31,171,173,185,180,135,135,21,24,0,2,17,16,"win_A",-8,-2,5,0,0,0,0,0,1,0.923076923076923,0.80952380952381,0.615384615384615,0,"orthodox"
"3872",22,26,171,178,185,175,139,138,15,12,0,6,12,6,"win_A",-4,-7,10,1,0,0,0,0,1,0.666666666666667,0.8,0.333333333333333,0,"orthodox"
"3875",21,23,171,178,185,178,138,135,12,6,0,6,9,2,"win_A",-2,-7,7,3,0,0,0,0,1,0.5,0.75,0.166666666666667,0,"orthodox"
"3885",18,28,171,170,185,173,138,139,2,3,0,11,2,2,"win_A",-10,1,12,-1,0,0,0,0,1,0.214285714285714,1,0.142857142857143,0,"orthodox"
"3888",31,34,183,183,188,191,167,168,23,28,1,3,14,18,"win_B",-3,0,-3,-1,0,0,0,0,0.958333333333333,0.903225806451613,0.583333333333333,0.580645161290323,1,"southpaw"
"3894",30,33,183,173,191,175,163,160,23,24,1,4,14,13,"win_A",-3,10,16,3,0,0,0,0,0.958333333333333,0.857142857142857,0.583333333333333,0.464285714285714,0,"orthodox"
"3897",29,34,183,178,191,178,164,164,20,44,1,14,12,24,"win_A",-5,5,13,0,0,0,0,0,0.952380952380952,0.758620689655172,0.571428571428571,0.413793103448276,0,"orthodox"
"3898",29,34,183,170,191,178,162,168,19,19,1,16,11,12,"win_A",-5,13,13,-6,0,0,0,0,0.95,0.542857142857143,0.55,0.342857142857143,0,"orthodox"
"3919",29,29,158,160,166,165,108,108,36,31,2,2,13,10,"win_A",0,-2,1,0,0,0,0,0,0.947368421052632,0.939393939393939,0.342105263157895,0.303030303030303,0,"orthodox"
"3926",26,24,158,163,166,168,111,111,30,11,1,5,12,8,"win_A",2,-5,-2,0,0,0,0,0,0.967741935483871,0.6875,0.387096774193548,0.5,0,"orthodox"
"3927",25,24,158,161,166,166,111,111,29,29,1,2,12,18,"win_A",1,-3,0,0,0,0,0,0,0.966666666666667,0.935483870967742,0.4,0.580645161290323,0,"orthodox"
"3931",23,25,158,163,166,165,112,112,25,28,0,9,9,22,"win_A",-2,-5,1,0,0,0,0,0,1,0.756756756756757,0.36,0.594594594594595,0,"orthodox"
"3939",21,37,158,160,166,150,106,106,17,62,0,6,5,32,"win_A",-16,-2,16,0,0,1,0,0,1,0.911764705882353,0.294117647058824,0.470588235294118,0,"orthodox"
"4023",29,34,156,168,168,176,122,121,22,21,0,5,15,13,"win_B",-5,-12,-8,1,0,0,0,0,1,0.807692307692308,0.681818181818182,0.5,1,"orthodox"
"4096",28,26,170,178,178,185,142,140,24,23,0,5,16,19,"win_A",2,-8,-7,2,0,0,0,0,1,0.821428571428571,0.666666666666667,0.678571428571429,0,"orthodox"
"4099",27,24,170,171,178,165,141,141,21,18,0,3,15,12,"win_A",3,-1,13,0,0,0,0,0,1,0.857142857142857,0.714285714285714,0.571428571428571,0,"orthodox"
"4101",26,34,170,179,178,170,141,140,19,32,0,8,15,16,"win_A",-8,-9,8,1,0,0,0,0,1,0.8,0.789473684210526,0.4,0,"orthodox"
"4122",27,44,171,174,174,180,146,146,21,49,1,9,11,41,"win_A",-17,-3,-6,0,0,1,0,0,0.954545454545455,0.844827586206897,0.5,0.706896551724138,0,"orthodox"
"4148",37,28,181,177,185,183,168,167,39,14,5,0,18,10,"win_A",9,4,2,1,1,0,0,0,0.886363636363636,1,0.409090909090909,0.714285714285714,0,"orthodox"
"4168",27,32,183,184,188,193,168,167,16,22,1,3,11,10,"win_A",-5,-1,-5,1,0,0,0,0,0.941176470588235,0.88,0.647058823529412,0.4,0,"southpaw"
"4187",31,34,166,171,170,175,142,142,16,23,0,1,8,4,"win_A",-3,-5,-5,0,0,0,0,0,1,0.958333333333333,0.5,0.166666666666667,0,"southpaw"
"4311",29,34,173,168,180,183,154,153,25,27,4,3,15,16,"win_B",-5,5,-3,1,0,0,0,0,0.862068965517241,0.9,0.517241379310345,0.533333333333333,1,"southpaw"
"4315",33,31,168,175,183,183,149,148,24,20,2,3,14,13,"win_A",2,-7,0,1,0,0,0,0,0.923076923076923,0.869565217391304,0.538461538461538,0.565217391304348,0,"orthodox"
"4316",33,35,168,175,183,175,150,149,23,22,2,12,13,12,"win_A",-2,-7,8,1,0,1,0,0,0.92,0.647058823529412,0.52,0.352941176470588,0,"orthodox"
"4317",28,32,171,168,173,183,150,149,31,23,3,1,9,13,"win_A",-4,3,-10,1,0,0,0,0,0.911764705882353,0.958333333333333,0.264705882352941,0.541666666666667,0,"orthodox"
"4319",32,32,168,173,183,185,148,144,21,35,1,3,13,16,"win_A",0,-5,-2,4,0,0,0,0,0.954545454545455,0.921052631578947,0.590909090909091,0.421052631578947,0,"orthodox"
"4320",25,32,178,168,188,183,153,153,15,21,0,0,9,13,"win_A",-7,10,5,0,0,0,0,0,1,1,0.6,0.619047619047619,0,"southpaw"
"4321",31,31,168,175,183,183,153,154,20,44,0,11,12,23,"win_A",0,-7,0,-1,0,0,0,0,1,0.8,0.6,0.418181818181818,0,"orthodox"
"4324",31,26,168,165,183,180,156,159,17,6,0,3,9,5,"win_A",5,3,3,-3,0,0,0,0,1,0.666666666666667,0.529411764705882,0.555555555555556,0,"orthodox"
"4343",34,26,169,171,175,165,147,147,37,20,4,4,34,14,"win_A",8,-2,10,0,0,0,0,0,0.902439024390244,0.833333333333333,0.829268292682927,0.583333333333333,0,"orthodox"
"4347",29,32,169,170,175,175,139,139,31,30,2,0,29,14,"win_A",-3,-1,0,0,0,0,0,0,0.939393939393939,1,0.878787878787879,0.466666666666667,0,"orthodox"
"4353",33,28,171,169,183,175,140,139,39,27,6,0,27,25,"win_A",5,2,8,1,0,0,0,0,0.866666666666667,1,0.6,0.925925925925926,0,"southpaw"
"4355",27,31,169,180,175,188,142,143,25,29,0,3,23,19,"win_A",-4,-11,-13,-1,0,0,0,0,1,0.90625,0.92,0.59375,0,"orthodox"
"4382",28,35,188,177,178,179,146,146,20,36,1,4,9,19,"win_A",-7,11,-1,0,0,1,0,0,0.952380952380952,0.9,0.428571428571429,0.475,0,"orthodox"
"4391",25,29,188,168,178,173,147,147,12,16,0,13,6,13,"win_A",-4,20,5,0,0,0,0,0,1,0.551724137931034,0.5,0.448275862068966,0,"orthodox"
"4396",24,33,188,173,178,175,148,152,7,6,0,2,5,3,"win_A",-9,15,3,-4,0,0,0,0,1,0.75,0.714285714285714,0.375,0,"orthodox"
"4398",23,24,188,173,178,183,147,147,5,5,0,11,4,0,"win_A",-1,15,-5,0,0,0,0,0,1,0.3125,0.8,0,0,"orthodox"
"4404",26,23,168,168,173,173,122,121,24,19,0,0,14,9,"win_B",3,0,0,1,0,0,0,0,1,1,0.583333333333333,0.473684210526316,1,"orthodox"
"4418",19,30,168,170,173,165,124,122,5,15,0,9,4,13,"win_A",-11,-2,8,2,0,0,0,0,1,0.625,0.8,0.541666666666667,0,"orthodox"
"4495",38,32,173,169,183,174,145,146,48,30,0,3,26,23,"win_A",6,4,9,-1,1,0,0,0,1,0.909090909090909,0.541666666666667,0.696969696969697,0,"orthodox"
"4498",29,30,169,177,174,183,147,147,28,27,2,8,22,17,"win_B",-1,-8,-9,0,0,0,0,0,0.933333333333333,0.771428571428571,0.733333333333333,0.485714285714286,1,"orthodox"
"4502",27,31,169,175,174,188,145,147,26,29,0,1,20,20,"win_A",-4,-6,-14,-2,0,0,0,0,1,0.966666666666667,0.769230769230769,0.666666666666667,0,"orthodox"
"4510",23,31,169,178,174,178,146,147,18,30,0,10,16,21,"win_A",-8,-9,-4,-1,0,0,0,0,1,0.75,0.888888888888889,0.525,0,"orthodox"
"4515",22,33,169,180,174,183,147,149,13,37,0,25,11,33,"win_A",-11,-11,-9,-2,0,0,0,0,1,0.596774193548387,0.846153846153846,0.532258064516129,0,"orthodox"
"4518",22,32,169,178,174,185,148,153,10,14,0,6,8,9,"win_A",-10,-9,-11,-5,0,0,0,0,1,0.7,0.8,0.45,0,"orthodox"
"4535",29,39,201,185,207,201,261,221,12,40,0,19,11,34,"win_A",-10,16,6,40,0,1,1,0,1,0.677966101694915,0.916666666666667,0.576271186440678,0,"orthodox"
"4536",28,41,201,183,207,180,250,233,11,27,0,13,10,16,"win_A",-13,18,27,17,0,1,1,0,1,0.675,0.909090909090909,0.4,0,"orthodox"
"4538",28,27,201,192,207,195,254,229,9,19,0,7,9,13,"win_A",1,9,12,25,0,0,1,0,1,0.730769230769231,1,0.5,0,"orthodox"
"4542",28,28,201,189,207,201,251,246,5,16,0,2,5,8,"win_A",0,12,6,5,0,0,0,0,1,0.888888888888889,1,0.444444444444444,0,"orthodox"
"4552",34,29,169,170,175,168,129,126,60,29,10,7,50,9,"win_A",5,-1,7,3,0,0,0,0,0.857142857142857,0.805555555555556,0.714285714285714,0.25,0,"orthodox"
"4555",32,33,163,169,170,175,129,129,25,58,4,9,16,49,"win_A",-1,-6,-5,0,0,0,0,0,0.862068965517241,0.865671641791045,0.551724137931034,0.73134328358209,0,"orthodox"
"4557",33,35,169,164,175,168,126,126,56,64,8,7,47,49,"win_A",-2,5,7,0,0,1,0,0,0.875,0.901408450704225,0.734375,0.690140845070423,0,"orthodox"
"4568",31,29,170,169,170,175,126,125,26,45,3,7,14,39,"win_B",2,1,-5,1,0,0,0,0,0.896551724137931,0.865384615384615,0.482758620689655,0.75,1,"orthodox"
"4569",28,29,169,168,175,170,126,126,44,17,7,2,38,10,"win_A",-1,1,5,0,0,0,0,0,0.862745098039216,0.894736842105263,0.745098039215686,0.526315789473684,0,"orthodox"
"4573",27,37,169,165,175,178,127,126,40,21,7,3,34,17,"win_A",-10,4,-3,1,0,1,0,0,0.851063829787234,0.875,0.723404255319149,0.708333333333333,0,"orthodox"
"4574",32,27,169,169,174,175,122,122,33,40,4,6,20,34,"win_A",5,0,-1,0,0,0,0,0,0.891891891891892,0.869565217391304,0.540540540540541,0.739130434782609,0,"southpaw"
"4578",26,30,169,170,175,173,124,124,36,29,6,19,30,20,"win_A",-4,-1,2,0,0,0,0,0,0.857142857142857,0.604166666666667,0.714285714285714,0.416666666666667,0,"orthodox"
"4580",26,31,169,163,175,168,123,120,34,30,6,10,29,25,"win_A",-5,6,7,3,0,0,0,0,0.85,0.75,0.725,0.625,0,"orthodox"
"4583",28,25,164,169,169,175,121,122,40,33,3,4,29,28,"win_A",3,-5,-6,-1,0,0,0,0,0.930232558139535,0.891891891891892,0.674418604651163,0.756756756756757,0,"orthodox"
"4591",23,25,169,170,175,175,118,117,25,17,4,0,23,8,"win_A",-2,-1,0,1,0,0,0,0,0.862068965517241,1,0.793103448275862,0.470588235294118,0,"orthodox"
"4603",30,20,163,169,160,175,118,118,32,14,9,3,11,12,"win_A",10,-6,-15,0,0,0,0,0,0.780487804878049,0.823529411764706,0.268292682926829,0.705882352941177,0,"southpaw"
"4619",23,18,163,169,165,175,118,119,0,0,1,1,0,0,"win_A",5,-6,-10,-1,0,0,0,0,0,0,0,0,0,"orthodox"
"4627",26,36,193,191,198,196,278,255,13,2,0,5,11,1,"win_A",-10,2,2,23,0,1,1,0,1,0.285714285714286,0.846153846153846,0.142857142857143,0,"orthodox"
"4634",25,39,193,191,198,203,266,235,6,8,0,2,6,3,"win_A",-14,2,-5,31,0,1,1,0,1,0.8,1,0.3,0,"orthodox"
"4660",26,33,188,175,189,183,170,171,20,14,0,17,17,10,"win_A",-7,13,6,-1,0,0,0,0,1,0.451612903225806,0.85,0.32258064516129,0,"orthodox"
"4747",21,32,177,173,178,175,159,159,23,52,0,3,22,28,"win_A",-11,4,3,0,0,0,0,0,1,0.945454545454545,0.956521739130435,0.509090909090909,0,"orthodox"
"4750",21,31,177,180,178,180,166,164,20,18,0,11,20,11,"win_A",-10,-3,-2,2,0,0,0,0,1,0.620689655172414,1,0.379310344827586,0,"orthodox"
"4774",29,27,165,168,164,167,118,118,14,46,0,29,8,25,"win_A",2,-3,-3,0,0,0,0,0,1,0.613333333333333,0.571428571428571,0.333333333333333,0,"southpaw"
"4776",29,36,165,157,164,157,118,122,12,32,0,23,6,20,"win_A",-7,8,7,-4,0,1,0,0,1,0.581818181818182,0.5,0.363636363636364,0,"southpaw"
"4780",27,33,165,163,164,170,118,118,8,13,0,6,5,5,"win_A",-6,2,-6,0,0,0,0,0,1,0.684210526315789,0.625,0.263157894736842,0,"southpaw"
"4785",26,19,165,168,164,173,118,119,3,0,0,3,1,0,"win_A",7,-3,-9,-1,0,0,0,0,1,0,0.333333333333333,0,0,"southpaw"
"4786",26,23,165,165,164,164,120,119,2,1,0,6,1,1,"win_A",3,0,0,1,0,0,0,0,1,0.142857142857143,0.5,0.142857142857143,0,"southpaw"
"4794",31,25,180,175,183,188,147,146,24,13,0,3,9,9,"win_A",6,5,-5,1,0,0,0,0,1,0.8125,0.375,0.5625,0,"orthodox"
"4799",22,22,175,178,188,170,143,144,8,7,2,1,5,4,"win_A",0,-3,18,-1,0,0,0,0,0.8,0.875,0.5,0.5,0,"orthodox"
"4800",22,19,175,173,188,178,136,136,8,10,1,0,5,8,"win_B",3,2,10,0,0,0,0,0,0.888888888888889,1,0.555555555555556,0.8,1,"orthodox"
"4835",23,32,178,180,178,183,147,147,29,26,0,0,13,9,"win_A",-9,-2,-5,0,0,0,0,0,1,1,0.448275862068966,0.346153846153846,0,"orthodox"
"4838",22,25,178,173,178,178,147,147,26,20,0,2,13,14,"win_A",-3,5,0,0,0,0,0,0,1,0.909090909090909,0.5,0.636363636363636,0,"orthodox"
"4843",21,37,178,173,178,183,146,146,21,26,0,18,10,8,"win_A",-16,5,-5,0,0,1,0,0,1,0.590909090909091,0.476190476190476,0.181818181818182,0,"orthodox"
"4918",23,24,173,165,171,168,114,115,11,17,3,2,3,9,"win_B",-1,8,3,-1,0,0,0,0,0.785714285714286,0.894736842105263,0.214285714285714,0.473684210526316,1,"orthodox"
"4940",24,26,187,173,192,177,161,159,22,22,0,2,12,5,"win_A",-2,14,15,2,0,0,0,0,1,0.916666666666667,0.545454545454545,0.208333333333333,0,"orthodox"
"4942",23,23,187,178,192,185,160,162,20,14,0,0,11,8,"win_A",0,9,7,-2,0,0,0,0,1,1,0.55,0.571428571428571,0,"orthodox"
"4946",21,36,187,180,192,188,153,152,16,12,0,7,8,9,"win_A",-15,7,4,1,0,1,0,0,1,0.631578947368421,0.5,0.473684210526316,0,"orthodox"
"5031",31,31,191,189,203,191,199,200,21,21,0,1,20,21,"win_A",0,2,12,-1,0,0,0,0,1,0.954545454545455,0.952380952380952,0.954545454545455,0,"orthodox"
"5042",24,35,191,185,203,201,197,200,10,30,0,10,10,26,"win_A",-11,6,2,-3,0,1,0,0,1,0.75,1,0.65,0,"orthodox"
"5075",28,30,173,170,174,173,126,126,22,25,1,1,16,18,"win_B",-2,3,1,0,0,0,0,0,0.956521739130435,0.961538461538462,0.695652173913043,0.692307692307692,1,"southpaw"
"5076",29,30,170,170,175,173,126,126,22,24,0,1,15,17,"win_B",-1,0,2,0,0,0,0,0,1,0.96,0.681818181818182,0.68,1,"orthodox"
"5088",21,32,170,163,173,168,123,122,13,30,0,14,10,25,"win_B",-11,7,5,1,0,0,0,0,1,0.681818181818182,0.769230769230769,0.568181818181818,1,"orthodox"
"5090",21,37,170,165,173,166,122,122,11,26,0,12,9,19,"win_A",-16,5,7,0,0,1,0,0,1,0.684210526315789,0.818181818181818,0.5,0,"orthodox"
"5092",20,30,170,168,173,180,122,122,9,9,0,10,7,7,"win_A",-10,2,-7,0,0,0,0,0,1,0.473684210526316,0.777777777777778,0.368421052631579,0,"orthodox"
"5106",26,32,160,152,165,154,105,105,26,24,1,5,9,14,"win_A",-6,8,11,0,0,0,0,0,0.962962962962963,0.827586206896552,0.333333333333333,0.482758620689655,0,"orthodox"
"5138",37,26,178,185,185,185,158,159,49,46,2,0,28,32,"win_A",11,-7,0,-1,1,0,0,0,0.96078431372549,1,0.549019607843137,0.695652173913043,0,"southpaw"
"5143",24,26,185,175,185,173,160,160,41,22,0,8,30,4,"win_A",-2,10,12,0,0,0,0,0,1,0.733333333333333,0.731707317073171,0.133333333333333,0,"orthodox"
"5144",24,31,185,180,185,188,160,159,40,29,0,1,30,18,"win_A",-7,5,-3,1,0,0,0,0,1,0.966666666666667,0.75,0.6,0,"orthodox"
"5146",23,24,185,178,185,178,154,154,38,23,0,0,29,10,"win_A",-1,7,7,0,0,0,0,0,1,1,0.763157894736842,0.434782608695652,0,"orthodox"
"5147",22,30,185,178,185,178,156,156,37,39,0,7,29,22,"win_A",-8,7,7,0,0,0,0,0,1,0.847826086956522,0.783783783783784,0.478260869565217,0,"orthodox"
"5151",21,24,185,178,185,188,150,149,33,20,0,1,26,15,"win_A",-3,7,-3,1,0,0,0,0,1,0.952380952380952,0.787878787878788,0.714285714285714,0,"orthodox"
"5154",21,30,185,174,185,165,151,150,30,20,0,4,23,14,"win_A",-9,11,20,1,0,0,0,0,1,0.833333333333333,0.766666666666667,0.583333333333333,0,"orthodox"
"5158",20,24,185,173,185,173,147,145,26,14,0,1,20,7,"win_A",-4,12,12,2,0,0,0,0,1,0.933333333333333,0.769230769230769,0.466666666666667,0,"orthodox"
"5168",19,25,185,178,185,193,139,138,16,17,0,15,11,5,"win_A",-6,7,-8,1,0,0,0,0,1,0.53125,0.6875,0.15625,0,"orthodox"
"5169",18,31,185,178,185,180,139,137,15,5,0,5,10,4,"win_A",-13,7,5,2,0,0,0,0,1,0.5,0.666666666666667,0.4,0,"orthodox"
"5209",29,33,165,167,169,171,112,112,15,23,1,2,8,12,"win_A",-4,-2,-2,0,0,0,0,0,0.9375,0.92,0.5,0.48,0,"orthodox"
"5228",20,29,187,174,196,173,166,167,16,14,0,1,15,7,"win_A",-9,13,23,-1,0,0,0,0,1,0.933333333333333,0.9375,0.466666666666667,0,"orthodox"
"5235",18,39,187,188,196,188,174,173,9,9,0,7,8,7,"win_A",-21,-1,8,1,0,1,0,0,1,0.5625,0.888888888888889,0.4375,0,"orthodox"
"5245",30,36,170,167,177,172,115,115,21,33,0,10,13,14,"win_A",-6,3,5,0,0,1,0,0,1,0.767441860465116,0.619047619047619,0.325581395348837,0,"southpaw"
"5305",28,24,163,168,174,170,108,108,29,32,2,5,25,17,"win_A",4,-5,4,0,0,0,0,0,0.935483870967742,0.864864864864865,0.806451612903226,0.459459459459459,0,"orthodox"
"5319",24,29,163,163,174,159,109,107,16,15,0,23,13,10,"win_A",-5,0,15,2,0,0,0,0,1,0.394736842105263,0.8125,0.263157894736842,0,"orthodox"
"5323",20,22,168,163,168,174,108,108,11,12,1,0,6,10,"win_B",-2,5,-6,0,0,0,0,0,0.916666666666667,1,0.5,0.833333333333333,1,"orthodox"
"5342",27,40,193,180,198,183,249,212,15,41,0,9,12,26,"win_A",-13,13,15,37,0,1,1,0,1,0.82,0.8,0.52,0,"orthodox"
"5368",31,32,163,167,177,172,115,115,14,28,3,7,7,11,"win_A",-1,-4,5,0,0,0,0,0,0.823529411764706,0.8,0.411764705882353,0.314285714285714,0,"orthodox"
"5380",22,26,165,163,168,177,118,120,7,5,0,0,3,3,"win_A",-4,2,-9,-2,0,0,0,0,1,1,0.428571428571429,0.6,0,"orthodox"
"5384",18,23,163,165,177,170,115,117,1,0,0,5,1,0,"win_A",-5,-2,7,-2,0,0,0,0,1,0,1,0,0,"orthodox"
"5456",29,25,188,183,191,191,154,152,32,18,2,1,22,15,"win_A",4,5,0,2,0,0,0,0,0.941176470588235,0.947368421052632,0.647058823529412,0.789473684210526,0,"southpaw"
"5459",28,38,188,180,191,173,161,162,29,28,2,4,20,11,"win_A",-10,8,18,-1,0,1,0,0,0.935483870967742,0.875,0.645161290322581,0.34375,0,"southpaw"
"5461",27,39,188,175,191,175,163,168,27,40,1,19,19,33,"win_A",-12,13,16,-5,0,1,0,0,0.964285714285714,0.677966101694915,0.678571428571429,0.559322033898305,0,"southpaw"
"5462",27,29,188,180,191,185,163,163,26,19,1,5,19,12,"win_A",-2,8,6,0,0,0,0,0,0.962962962962963,0.791666666666667,0.703703703703704,0.5,0,"southpaw"
"5463",26,35,188,175,191,191,160,158,25,31,1,7,19,17,"win_A",-9,13,0,2,0,1,0,0,0.961538461538462,0.815789473684211,0.730769230769231,0.447368421052632,0,"southpaw"
"5466",26,32,188,170,191,178,162,161,22,19,1,4,16,12,"win_A",-6,18,13,1,0,0,0,0,0.956521739130435,0.826086956521739,0.695652173913043,0.521739130434783,0,"southpaw"
"5482",22,36,188,175,191,183,164,168,7,49,0,10,4,31,"win_A",-14,13,8,-4,0,1,0,0,1,0.830508474576271,0.571428571428571,0.525423728813559,0,"southpaw"
"5486",22,32,188,180,191,182,162,161,3,12,0,11,2,4,"win_A",-10,8,9,1,0,0,0,0,1,0.521739130434783,0.666666666666667,0.173913043478261,0,"southpaw"
"5490",33,26,168,173,177,180,134,135,37,24,4,1,18,11,"win_A",7,-5,-3,-1,0,0,0,0,0.902439024390244,0.96,0.439024390243902,0.44,0,"orthodox"
"5492",32,34,168,174,177,174,133,133,35,39,4,11,17,18,"win_A",-2,-6,3,0,0,0,0,0,0.897435897435897,0.78,0.435897435897436,0.36,0,"orthodox"
"5493",31,23,168,180,177,175,134,135,34,17,4,5,16,13,"win_A",8,-12,2,-1,0,0,0,0,0.894736842105263,0.772727272727273,0.421052631578947,0.590909090909091,0,"orthodox"
"5545",28,26,178,169,178,175,149,151,11,15,0,8,10,11,"win_A",2,9,3,-2,0,0,0,0,1,0.652173913043478,0.909090909090909,0.478260869565217,0,"orthodox"
"5549",28,33,178,168,178,183,154,154,7,39,0,8,7,24,"win_A",-5,10,-5,0,0,0,0,0,1,0.829787234042553,1,0.51063829787234,0,"orthodox"
"5584",28,33,178,180,188,185,160,160,18,23,1,8,6,14,"win_A",-5,-2,3,0,0,0,0,0,0.947368421052632,0.741935483870968,0.315789473684211,0.451612903225806,0,"southpaw"
"5586",30,27,183,178,178,188,160,160,22,16,0,1,12,6,"win_B",3,5,-10,0,0,0,0,0,1,0.941176470588235,0.545454545454545,0.352941176470588,1,"orthodox"
"5590",26,34,178,170,188,178,164,164,12,19,1,18,4,12,"win_A",-8,8,10,0,0,0,0,0,0.923076923076923,0.513513513513513,0.307692307692308,0.324324324324324,0,"southpaw"
"5591",26,30,178,188,188,198,159,161,11,15,1,8,4,10,"win_A",-4,-10,-10,-2,0,0,0,0,0.916666666666667,0.652173913043478,0.333333333333333,0.434782608695652,0,"southpaw"
"5593",31,24,171,178,184,188,157,159,17,10,17,0,7,4,"win_A",7,-7,-4,-2,0,0,0,0,0.5,1,0.205882352941176,0.4,0,"orthodox"
"5621",26,33,174,173,179,175,129,129,20,34,0,6,12,19,"win_A",-7,1,4,0,0,0,0,0,1,0.85,0.6,0.475,0,"orthodox"
"5626",29,30,173,170,175,175,132,132,29,19,6,13,16,7,"win_A",-1,3,0,0,0,0,0,0,0.828571428571429,0.59375,0.457142857142857,0.21875,0,"orthodox"
"5627",29,23,173,175,175,180,130,130,28,13,6,4,16,5,"win_A",6,-2,-5,0,0,0,0,0,0.823529411764706,0.764705882352941,0.470588235294118,0.294117647058824,0,"orthodox"
"5628",28,36,173,173,175,178,131,132,27,12,6,18,15,9,"win_A",-8,0,-3,-1,0,1,0,0,0.818181818181818,0.4,0.454545454545455,0.3,0,"orthodox"
"5634",25,22,173,170,175,185,134,134,22,17,5,2,10,5,"win_A",3,3,-10,0,0,0,0,0,0.814814814814815,0.894736842105263,0.37037037037037,0.263157894736842,0,"orthodox"
"5637",24,33,173,173,175,178,135,135,20,30,4,5,9,22,"win_A",-9,0,-3,0,0,0,0,0,0.833333333333333,0.857142857142857,0.375,0.628571428571429,0,"orthodox"
"5643",22,32,173,170,175,168,133,135,16,30,2,5,7,26,"win_A",-10,3,7,-2,0,0,0,0,0.888888888888889,0.857142857142857,0.388888888888889,0.742857142857143,0,"orthodox"
"5719",27,25,179,180,178,185,153,154,25,23,1,1,15,15,"win_A",2,-1,-7,-1,0,0,0,0,0.961538461538462,0.958333333333333,0.576923076923077,0.625,0,"orthodox"
"5769",27,30,171,167,179,172,115,115,20,25,2,5,11,9,"win_A",-3,4,7,0,0,0,0,0,0.909090909090909,0.833333333333333,0.5,0.3,0,"orthodox"
"5770",30,29,173,167,176,172,115,115,33,25,12,4,23,9,"win_A",1,6,4,0,0,0,0,0,0.733333333333333,0.862068965517241,0.511111111111111,0.310344827586207,0,"southpaw"
"5775",26,27,164,167,166,172,115,115,11,21,1,3,7,7,"win_A",-1,-3,-6,0,0,0,0,0,0.916666666666667,0.875,0.583333333333333,0.291666666666667,0,"orthodox"
"5899",29,30,177,170,183,173,156,156,29,24,2,3,16,14,"win_A",-1,7,10,0,0,0,0,0,0.935483870967742,0.888888888888889,0.516129032258065,0.518518518518518,0,"southpaw"
"5902",28,36,177,178,183,176,154,154,26,40,2,3,14,26,"win_A",-8,-1,7,0,0,1,0,0,0.928571428571429,0.930232558139535,0.5,0.604651162790698,0,"southpaw"
"5906",25,33,177,188,183,198,154,154,22,40,0,12,13,23,"win_A",-8,-11,-15,0,0,0,0,0,1,0.769230769230769,0.590909090909091,0.442307692307692,0,"southpaw"
"5912",23,25,177,178,183,165,154,154,16,9,0,4,12,3,"win_A",-2,-1,18,0,0,0,0,0,1,0.692307692307692,0.75,0.230769230769231,0,"southpaw"
"5916",22,26,177,168,183,178,157,160,12,16,0,5,10,13,"win_A",-4,9,5,-3,0,0,0,0,1,0.761904761904762,0.833333333333333,0.619047619047619,0,"southpaw"
"5918",21,31,177,168,183,175,154,155,10,13,0,5,8,9,"win_A",-10,9,8,-1,0,0,0,0,1,0.722222222222222,0.8,0.5,0,"southpaw"
"5936",30,28,160,166,165,172,112,112,17,32,3,5,9,23,"win_A",2,-6,-7,0,0,0,0,0,0.85,0.864864864864865,0.45,0.621621621621622,0,"orthodox"
"5937",30,29,160,167,165,171,112,112,16,17,3,1,9,10,"win_A",1,-7,-6,0,0,0,0,0,0.842105263157895,0.944444444444444,0.473684210526316,0.555555555555556,0,"orthodox"
"5939",23,29,165,160,169,165,105,105,9,15,0,2,6,8,"win_A",-6,5,4,0,0,0,0,0,1,0.882352941176471,0.666666666666667,0.470588235294118,0,"orthodox"
"5940",28,33,160,157,165,160,105,105,14,23,2,3,7,16,"win_A",-5,3,5,0,0,0,0,0,0.875,0.884615384615385,0.4375,0.615384615384615,0,"orthodox"
"6022",30,31,170,168,172,168,120,125,21,27,1,12,12,21,"win_A",-1,2,4,-5,0,0,0,0,0.954545454545455,0.692307692307692,0.545454545454545,0.538461538461538,0,"orthodox"
"6103",26,34,171,174,177,175,139,140,24,19,3,1,19,18,"win_B",-8,-3,2,-1,0,0,0,0,0.888888888888889,0.95,0.703703703703704,0.9,1,"southpaw"
"6128",24,21,178,167,185,173,141,141,21,15,4,0,19,6,"win_A",3,11,12,0,0,0,0,0,0.84,1,0.76,0.4,0,"orthodox"
"6149",26,33,172,172,176,171,122,122,13,24,1,7,4,7,"win_A",-7,0,5,0,0,0,0,0,0.928571428571429,0.774193548387097,0.285714285714286,0.225806451612903,0,"orthodox"
"6153",25,24,175,172,176,176,122,122,12,10,4,0,5,2,"win_A",1,3,0,0,0,0,0,0,0.75,1,0.3125,0.2,0,"southpaw"
"6217",28,24,168,178,175,180,135,135,26,23,0,1,26,17,"win_A",4,-10,-5,0,0,0,0,0,1,0.958333333333333,1,0.708333333333333,0,"southpaw"
"6221",22,30,178,170,180,175,134,136,19,23,1,4,14,8,"win_A",-8,8,5,-2,0,0,0,0,0.95,0.851851851851852,0.7,0.296296296296296,0,"southpaw"
"6224",21,28,178,178,180,183,139,142,16,9,1,11,12,4,"win_A",-7,0,-3,-3,0,0,0,0,0.941176470588235,0.45,0.705882352941177,0.2,0,"southpaw"
"6226",21,34,178,180,180,183,139,140,14,39,1,34,11,34,"win_A",-13,-2,-3,-1,0,0,0,0,0.933333333333333,0.534246575342466,0.733333333333333,0.465753424657534,0,"southpaw"
"6243",28,28,192,191,193,193,242,225,20,15,2,0,15,12,"win_B",0,1,0,17,0,0,1,0,0.909090909090909,1,0.681818181818182,0.8,1,"southpaw"
"6246",26,24,191,191,193,206,252,232,12,9,0,1,10,8,"win_A",2,0,-13,20,0,0,1,0,1,0.9,0.833333333333333,0.8,0,"orthodox"
"6284",28,22,169,163,173,165,108,107,22,18,2,3,12,12,"win_A",6,6,8,1,0,0,0,0,0.916666666666667,0.857142857142857,0.5,0.571428571428571,0,"orthodox"
"6286",31,21,158,163,159,165,105,105,27,16,6,2,10,12,"win_B",10,-5,-6,0,0,0,0,0,0.818181818181818,0.888888888888889,0.303030303030303,0.666666666666667,1,"orthodox"
"6423",31,31,157,157,160,165,115,114,35,25,5,8,24,15,"win_A",0,0,-5,1,0,0,0,0,0.875,0.757575757575758,0.6,0.454545454545455,0,"orthodox"
"6429",27,31,157,165,160,168,112,112,28,19,3,1,21,9,"win_A",-4,-8,-8,0,0,0,0,0,0.903225806451613,0.95,0.67741935483871,0.45,0,"orthodox"
"6435",23,26,160,157,152,160,112,112,31,23,2,2,24,18,"win_A",-3,3,-8,0,0,0,0,0,0.939393939393939,0.92,0.727272727272727,0.72,0,"southpaw"
"6436",25,30,157,168,160,160,114,114,22,31,2,8,17,16,"win_A",-5,-11,0,0,0,0,0,0,0.916666666666667,0.794871794871795,0.708333333333333,0.41025641025641,0,"orthodox"
"6437",25,22,157,160,160,152,112,112,22,29,1,2,17,22,"win_B",3,-3,8,0,0,0,0,0,0.956521739130435,0.935483870967742,0.739130434782609,0.709677419354839,1,"orthodox"
"6438",24,34,157,161,160,168,112,112,21,50,1,2,16,20,"win_A",-10,-4,-8,0,0,0,0,0,0.954545454545455,0.961538461538462,0.727272727272727,0.384615384615385,0,"orthodox"
"6441",24,30,157,168,160,168,111,112,18,27,1,9,13,21,"win_A",-6,-11,-8,-1,0,0,0,0,0.947368421052632,0.75,0.684210526315789,0.583333333333333,0,"orthodox"
"6500",33,26,178,177,178,171,139,140,40,21,5,0,14,19,"win_A",7,1,7,-1,0,0,0,0,0.888888888888889,1,0.311111111111111,0.904761904761905,0,"orthodox"
"6508",28,31,178,170,178,168,135,135,32,28,2,4,9,23,"win_A",-3,8,10,0,0,0,0,0,0.941176470588235,0.875,0.264705882352941,0.71875,0,"orthodox"
"6527",23,30,178,170,178,178,132,132,14,16,1,29,3,6,"win_A",-7,8,0,0,0,0,0,0,0.933333333333333,0.355555555555556,0.2,0.133333333333333,0,"orthodox"
"6679",22,31,178,173,184,175,141,141,14,26,0,7,11,13,"win_A",-9,5,9,0,0,0,0,0,1,0.787878787878788,0.785714285714286,0.393939393939394,0,"orthodox"
"6685",21,25,178,178,184,183,141,141,8,10,0,3,6,9,"win_A",-4,0,1,0,0,0,0,0,1,0.769230769230769,0.75,0.692307692307692,0,"orthodox"
"6694",40,32,190,185,208,187,205,202,28,19,8,11,13,13,"win_A",8,5,21,3,1,0,0,0,0.777777777777778,0.633333333333333,0.361111111111111,0.433333333333333,0,"orthodox"
"6696",38,30,190,188,208,197,205,278,27,10,6,0,12,8,"win_A",8,2,11,-73,1,0,0,1,0.818181818181818,1,0.363636363636364,0.8,0,"orthodox"
"6699",24,36,206,190,216,208,210,254,20,25,0,5,14,12,"win_A",-12,16,8,-44,0,1,0,1,1,0.833333333333333,0.7,0.4,0,"orthodox"
"6700",36,36,187,190,191,208,203,223,47,25,2,4,29,12,"win_A",0,-3,-17,-20,1,1,0,1,0.959183673469388,0.862068965517241,0.591836734693878,0.413793103448276,0,"orthodox"
"6701",36,35,190,188,208,193,207,239,24,21,4,10,12,10,"win_A",1,2,15,-32,1,1,0,1,0.857142857142857,0.67741935483871,0.428571428571429,0.32258064516129,0,"orthodox"
"6703",35,26,190,193,208,196,199,200,24,24,2,1,12,13,"win_B",9,-3,12,-1,1,0,0,0,0.923076923076923,0.96,0.461538461538462,0.52,1,"orthodox"
"6707",32,32,190,187,208,191,197,198,21,35,1,1,11,24,"win_B",0,3,17,-1,0,0,0,0,0.954545454545455,0.972222222222222,0.5,0.666666666666667,1,"orthodox"
"6708",25,30,186,190,191,208,194,196,37,19,1,1,27,10,"win_B",-5,-4,-17,-2,0,0,0,0,0.973684210526316,0.95,0.710526315789474,0.5,1,"orthodox"
"6709",25,30,186,190,191,208,193,194,36,19,1,0,27,10,"win_A",-5,-4,-17,-1,0,0,0,0,0.972972972972973,1,0.72972972972973,0.526315789473684,0,"orthodox"
"6712",28,32,190,193,208,193,190,192,16,31,0,2,9,24,"win_A",-4,-3,15,-2,0,0,0,0,1,0.939393939393939,0.5625,0.727272727272727,0,"orthodox"
"6715",27,37,190,185,208,196,189,189,13,19,0,5,8,10,"win_A",-10,5,12,0,0,1,0,0,1,0.791666666666667,0.615384615384615,0.416666666666667,0,"orthodox"
"6742",25,34,175,173,180,183,146,146,4,3,0,5,3,1,"win_A",-9,2,-3,0,0,0,0,0,1,0.375,0.75,0.125,0,"orthodox"
"6772",31,27,175,178,175,185,148,147,19,24,3,2,9,16,"win_A",4,-3,-10,1,0,0,0,0,0.863636363636364,0.923076923076923,0.409090909090909,0.615384615384615,0,"orthodox"
"6777",25,27,173,175,178,175,140,140,9,15,0,1,3,7,"win_A",-2,-2,3,0,0,0,0,0,1,0.9375,0.333333333333333,0.4375,0,"southpaw"
"6779",26,32,175,170,175,170,144,144,13,15,1,7,6,6,"win_A",-6,5,5,0,0,0,0,0,0.928571428571429,0.681818181818182,0.428571428571429,0.272727272727273,0,"orthodox"
"6781",26,28,175,178,175,191,143,138,11,7,1,15,5,5,"win_A",-2,-3,-16,5,0,0,0,0,0.916666666666667,0.318181818181818,0.416666666666667,0.227272727272727,0,"orthodox"
"6787",24,22,175,183,175,196,147,147,6,6,0,7,3,6,"win_A",2,-8,-21,0,0,0,0,0,1,0.461538461538462,0.5,0.461538461538462,0,"orthodox"
"6820",28,32,180,168,185,173,160,167,16,17,1,19,13,13,"win_A",-4,12,12,-7,0,0,0,0,0.941176470588235,0.472222222222222,0.764705882352941,0.361111111111111,0,"orthodox"
"6831",27,32,180,170,185,183,158,159,6,10,0,14,5,9,"win_A",-5,10,2,-1,0,0,0,0,1,0.416666666666667,0.833333333333333,0.375,0,"orthodox"
"6895",21,25,170,164,173,170,125,126,21,24,0,4,16,16,"win_A",-4,6,3,-1,0,0,0,0,1,0.857142857142857,0.761904761904762,0.571428571428571,0,"orthodox"
"7030",23,43,185,183,194,183,158,159,17,56,0,10,14,34,"win_A",-20,2,11,-1,0,1,0,0,1,0.848484848484849,0.823529411764706,0.515151515151515,0,"orthodox"
"7154",29,33,182,186,195,196,188,194,9,7,0,10,5,5,"win_A",-4,-4,-1,-6,0,0,0,0,1,0.411764705882353,0.555555555555556,0.294117647058824,0,"southpaw"
"7234",27,32,160,158,164,159,105,105,16,30,3,7,10,12,"win_A",-5,2,5,0,0,0,0,0,0.842105263157895,0.810810810810811,0.526315789473684,0.324324324324324,0,"orthodox"
"7237",23,25,160,160,164,164,105,105,25,14,3,2,14,8,"win_A",-2,0,0,0,0,0,0,0,0.892857142857143,0.875,0.5,0.5,0,"orthodox"
"7265",20,32,178,170,183,183,146,154,14,10,0,13,10,9,"win_A",-12,8,0,-8,0,0,0,0,1,0.434782608695652,0.714285714285714,0.391304347826087,0,"orthodox"
"7311",24,34,168,168,170,170,130,130,16,8,4,9,3,2,"win_A",-10,0,0,0,0,0,0,0,0.8,0.470588235294118,0.15,0.117647058823529,0,"southpaw"
"7312",26,23,173,168,178,170,129,130,14,15,0,4,7,3,"win_B",3,5,8,-1,0,0,0,0,1,0.789473684210526,0.5,0.157894736842105,1,"orthodox"
"7314",23,34,168,168,170,168,130,130,13,10,4,11,2,2,"win_A",-11,0,2,0,0,0,0,0,0.764705882352941,0.476190476190476,0.117647058823529,0.0952380952380952,0,"southpaw"
"7325",21,21,168,168,164,170,130,130,7,4,0,2,5,1,"win_A",0,0,-6,0,0,0,0,0,1,0.666666666666667,0.714285714285714,0.166666666666667,0,"orthodox"
"7339",37,41,180,183,178,183,156,156,43,54,4,9,25,32,"win_A",-4,-3,-5,0,1,1,0,0,0.914893617021277,0.857142857142857,0.531914893617021,0.507936507936508,0,"orthodox"
"7346",34,28,180,183,178,181,159,158,37,27,3,2,23,17,"win_A",6,-3,-3,1,0,0,0,0,0.925,0.931034482758621,0.575,0.586206896551724,0,"orthodox"
"7367",28,31,180,180,178,185,168,167,18,29,1,4,14,26,"win_A",-3,0,-7,1,0,0,0,0,0.947368421052632,0.878787878787879,0.736842105263158,0.787878787878788,0,"orthodox"
"7541",29,31,188,178,194,171,198,198,10,10,0,0,6,3,"win_B",-2,10,23,0,0,0,0,0,1,1,0.6,0.3,1,"orthodox"
"7548",29,34,178,191,171,196,216,236,3,2,0,1,2,1,"win_A",-5,-13,-25,-20,0,0,0,1,1,0.666666666666667,0.666666666666667,0.333333333333333,0,"southpaw"
"7556",28,27,174,170,178,183,129,130,23,23,2,7,16,16,"win_B",1,4,-5,-1,0,0,0,0,0.92,0.766666666666667,0.64,0.533333333333333,1,"orthodox"
"7603",37,28,180,170,185,178,154,154,38,39,8,7,27,23,"win_A",9,10,7,0,1,0,0,0,0.826086956521739,0.847826086956522,0.58695652173913,0.5,0,"orthodox"
"7605",32,30,180,178,185,183,154,153,37,28,6,2,27,21,"win_A",2,2,2,1,0,0,0,0,0.86046511627907,0.933333333333333,0.627906976744186,0.7,0,"orthodox"
"7607",27,30,170,180,170,185,147,147,32,36,0,5,26,26,"win_B",-3,-10,-15,0,0,0,0,0,1,0.878048780487805,0.8125,0.634146341463415,1,"orthodox"
"7611",28,29,180,173,185,178,147,147,33,30,4,1,24,20,"win_A",-1,7,7,0,0,0,0,0,0.891891891891892,0.967741935483871,0.648648648648649,0.645161290322581,0,"orthodox"
"7615",28,26,182,180,188,185,153,154,28,30,2,3,20,21,"win_A",2,2,3,-1,0,0,0,0,0.933333333333333,0.909090909090909,0.666666666666667,0.636363636363636,0,"southpaw"
"7622",22,39,180,173,185,173,147,147,23,55,3,7,15,42,"win_A",-17,7,12,0,0,1,0,0,0.884615384615385,0.887096774193548,0.576923076923077,0.67741935483871,0,"orthodox"
"7628",21,22,180,180,185,178,151,147,17,16,3,1,10,10,"win_A",-1,0,7,4,0,0,0,0,0.85,0.941176470588235,0.5,0.588235294117647,0,"orthodox"
"7634",19,24,180,178,185,185,147,149,11,8,3,0,6,7,"win_A",-5,2,0,-2,0,0,0,0,0.785714285714286,1,0.428571428571429,0.875,0,"orthodox"
"7635",18,28,180,170,185,178,147,145,10,41,3,14,6,31,"win_A",-10,10,7,2,0,0,0,0,0.769230769230769,0.745454545454545,0.461538461538462,0.563636363636364,0,"orthodox"
"7639",17,27,180,174,185,173,147,147,8,13,1,0,4,6,"win_B",-10,6,12,0,0,0,0,0,0.888888888888889,1,0.444444444444444,0.461538461538462,1,"orthodox"
"7695",28,34,196,193,203,191,243,241,19,35,0,9,17,27,"win_A",-6,3,12,2,0,0,0,0,1,0.795454545454545,0.894736842105263,0.613636363636364,0,"southpaw"
"7697",28,37,196,193,203,206,241,265,17,24,0,8,15,18,"win_A",-9,3,-3,-24,0,1,0,1,1,0.75,0.882352941176471,0.5625,0,"southpaw"
"7698",28,38,196,201,203,216,246,254,16,21,0,10,14,15,"win_A",-10,-5,-13,-8,0,1,0,0,1,0.67741935483871,0.875,0.483870967741935,0,"southpaw"
"7703",27,23,196,178,203,178,238,237,11,8,0,2,9,3,"win_A",4,18,25,1,0,0,0,0,1,0.8,0.818181818181818,0.3,0,"southpaw"
"7728",23,25,168,165,169,175,118,117,12,16,0,4,8,10,"win_A",-2,3,-6,1,0,0,0,0,1,0.8,0.666666666666667,0.5,0,"orthodox"
"7732",21,30,168,168,169,168,117,118,8,8,0,4,5,3,"win_A",-9,0,1,-1,0,0,0,0,1,0.666666666666667,0.625,0.25,0,"orthodox"
"7734",21,29,168,163,169,173,115,113,6,14,0,14,5,8,"win_A",-8,5,-4,2,0,0,0,0,1,0.5,0.833333333333333,0.285714285714286,0,"orthodox"
"7738",20,26,168,157,169,168,118,117,2,2,0,12,2,0,"win_A",-6,11,1,1,0,0,0,0,1,0.142857142857143,1,0,0,"orthodox"
"7763",28,26,159,162,166,162,118,115,29,31,2,6,20,22,"win_A",2,-3,4,3,0,0,0,0,0.935483870967742,0.837837837837838,0.645161290322581,0.594594594594595,0,"orthodox"
"7776",23,23,159,160,166,163,105,105,16,21,1,3,13,11,"win_A",0,-1,3,0,0,0,0,0,0.941176470588235,0.875,0.764705882352941,0.458333333333333,0,"orthodox"
"7777",23,23,159,152,166,168,105,105,15,18,1,4,12,5,"win_A",0,7,-2,0,0,0,0,0,0.9375,0.818181818181818,0.75,0.227272727272727,0,"orthodox"
"7821",32,35,200,195,201,210,239,254,22,33,0,3,13,20,"win_B",-3,5,-9,-15,0,1,0,1,1,0.916666666666667,0.590909090909091,0.555555555555556,1,"orthodox"
"7888",23,24,170,164,168,170,118,117,29,46,0,2,18,31,"win_A",-1,6,-2,1,0,0,0,0,1,0.958333333333333,0.620689655172414,0.645833333333333,0,"orthodox"
"7889",22,29,170,172,168,177,118,118,28,17,0,0,18,11,"win_A",-7,-2,-9,0,0,0,0,0,1,1,0.642857142857143,0.647058823529412,0,"orthodox"
"7895",20,22,170,165,168,165,118,118,22,8,0,0,14,3,"win_A",-2,5,3,0,0,0,0,0,1,1,0.636363636363636,0.375,0,"orthodox"
"7900",19,24,170,168,168,167,117,118,17,30,0,17,12,13,"win_A",-5,2,1,-1,0,0,0,0,1,0.638297872340426,0.705882352941177,0.276595744680851,0,"orthodox"
"7949",24,35,168,163,165,170,122,122,27,15,0,11,19,6,"win_A",-11,5,-5,0,0,1,0,0,1,0.576923076923077,0.703703703703704,0.230769230769231,0,"orthodox"
"7950",24,27,168,165,165,175,122,122,26,33,0,9,18,27,"win_A",-3,3,-10,0,0,0,0,0,1,0.785714285714286,0.692307692307692,0.642857142857143,0,"orthodox"
"7953",23,18,168,168,165,163,118,124,23,3,0,1,15,3,"win_A",5,0,2,-6,0,0,0,0,1,0.75,0.652173913043478,0.75,0,"orthodox"
"7958",22,32,168,168,165,173,125,126,18,22,0,25,13,10,"win_A",-10,0,-8,-1,0,0,0,0,1,0.468085106382979,0.722222222222222,0.212765957446809,0,"orthodox"
"7993",30,28,165,173,174,186,136,133,35,27,1,4,18,21,"win_A",2,-8,-12,3,0,0,0,0,0.972222222222222,0.870967741935484,0.5,0.67741935483871,0,"southpaw"
"8032",35,36,168,173,173,176,130,130,55,48,8,14,26,32,"win_A",-1,-5,-3,0,1,1,0,0,0.873015873015873,0.774193548387097,0.412698412698413,0.516129032258065,0,"southpaw"
"8053",30,27,168,168,176,173,118,118,17,36,0,5,10,15,"win_A",3,0,3,0,0,0,0,0,1,0.878048780487805,0.588235294117647,0.365853658536585,0,"orthodox"
"8054",27,29,168,168,173,176,118,118,36,16,4,0,15,10,"win_B",-2,0,-3,0,0,0,0,0,0.9,1,0.375,0.625,1,"southpaw"
"8055",27,32,168,166,173,164,115,115,36,30,3,1,15,24,"win_B",-5,2,9,0,0,0,0,0,0.923076923076923,0.967741935483871,0.384615384615385,0.774193548387097,1,"southpaw"
"8056",26,38,168,159,173,160,115,115,35,62,3,3,14,37,"win_A",-12,9,13,0,0,1,0,0,0.921052631578947,0.953846153846154,0.368421052631579,0.569230769230769,0,"southpaw"
"8058",26,26,168,166,173,173,115,115,33,26,3,3,14,12,"win_A",0,2,0,0,0,0,0,0,0.916666666666667,0.896551724137931,0.388888888888889,0.413793103448276,0,"southpaw"
"8061",27,25,164,168,168,173,115,115,46,30,3,3,35,12,"win_B",2,-4,-5,0,0,0,0,0,0.938775510204082,0.909090909090909,0.714285714285714,0.363636363636364,1,"orthodox"
"8062",25,32,168,165,173,165,115,115,29,30,3,5,11,20,"win_A",-7,3,8,0,0,0,0,0,0.90625,0.857142857142857,0.34375,0.571428571428571,0,"southpaw"
"8063",25,33,168,165,173,175,115,115,28,28,3,3,11,19,"win_A",-8,3,-2,0,0,0,0,0,0.903225806451613,0.903225806451613,0.354838709677419,0.612903225806452,0,"southpaw"
"8064",24,31,168,165,173,165,115,115,27,30,3,4,11,20,"win_A",-7,3,8,0,0,0,0,0,0.9,0.882352941176471,0.366666666666667,0.588235294117647,0,"southpaw"
"8069",23,28,168,163,173,165,117,117,22,12,3,7,8,7,"win_A",-5,5,8,0,0,0,0,0,0.88,0.631578947368421,0.32,0.368421052631579,0,"southpaw"
"8073",22,23,168,173,173,176,115,115,18,19,3,5,6,11,"win_A",-1,-5,-3,0,0,0,0,0,0.857142857142857,0.791666666666667,0.285714285714286,0.458333333333333,0,"southpaw"
"8139",22,30,161,164,162,166,115,115,19,15,4,3,7,9,"win_A",-8,-3,-4,0,0,0,0,0,0.826086956521739,0.833333333333333,0.304347826086957,0.5,0,"orthodox"
"8140",31,22,173,161,176,162,115,115,36,18,12,4,24,7,"win_B",9,12,14,0,0,0,0,0,0.75,0.818181818181818,0.5,0.318181818181818,1,"southpaw"
"8154",18,19,161,157,162,158,109,109,6,5,2,1,0,5,"win_A",-1,4,4,0,0,0,0,0,0.75,0.833333333333333,0,0.833333333333333,0,"orthodox"
"8206",35,35,178,175,180,183,154,153,25,24,6,13,11,9,"win_A",0,3,-3,1,1,1,0,0,0.806451612903226,0.648648648648649,0.354838709677419,0.243243243243243,0,"orthodox"
"8208",34,33,178,173,180,183,154,154,23,17,5,7,11,8,"win_A",1,5,-3,0,0,0,0,0,0.821428571428571,0.708333333333333,0.392857142857143,0.333333333333333,0,"orthodox"
"8215",29,25,178,175,180,178,157,157,18,10,2,10,8,10,"win_A",4,3,2,0,0,0,0,0,0.9,0.5,0.4,0.5,0,"orthodox"
"8218",27,33,178,175,180,188,154,155,16,10,1,5,7,4,"win_A",-6,3,-8,-1,0,0,0,0,0.941176470588235,0.666666666666667,0.411764705882353,0.266666666666667,0,"orthodox"
"8222",25,29,178,175,180,178,147,146,13,27,0,3,7,26,"win_A",-4,3,2,1,0,0,0,0,1,0.9,0.538461538461538,0.866666666666667,0,"orthodox"
"8223",25,24,178,175,180,178,149,148,12,15,0,0,7,7,"win_A",1,3,2,1,0,0,0,0,1,1,0.583333333333333,0.466666666666667,0,"orthodox"
"8225",24,33,178,180,180,185,150,150,10,34,0,6,6,30,"win_A",-9,-2,-5,0,0,0,0,0,1,0.85,0.6,0.75,0,"orthodox"
"8232",22,20,178,175,180,175,148,147,3,1,0,0,3,0,"win_A",2,3,5,1,0,0,0,0,1,1,1,0,0,"orthodox"
"8268",24,30,178,170,185,173,139,140,21,25,1,3,14,12,"win_A",-6,8,12,-1,0,0,0,0,0.954545454545455,0.892857142857143,0.636363636363636,0.428571428571429,0,"orthodox"
"8270",23,38,178,170,185,170,142,142,19,55,1,19,14,38,"win_A",-15,8,15,0,0,1,0,0,0.95,0.743243243243243,0.7,0.513513513513513,0,"orthodox"
"8271",23,35,178,168,185,168,141,142,18,20,1,5,13,13,"win_A",-12,10,17,-1,0,1,0,0,0.947368421052632,0.8,0.684210526315789,0.52,0,"orthodox"
"8274",22,28,178,178,185,183,146,147,16,33,0,1,12,27,"win_B",-6,0,2,-1,0,0,0,0,1,0.970588235294118,0.75,0.794117647058823,1,"orthodox"
"8279",21,37,178,170,185,178,144,143,11,37,0,17,10,22,"win_A",-16,8,7,1,0,1,0,0,1,0.685185185185185,0.909090909090909,0.407407407407407,0,"orthodox"
"8282",21,35,178,178,185,180,147,148,8,4,0,8,7,2,"win_A",-14,0,5,-1,0,1,0,0,1,0.333333333333333,0.875,0.166666666666667,0,"orthodox"
"8345",25,35,185,187,183,183,175,175,13,24,0,12,10,10,"win_A",-10,-2,0,0,0,1,0,0,1,0.666666666666667,0.769230769230769,0.277777777777778,0,"southpaw"
"8362",26,32,170,163,180,160,126,126,25,17,1,4,10,10,"win_A",-6,7,20,0,0,0,0,0,0.961538461538462,0.80952380952381,0.384615384615385,0.476190476190476,0,"orthodox"
"8366",23,37,170,163,180,168,128,127,21,36,0,27,10,28,"win_A",-14,7,12,1,0,1,0,0,1,0.571428571428571,0.476190476190476,0.444444444444444,0,"orthodox"
"8369",22,30,170,180,180,188,130,130,18,16,0,6,8,7,"win_A",-8,-10,-8,0,0,0,0,0,1,0.727272727272727,0.444444444444444,0.318181818181818,0,"orthodox"
"8370",22,23,170,175,180,180,128,130,17,13,0,5,8,5,"win_A",-1,-5,0,-2,0,0,0,0,1,0.722222222222222,0.470588235294118,0.277777777777778,0,"orthodox"
"8372",21,22,170,170,180,173,129,129,14,7,0,8,6,5,"win_A",-1,0,7,0,0,0,0,0,1,0.466666666666667,0.428571428571429,0.333333333333333,0,"orthodox"
"8374",20,31,170,168,180,173,128,128,12,20,0,16,6,9,"win_A",-11,2,7,0,0,0,0,0,1,0.555555555555556,0.5,0.25,0,"orthodox"
"8384",19,28,170,157,180,165,123,121,2,9,0,14,1,6,"win_A",-9,13,15,2,0,0,0,0,1,0.391304347826087,0.5,0.260869565217391,0,"orthodox"
"8387",28,27,173,178,179,185,140,140,27,25,1,7,22,21,"win_A",1,-5,-6,0,0,0,0,0,0.964285714285714,0.78125,0.785714285714286,0.65625,0,"southpaw"
"8388",28,26,173,175,179,180,140,140,26,39,1,9,21,23,"win_A",2,-2,-1,0,0,0,0,0,0.962962962962963,0.8125,0.777777777777778,0.479166666666667,0,"southpaw"
"8408",22,30,173,173,179,183,143,144,6,6,0,2,4,4,"win_A",-8,0,-4,-1,0,0,0,0,1,0.75,0.666666666666667,0.5,0,"southpaw"
"8514",32,29,168,173,175,173,147,146,32,33,1,2,12,24,"win_A",3,-5,2,1,0,0,0,0,0.96969696969697,0.942857142857143,0.363636363636364,0.685714285714286,0,"orthodox"
"8516",28,28,173,171,173,169,147,148,31,23,2,1,23,19,"win_A",0,2,4,-1,0,0,0,0,0.939393939393939,0.958333333333333,0.696969696969697,0.791666666666667,0,"orthodox"
"8517",26,32,173,175,173,177,140,140,31,33,0,1,23,23,"win_B",-6,-2,-4,0,0,0,0,0,1,0.970588235294118,0.741935483870968,0.676470588235294,1,"orthodox"
"8519",25,29,173,175,173,183,137,135,29,17,0,2,22,8,"win_A",-4,-2,-10,2,0,0,0,0,1,0.894736842105263,0.758620689655172,0.421052631578947,0,"orthodox"
"8524",24,25,173,173,173,188,135,134,24,30,0,0,18,20,"win_A",-1,0,-15,1,0,0,0,0,1,1,0.75,0.666666666666667,0,"orthodox"
"8525",23,24,173,183,173,188,135,134,23,23,0,1,17,15,"win_A",-1,-10,-15,1,0,0,0,0,1,0.958333333333333,0.739130434782609,0.625,0,"orthodox"
"8531",22,34,173,170,173,183,135,135,17,26,0,18,11,22,"win_A",-12,3,-10,0,0,0,0,0,1,0.590909090909091,0.647058823529412,0.5,0,"orthodox"
"8532",22,22,173,175,173,173,129,129,16,24,0,3,11,15,"win_A",0,-2,0,0,0,0,0,0,1,0.888888888888889,0.6875,0.555555555555556,0,"orthodox"
"8534",21,29,173,170,173,173,132,132,14,8,0,2,10,2,"win_A",-8,3,0,0,0,0,0,0,1,0.8,0.714285714285714,0.2,0,"orthodox"
"8535",20,20,173,173,173,183,133,133,13,10,0,3,10,6,"win_A",0,0,-10,0,0,0,0,0,1,0.769230769230769,0.769230769230769,0.461538461538462,0,"orthodox"
"8540",19,20,173,175,173,190,133,133,8,4,0,6,6,3,"win_A",-1,-2,-17,0,0,0,0,0,1,0.4,0.75,0.3,0,"orthodox"
"8541",19,27,173,170,173,170,136,133,7,6,0,2,6,4,"win_A",-8,3,3,3,0,0,0,0,1,0.75,0.857142857142857,0.5,0,"orthodox"
"8573",21,29,168,165,170,170,122,122,29,26,0,12,22,13,"win_A",-8,3,0,0,0,0,0,0,1,0.684210526315789,0.758620689655172,0.342105263157895,0,"orthodox"
"8574",20,24,168,165,170,165,130,130,28,10,0,5,22,3,"win_A",-4,3,5,0,0,0,0,0,1,0.666666666666667,0.785714285714286,0.2,0,"orthodox"
"8576",19,22,168,168,170,177,122,122,26,17,0,3,22,3,"win_A",-3,0,-7,0,0,0,0,0,1,0.85,0.846153846153846,0.15,0,"orthodox"
"8580",19,30,168,165,170,175,124,122,22,12,0,5,19,5,"win_A",-11,3,-5,2,0,0,0,0,1,0.705882352941177,0.863636363636364,0.294117647058824,0,"orthodox"
"8586",17,31,168,178,170,169,127,127,16,12,0,22,13,8,"win_A",-14,-10,1,0,0,0,0,0,1,0.352941176470588,0.8125,0.235294117647059,0,"orthodox"
"8638",21,37,177,180,189,187,157,159,16,23,0,1,11,15,"win_A",-16,-3,2,-2,0,1,0,0,1,0.958333333333333,0.6875,0.625,0,"southpaw"
"8677",25,32,188,168,194,188,171,172,24,23,1,19,20,15,"win_A",-7,20,6,-1,0,0,0,0,0.96,0.547619047619048,0.8,0.357142857142857,0,"orthodox"
"8680",31,23,180,188,179,194,160,160,23,22,0,0,14,18,"win_A",8,-8,-15,0,0,0,0,0,1,1,0.608695652173913,0.818181818181818,0,"southpaw"
"8681",23,36,188,188,194,198,160,160,21,42,0,13,17,24,"win_A",-13,0,-4,0,0,1,0,0,1,0.763636363636364,0.80952380952381,0.436363636363636,0,"orthodox"
"8705",26,30,174,169,179,168,129,129,21,23,0,1,12,13,"win_A",-4,5,11,0,0,0,0,0,1,0.958333333333333,0.571428571428571,0.541666666666667,0,"orthodox"
"8706",30,34,169,166,168,173,130,129,22,37,1,3,12,19,"win_A",-4,3,-5,1,0,0,0,0,0.956521739130435,0.925,0.521739130434783,0.475,0,"orthodox"
"8735",27,30,168,170,163,170,117,117,20,21,2,1,5,14,"win_B",-3,-2,-7,0,0,0,0,0,0.909090909090909,0.954545454545455,0.227272727272727,0.636363636363636,1,"orthodox"
"8789",26,24,173,175,170,175,140,139,15,14,0,0,12,9,"win_A",2,-2,-5,1,0,0,0,0,1,1,0.8,0.642857142857143,0,"southpaw"
"8790",26,25,173,170,170,171,139,139,14,11,0,0,12,9,"win_A",1,3,-1,0,0,0,0,0,1,1,0.857142857142857,0.818181818181818,0,"southpaw"
"8792",25,39,173,170,170,170,144,143,12,56,0,24,10,38,"win_A",-14,3,0,1,0,1,0,0,1,0.7,0.833333333333333,0.475,0,"southpaw"
"8799",34,24,173,173,183,170,145,145,3,5,4,0,1,4,"win_B",10,0,13,0,0,0,0,0,0.428571428571429,1,0.142857142857143,0.8,1,"orthodox"
"8830",29,21,169,168,170,168,118,118,4,6,0,1,2,0,"win_A",8,1,2,0,0,0,0,0,1,0.857142857142857,0.5,0,0,"orthodox"
"8874",25,28,169,157,173,165,108,108,17,22,1,2,8,12,"win_A",-3,12,8,0,0,0,0,0,0.944444444444444,0.916666666666667,0.444444444444444,0.5,0,"orthodox"
"8875",25,28,169,165,173,160,111,111,16,18,1,5,8,14,"win_A",-3,4,13,0,0,0,0,0,0.941176470588235,0.782608695652174,0.470588235294118,0.608695652173913,0,"orthodox"
"8883",22,20,169,163,173,164,112,113,8,3,0,9,4,2,"win_A",2,6,9,-1,0,0,0,0,1,0.25,0.5,0.166666666666667,0,"orthodox"
"8913",28,27,173,173,178,178,140,140,15,23,0,4,5,16,"win_B",1,0,0,0,0,0,0,0,1,0.851851851851852,0.333333333333333,0.592592592592593,1,"southpaw"
"8914",28,26,175,173,183,178,147,147,23,23,2,3,12,16,"win_A",2,2,5,0,0,0,0,0,0.92,0.884615384615385,0.48,0.615384615384615,0,"southpaw"
"8970",25,39,175,168,178,175,134,138,18,23,2,42,9,18,"win_A",-14,7,3,-4,0,1,0,0,0.9,0.353846153846154,0.45,0.276923076923077,0,"orthodox"
"8974",30,23,179,175,170,178,130,130,28,15,4,1,14,9,"win_B",7,4,-8,0,0,0,0,0,0.875,0.9375,0.4375,0.5625,1,"orthodox"
"8979",21,28,175,173,178,175,130,130,11,13,0,16,8,6,"win_A",-7,2,3,0,0,0,0,0,1,0.448275862068966,0.727272727272727,0.206896551724138,0,"orthodox"
"8982",21,28,175,165,178,168,130,132,8,5,0,2,6,0,"win_A",-7,10,10,-2,0,0,0,0,1,0.714285714285714,0.75,0,0,"orthodox"
"8985",21,25,175,170,178,180,128,127,5,2,0,1,4,1,"win_A",-4,5,-2,1,0,0,0,0,1,0.666666666666667,0.8,0.333333333333333,0,"orthodox"
"9070",26,27,170,175,173,183,136,134,16,12,0,1,10,6,"win_A",-1,-5,-10,2,0,0,0,0,1,0.923076923076923,0.625,0.461538461538462,0,"orthodox"
"9073",25,27,170,168,173,183,141,141,13,4,0,3,7,2,"win_A",-2,2,-10,0,0,0,0,0,1,0.571428571428571,0.538461538461538,0.285714285714286,0,"orthodox"
"9174",27,23,161,174,163,177,112,112,33,11,1,1,17,8,"win_A",4,-13,-14,0,0,0,0,0,0.970588235294118,0.916666666666667,0.5,0.666666666666667,0,"southpaw"
"9290",27,26,188,180,184,193,168,168,6,12,0,4,5,6,"win_A",1,8,-9,0,0,0,0,0,1,0.75,0.833333333333333,0.375,0,"orthodox"
"9293",26,29,188,178,184,188,168,166,3,5,0,6,2,4,"win_A",-3,10,-4,2,0,0,0,0,1,0.454545454545455,0.666666666666667,0.363636363636364,0,"orthodox"
"9297",26,28,189,193,191,203,200,204,22,15,1,1,10,6,"win_A",-2,-4,-12,-4,0,0,0,0,0.956521739130435,0.9375,0.434782608695652,0.375,0,"orthodox"
"9325",26,27,170,175,173,175,140,136,26,37,1,17,14,26,"win_A",-1,-5,-2,4,0,0,0,0,0.962962962962963,0.685185185185185,0.518518518518518,0.481481481481481,0,"southpaw"
"9326",25,25,178,170,183,173,134,135,32,26,3,0,13,14,"win_A",0,8,10,-1,0,0,0,0,0.914285714285714,1,0.371428571428571,0.538461538461538,0,"orthodox"
"9329",24,26,170,175,173,173,136,136,23,34,0,7,12,21,"win_A",-2,-5,0,0,0,0,0,0,1,0.829268292682927,0.521739130434783,0.51219512195122,0,"southpaw"
"9330",23,27,170,170,173,170,136,136,22,16,0,6,12,4,"win_A",-4,0,3,0,0,0,0,0,1,0.727272727272727,0.545454545454545,0.181818181818182,0,"southpaw"
"9333",23,30,170,175,173,178,137,137,19,28,0,10,9,24,"win_A",-7,-5,-5,0,0,0,0,0,1,0.736842105263158,0.473684210526316,0.631578947368421,0,"southpaw"
"9336",22,30,170,170,173,175,138,138,16,29,0,20,7,19,"win_A",-8,0,-2,0,0,0,0,0,1,0.591836734693878,0.4375,0.387755102040816,0,"southpaw"
"9341",19,27,170,168,173,168,129,129,11,7,0,4,3,1,"win_A",-8,2,5,0,0,0,0,0,1,0.636363636363636,0.272727272727273,0.0909090909090909,0,"southpaw"
"9342",19,29,170,170,173,173,130,132,10,8,0,3,3,2,"win_A",-10,0,0,-2,0,0,0,0,1,0.727272727272727,0.3,0.181818181818182,0,"southpaw"
"9381",31,28,191,187,198,188,210,247,25,15,2,3,23,9,"win_A",3,4,10,-37,0,0,0,1,0.925925925925926,0.833333333333333,0.851851851851852,0.5,0,"orthodox"
"9384",29,38,191,188,198,198,222,231,23,44,1,8,21,30,"win_A",-9,3,0,-9,0,1,0,0,0.958333333333333,0.846153846153846,0.875,0.576923076923077,0,"orthodox"
"9385",36,29,213,191,216,198,217,316,50,22,1,1,34,21,"win_B",7,22,18,-99,1,0,0,1,0.980392156862745,0.956521739130435,0.666666666666667,0.91304347826087,1,"orthodox"
"9386",28,37,191,191,198,198,215,226,21,34,1,6,20,20,"win_A",-9,0,0,-11,0,1,0,0,0.954545454545455,0.85,0.909090909090909,0.5,0,"orthodox"
"9387",27,27,193,191,189,198,198,197,28,20,1,1,21,19,"win_B",0,2,-9,1,0,0,0,0,0.96551724137931,0.952380952380952,0.724137931034483,0.904761904761905,1,"orthodox"
"9399",23,39,191,188,198,203,199,201,9,38,0,10,9,27,"win_A",-16,3,-5,-2,0,1,0,0,1,0.791666666666667,1,0.5625,0,"orthodox"
"9409",31,31,189,182,191,184,199,200,19,27,1,3,19,21,"win_A",0,7,7,-1,0,0,0,0,0.95,0.9,0.95,0.7,0,"orthodox"
"9414",29,41,189,192,191,204,199,200,15,55,0,3,15,40,"win_A",-12,-3,-13,-1,0,1,0,0,1,0.948275862068966,1,0.689655172413793,0,"orthodox"
"9424",26,25,189,177,191,177,200,199,5,7,0,7,5,2,"win_A",1,12,14,1,0,0,0,0,1,0.5,1,0.142857142857143,0,"orthodox"
"9440",26,21,165,174,169,179,130,130,32,27,1,0,17,22,"win_A",5,-9,-10,0,0,0,0,0,0.96969696969697,1,0.515151515151515,0.814814814814815,0,"orthodox"
"9441",21,31,174,170,179,178,132,131,26,23,0,4,21,17,"win_A",-10,4,1,1,0,0,0,0,1,0.851851851851852,0.807692307692308,0.62962962962963,0,"orthodox"
"9443",21,24,174,168,179,183,133,132,24,27,0,5,19,17,"win_A",-3,6,-4,1,0,0,0,0,1,0.84375,0.791666666666667,0.53125,0,"orthodox"
"9446",20,26,174,175,179,183,132,132,21,20,0,1,18,16,"win_A",-6,-1,-4,0,0,0,0,0,1,0.952380952380952,0.857142857142857,0.761904761904762,0,"orthodox"
"9494",30,30,173,170,174,180,153,154,21,14,0,7,7,7,"win_A",0,3,-6,-1,0,0,0,0,1,0.666666666666667,0.333333333333333,0.333333333333333,0,"orthodox"
"9497",29,26,173,169,174,171,153,154,18,5,0,0,7,4,"win_A",3,4,3,-1,0,0,0,0,1,1,0.388888888888889,0.8,0,"orthodox"
"9549",26,31,183,182,180,180,168,168,22,28,0,4,13,19,"win_A",-5,1,0,0,0,0,0,0,1,0.875,0.590909090909091,0.59375,0,"orthodox"
"9550",36,31,182,182,188,180,166,167,28,28,0,3,16,19,"win_A",5,0,8,-1,1,0,0,0,1,0.903225806451613,0.571428571428571,0.612903225806452,0,"southpaw"
"9555",28,33,182,175,180,182,166,167,23,34,3,9,15,13,"win_A",-5,7,-2,-1,0,0,0,0,0.884615384615385,0.790697674418605,0.576923076923077,0.302325581395349,0,"orthodox"
"9560",34,27,180,182,185,180,168,168,41,20,0,1,31,14,"win_A",7,-2,5,0,0,0,0,0,1,0.952380952380952,0.75609756097561,0.666666666666667,0,"southpaw"
"9562",26,25,179,182,184,180,171,169,12,18,3,1,5,12,"win_B",1,-3,4,2,0,0,0,0,0.8,0.947368421052632,0.333333333333333,0.631578947368421,1,"orthodox"
"9647",24,23,178,168,183,172,135,135,27,25,3,0,12,17,"win_A",1,10,11,0,0,0,0,0,0.9,1,0.4,0.68,0,"orthodox"
"9650",26,22,180,178,183,183,136,137,21,24,0,3,18,12,"win_B",4,2,0,-1,0,0,0,0,1,0.888888888888889,0.857142857142857,0.444444444444444,1,"orthodox"
"9677",32,23,180,180,182,182,160,162,31,17,0,1,22,9,"win_A",9,0,0,-2,0,0,0,0,1,0.944444444444444,0.709677419354839,0.5,0,"orthodox"
"9680",29,26,180,175,182,183,160,160,28,25,0,1,20,19,"win_A",3,5,-1,0,0,0,0,0,1,0.961538461538462,0.714285714285714,0.730769230769231,0,"orthodox"
"9686",27,35,180,178,182,185,162,159,22,17,0,5,16,4,"win_A",-8,2,-3,3,0,1,0,0,1,0.772727272727273,0.727272727272727,0.181818181818182,0,"orthodox"
"9693",24,37,180,179,182,188,163,164,15,27,0,7,12,16,"win_A",-13,1,-6,-1,0,1,0,0,1,0.794117647058823,0.8,0.470588235294118,0,"orthodox"
"9696",23,26,180,175,182,180,160,161,12,7,0,1,11,6,"win_A",-3,5,2,-1,0,0,0,0,1,0.875,0.916666666666667,0.75,0,"orthodox"
"9697",23,26,180,178,182,193,163,163,11,9,0,3,10,1,"win_A",-3,2,-11,0,0,0,0,0,1,0.75,0.909090909090909,0.0833333333333333,0,"orthodox"
"9699",23,29,180,173,182,188,164,164,9,8,0,6,8,4,"win_A",-6,7,-6,0,0,0,0,0,1,0.571428571428571,0.888888888888889,0.285714285714286,0,"orthodox"
"9747",23,27,180,170,185,178,139,140,22,38,0,5,15,23,"win_A",-4,10,7,-1,0,0,0,0,1,0.883720930232558,0.681818181818182,0.534883720930233,0,"orthodox"
"9751",21,27,180,180,185,182,145,145,18,18,0,4,14,12,"win_A",-6,0,3,0,0,0,0,0,1,0.818181818181818,0.777777777777778,0.545454545454545,0,"orthodox"
"9756",19,26,180,160,185,170,141,142,13,4,0,4,12,0,"win_A",-7,20,15,-1,0,0,0,0,1,0.5,0.923076923076923,0,0,"orthodox"
"9771",23,30,168,165,170,170,122,121,19,14,0,7,14,6,"win_A",-7,3,0,1,0,0,0,0,1,0.666666666666667,0.736842105263158,0.285714285714286,0,"southpaw"
"9808",31,32,175,180,182,203,160,159,30,23,7,7,12,18,"win_A",-1,-5,-21,1,0,0,0,0,0.810810810810811,0.766666666666667,0.324324324324324,0.6,0,"orthodox"
"9838",24,29,175,178,182,180,164,168,3,15,2,4,1,6,"win_A",-5,-3,2,-4,0,0,0,0,0.6,0.789473684210526,0.2,0.315789473684211,0,"orthodox"
"9845",29,33,179,168,184,188,164,166,14,27,1,21,12,18,"win_A",-4,11,-4,-2,0,0,0,0,0.933333333333333,0.5625,0.8,0.375,0,"orthodox"
"9847",27,27,179,185,184,193,159,160,13,19,0,2,11,9,"win_A",0,-6,-9,-1,0,0,0,0,1,0.904761904761905,0.846153846153846,0.428571428571429,0,"orthodox"
"9850",26,27,179,180,184,177,159,159,10,17,0,3,9,7,"win_A",-1,-1,7,0,0,0,0,0,1,0.85,0.9,0.35,0,"orthodox"
"9852",26,26,179,183,184,185,160,159,8,28,0,4,8,26,"win_A",0,-4,-1,1,0,0,0,0,1,0.875,1,0.8125,0,"orthodox"
"9854",26,25,179,180,184,191,161,161,6,11,0,1,6,3,"win_A",1,-1,-7,0,0,0,0,0,1,0.916666666666667,1,0.25,0,"orthodox"
"9863",22,33,168,163,163,160,127,130,19,17,0,5,11,10,"win_A",-11,5,3,-3,0,0,0,0,1,0.772727272727273,0.578947368421053,0.454545454545455,0,"orthodox"
"9867",21,23,168,165,163,168,125,125,15,13,0,0,10,4,"win_A",-2,3,-5,0,0,0,0,0,1,1,0.666666666666667,0.307692307692308,0,"orthodox"
"9920",22,23,168,165,168,165,127,127,24,10,0,4,17,3,"win_A",-1,3,3,0,0,0,0,0,1,0.714285714285714,0.708333333333333,0.214285714285714,0,"southpaw"
"9945",28,41,165,185,169,192,136,136,34,19,2,9,18,8,"win_A",-13,-20,-23,0,0,1,0,0,0.944444444444444,0.678571428571429,0.5,0.285714285714286,0,"orthodox"
"9948",25,26,165,166,169,173,135,134,30,26,1,25,16,21,"win_A",-1,-1,-4,1,0,0,0,0,0.967741935483871,0.509803921568627,0.516129032258065,0.411764705882353,0,"orthodox"
"9953",23,21,165,170,169,170,130,130,26,25,0,2,14,16,"win_A",2,-5,-1,0,0,0,0,0,1,0.925925925925926,0.538461538461538,0.592592592592593,0,"orthodox"
"9958",23,33,165,168,169,170,132,135,21,9,0,18,11,8,"win_A",-10,-3,-1,-3,0,0,0,0,1,0.333333333333333,0.523809523809524,0.296296296296296,0,"orthodox"
"10004",22,22,201,188,211,188,249,249,17,20,0,1,11,16,"win_A",0,13,23,0,0,0,0,0,1,0.952380952380952,0.647058823529412,0.761904761904762,0,"orthodox"
"10024",25,28,160,163,152,165,115,115,37,14,4,0,26,7,"win_B",-3,-3,-13,0,0,0,0,0,0.902439024390244,1,0.634146341463415,0.5,1,"southpaw"
"10025",28,27,163,157,165,163,115,115,13,15,0,4,7,9,"win_A",1,6,2,0,0,0,0,0,1,0.789473684210526,0.538461538461538,0.473684210526316,0,"southpaw"
"10026",27,23,163,165,165,165,116,117,12,9,0,2,7,3,"win_A",4,-2,0,-1,0,0,0,0,1,0.818181818181818,0.583333333333333,0.272727272727273,0,"southpaw"
"10027",27,29,163,163,165,173,114,114,11,14,0,12,6,8,"win_A",-2,0,-8,0,0,0,0,0,1,0.538461538461538,0.545454545454545,0.307692307692308,0,"southpaw"
"10028",26,40,163,165,165,157,115,117,10,39,0,10,5,32,"win_A",-14,-2,8,-2,0,1,0,0,1,0.795918367346939,0.5,0.653061224489796,0,"southpaw"
"10029",26,23,163,165,165,165,116,116,9,5,0,9,5,5,"win_A",3,-2,0,0,0,0,0,0,1,0.357142857142857,0.555555555555556,0.357142857142857,0,"southpaw"
"10032",25,26,163,175,165,193,118,119,6,4,0,7,3,1,"win_A",-1,-12,-28,-1,0,0,0,0,1,0.363636363636364,0.5,0.0909090909090909,0,"southpaw"
"10135",30,34,171,174,168,177,129,129,20,19,0,2,14,9,"win_A",-4,-3,-9,0,0,0,0,0,1,0.904761904761905,0.7,0.428571428571429,0,"southpaw"
"10196",25,25,170,180,170,183,138,139,15,13,0,6,7,5,"win_B",0,-10,-13,-1,0,0,0,0,1,0.684210526315789,0.466666666666667,0.263157894736842,1,"orthodox"
"10203",22,29,170,173,170,170,134,134,8,19,0,7,2,11,"win_A",-7,-3,0,0,0,0,0,0,1,0.730769230769231,0.25,0.423076923076923,0,"orthodox"
"10210",20,29,170,175,170,165,135,137,1,1,0,5,0,0,"win_A",-9,-5,5,-2,0,0,0,0,1,0.166666666666667,0,0,0,"orthodox"
"10214",27,28,174,174,175,180,147,147,26,29,2,3,14,19,"win_B",-1,0,-5,0,0,0,0,0,0.928571428571429,0.90625,0.5,0.59375,1,"southpaw"
"10223",22,29,174,170,175,175,140,141,17,19,0,3,10,5,"win_A",-7,4,0,-1,0,0,0,0,1,0.863636363636364,0.588235294117647,0.227272727272727,0,"southpaw"
"10224",21,32,174,175,175,178,139,139,16,16,0,5,9,9,"win_A",-11,-1,-3,0,0,0,0,0,1,0.761904761904762,0.5625,0.428571428571429,0,"southpaw"
"10230",20,23,174,180,175,188,141,143,10,8,0,2,5,6,"win_A",-3,-6,-13,-2,0,0,0,0,1,0.8,0.5,0.6,0,"southpaw"
"10232",19,22,174,170,175,173,144,144,8,8,0,3,3,6,"win_A",-3,4,2,0,0,0,0,0,1,0.727272727272727,0.375,0.545454545454545,0,"southpaw"
"10264",33,34,185,188,194,193,175,176,33,23,4,4,18,17,"win_A",-1,-3,1,-1,0,0,0,0,0.891891891891892,0.851851851851852,0.486486486486487,0.62962962962963,0,"southpaw"
"10265",33,28,185,180,194,193,174,177,32,12,4,8,18,6,"win_A",5,5,1,-3,0,0,0,0,0.888888888888889,0.6,0.5,0.3,0,"southpaw"
"10266",32,28,185,182,194,185,173,173,32,23,3,4,18,14,"win_B",4,3,9,0,0,0,0,0,0.914285714285714,0.851851851851852,0.514285714285714,0.518518518518518,1,"southpaw"
"10268",28,30,183,185,180,194,168,168,25,31,0,1,13,17,"win_A",-2,-2,-14,0,0,0,0,0,1,0.96875,0.52,0.53125,0,"orthodox"
"10273",26,40,185,188,194,191,175,175,27,27,0,5,17,19,"win_A",-14,-3,3,0,0,1,0,0,1,0.84375,0.62962962962963,0.59375,0,"southpaw"
"10274",26,39,185,188,194,191,174,174,26,27,0,4,17,19,"win_A",-13,-3,3,0,0,1,0,0,1,0.870967741935484,0.653846153846154,0.612903225806452,0,"southpaw"
"10278",30,24,187,185,191,194,175,174,31,22,0,0,21,15,"win_B",6,2,-3,1,0,0,0,0,1,1,0.67741935483871,0.681818181818182,1,"orthodox"
"10279",23,33,185,185,194,196,175,174,21,23,0,3,15,7,"win_A",-10,0,-2,1,0,0,0,0,1,0.884615384615385,0.714285714285714,0.269230769230769,0,"southpaw"
"10285",22,34,185,175,194,183,160,160,15,49,0,4,10,31,"win_A",-12,10,11,0,0,0,0,0,1,0.924528301886792,0.666666666666667,0.584905660377358,0,"southpaw"
"10289",20,34,185,178,194,191,162,163,11,12,0,15,7,1,"win_A",-14,7,3,-1,0,0,0,0,1,0.444444444444444,0.636363636363636,0.037037037037037,0,"southpaw"
"10309",24,26,165,174,177,178,114,114,22,21,0,4,12,19,"win_A",-2,-9,-1,0,0,0,0,0,1,0.84,0.545454545454545,0.76,0,"orthodox"
"10310",24,22,165,163,177,173,115,113,21,18,0,0,12,14,"win_A",2,2,4,2,0,0,0,0,1,1,0.571428571428571,0.777777777777778,0,"orthodox"
"10426",31,35,186,188,191,192,199,196,46,21,2,1,33,13,"win_A",-4,-2,-1,3,0,1,0,0,0.958333333333333,0.954545454545455,0.6875,0.590909090909091,0,"orthodox"
"10435",26,24,186,193,191,188,197,197,37,16,2,3,27,8,"win_A",2,-7,3,0,0,0,0,0,0.948717948717949,0.842105263157895,0.692307692307692,0.421052631578947,0,"orthodox"
"10494",28,31,192,168,191,188,179,178,15,23,0,18,12,15,"win_A",-3,24,3,1,0,0,0,0,1,0.560975609756098,0.8,0.365853658536585,0,"orthodox"
"10498",27,32,192,173,191,184,177,178,11,13,0,8,9,7,"win_A",-5,19,7,-1,0,0,0,0,1,0.619047619047619,0.818181818181818,0.333333333333333,0,"orthodox"
"10544",29,27,173,168,170,178,126,126,23,18,1,1,19,8,"win_A",2,5,-8,0,0,0,0,0,0.958333333333333,0.947368421052632,0.791666666666667,0.421052631578947,0,"orthodox"
"10558",19,25,170,173,170,170,124,125,11,10,2,0,10,9,"win_B",-6,-3,0,-1,0,0,0,0,0.846153846153846,1,0.769230769230769,0.9,1,"Unknown"
"10572",32,31,170,171,168,165,126,126,29,30,2,4,20,13,"win_A",1,-1,3,0,0,0,0,0,0.935483870967742,0.882352941176471,0.645161290322581,0.382352941176471,0,"orthodox"
"10587",29,26,164,170,165,168,122,122,39,16,1,0,28,12,"win_A",3,-6,-3,0,0,0,0,0,0.975,1,0.7,0.75,0,"orthodox"
"10686",38,29,173,182,178,182,158,157,39,21,4,9,22,13,"win_B",9,-9,-4,1,1,0,0,0,0.906976744186046,0.7,0.511627906976744,0.433333333333333,1,"orthodox"
"10690",25,34,182,183,182,203,153,152,17,13,5,6,10,9,"win_A",-9,-1,-21,1,0,0,0,0,0.772727272727273,0.684210526315789,0.454545454545455,0.473684210526316,0,"orthodox"
"10691",25,25,182,175,182,180,155,154,16,20,5,3,9,12,"win_A",0,7,2,1,0,0,0,0,0.761904761904762,0.869565217391304,0.428571428571429,0.521739130434783,0,"orthodox"
"10692",29,25,175,182,180,182,154,154,12,15,7,5,6,8,"win_B",4,-7,-2,0,0,0,0,0,0.631578947368421,0.75,0.315789473684211,0.4,1,"orthodox"
"10694",29,24,173,182,175,182,160,159,21,14,2,4,13,8,"win_A",5,-9,-7,1,0,0,0,0,0.91304347826087,0.777777777777778,0.565217391304348,0.444444444444444,0,"orthodox"
"10697",26,23,177,182,175,182,154,155,15,12,1,3,12,7,"win_A",3,-5,-7,-1,0,0,0,0,0.9375,0.8,0.75,0.466666666666667,0,"orthodox"
"10786",27,22,165,165,170,165,120,123,9,12,0,3,3,7,"win_A",5,0,5,-3,0,0,0,0,1,0.8,0.333333333333333,0.466666666666667,0,"orthodox"
"10903",28,33,175,173,180,177,146,149,18,19,0,6,16,12,"win_A",-5,2,3,-3,0,0,0,0,1,0.76,0.888888888888889,0.48,0,"orthodox"
"10984",25,44,168,170,173,175,116,116,24,26,8,14,12,12,"win_A",-19,-2,-2,0,0,1,0,0,0.75,0.65,0.375,0.3,0,"orthodox"
"10995",22,23,168,164,173,165,115,115,13,15,8,1,8,10,"win_A",-1,4,8,0,0,0,0,0,0.619047619047619,0.9375,0.380952380952381,0.625,0,"orthodox"
"11009",24,20,165,168,164,173,115,113,5,1,7,6,3,0,"win_A",4,-3,-9,2,0,0,0,0,0.416666666666667,0.142857142857143,0.25,0,0,"Unknown"
"11035",36,39,187,189,204,193,247,236,33,17,3,4,25,14,"win_A",-3,-2,11,11,1,1,0,0,0.916666666666667,0.80952380952381,0.694444444444444,0.666666666666667,0,"orthodox"
"11039",33,42,187,196,204,207,257,270,29,39,1,4,23,26,"win_A",-9,-9,-3,-13,0,1,0,0,0.966666666666667,0.906976744186046,0.766666666666667,0.604651162790698,0,"orthodox"
"11198",33,32,178,178,183,180,155,157,33,20,3,3,22,13,"win_A",1,0,3,-2,0,0,0,0,0.916666666666667,0.869565217391304,0.611111111111111,0.565217391304348,0,"orthodox"
"11201",31,25,178,173,183,183,154,154,30,21,3,3,21,12,"win_A",6,5,0,0,0,0,0,0,0.909090909090909,0.875,0.636363636363636,0.5,0,"orthodox"
"11217",26,24,179,178,183,183,150,149,17,15,3,1,10,11,"win_A",2,1,0,1,0,0,0,0,0.85,0.9375,0.5,0.6875,0,"orthodox"
"11242",27,27,183,180,193,185,166,165,21,13,0,0,14,12,"win_A",0,3,8,1,0,0,0,0,1,1,0.666666666666667,0.923076923076923,0,"orthodox"
"11243",26,27,183,183,193,178,166,166,20,22,0,1,14,19,"win_A",-1,0,15,0,0,0,0,0,1,0.956521739130435,0.7,0.826086956521739,0,"orthodox"
"11244",26,26,183,178,193,178,171,171,19,14,0,0,14,8,"win_A",0,5,15,0,0,0,0,0,1,1,0.736842105263158,0.571428571428571,0,"orthodox"
"11252",24,29,183,171,193,184,165,160,11,16,0,12,8,6,"win_A",-5,12,9,5,0,0,0,0,1,0.571428571428571,0.727272727272727,0.214285714285714,0,"orthodox"
"11254",23,36,183,175,193,188,163,164,9,15,0,13,6,5,"win_A",-13,8,5,-1,0,1,0,0,1,0.535714285714286,0.666666666666667,0.178571428571429,0,"orthodox"
"11290",23,34,170,163,173,163,122,124,20,29,2,7,15,20,"win_A",-11,7,10,-2,0,0,0,0,0.909090909090909,0.805555555555556,0.681818181818182,0.555555555555556,0,"orthodox"
"11291",22,26,170,165,173,168,120,121,19,23,2,0,15,15,"win_A",-4,5,5,-1,0,0,0,0,0.904761904761905,1,0.714285714285714,0.652173913043478,0,"orthodox"
"11293",21,30,170,169,173,169,120,120,18,11,1,0,15,5,"win_A",-9,1,4,0,0,0,0,0,0.947368421052632,1,0.789473684210526,0.454545454545455,0,"orthodox"
"11294",21,32,170,157,173,163,121,121,17,25,1,15,14,15,"win_A",-11,13,10,0,0,0,0,0,0.944444444444444,0.625,0.777777777777778,0.375,0,"orthodox"
"11296",20,24,170,170,173,168,118,120,16,18,0,0,13,5,"win_B",-4,0,5,-2,0,0,0,0,1,1,0.8125,0.277777777777778,1,"orthodox"
"11298",20,29,170,167,173,168,118,119,14,17,0,1,11,8,"win_A",-9,3,5,-1,0,0,0,0,1,0.944444444444444,0.785714285714286,0.444444444444444,0,"orthodox"
"11301",19,26,170,182,173,178,118,118,11,13,0,7,9,11,"win_A",-7,-12,-5,0,0,0,0,0,1,0.65,0.818181818181818,0.55,0,"orthodox"
"11302",19,26,170,163,173,178,117,117,10,11,0,2,8,9,"win_A",-7,7,-5,0,0,0,0,0,1,0.846153846153846,0.8,0.692307692307692,0,"orthodox"
"11310",18,26,170,165,173,165,118,118,2,6,0,3,2,3,"win_A",-8,5,8,0,0,0,0,0,1,0.666666666666667,1,0.333333333333333,0,"orthodox"
"11396",24,26,173,175,170,177,140,140,16,11,0,0,10,5,"win_A",-2,-2,-7,0,0,0,0,0,1,1,0.625,0.454545454545455,0,"orthodox"
"11400",23,28,173,173,170,188,143,143,12,9,0,0,9,6,"win_A",-5,0,-18,0,0,0,0,0,1,1,0.75,0.666666666666667,0,"orthodox"
"11419",22,23,170,173,168,183,122,122,15,16,0,3,6,9,"win_A",-1,-3,-15,0,0,0,0,0,1,0.842105263157895,0.4,0.473684210526316,0,"orthodox"
"11428",19,21,170,165,168,178,118,120,6,2,0,1,2,0,"win_A",-2,5,-10,-2,0,0,0,0,1,0.666666666666667,0.333333333333333,0,0,"orthodox"
"11430",19,27,170,163,168,168,123,124,4,1,0,1,2,0,"win_A",-8,7,0,-1,0,0,0,0,1,0.5,0.5,0,0,"orthodox"
"11433",18,18,170,165,168,170,121,119,1,0,0,2,0,0,"win_A",0,5,-2,2,0,0,0,0,1,0,0,0,0,"orthodox"
"11452",26,25,169,168,173,183,136,136,25,30,1,6,17,18,"win_A",1,1,-10,0,0,0,0,0,0.961538461538462,0.833333333333333,0.653846153846154,0.5,0,"orthodox"
"11453",25,23,169,175,173,180,136,137,24,29,1,4,16,16,"win_A",2,-6,-7,-1,0,0,0,0,0.96,0.878787878787879,0.64,0.484848484848485,0,"orthodox"
"11458",22,27,169,178,173,175,135,135,20,16,0,0,12,13,"win_A",-5,-9,-2,0,0,0,0,0,1,1,0.6,0.8125,0,"orthodox"
"11460",22,34,169,175,173,178,137,137,17,19,0,10,11,12,"win_A",-12,-6,-5,0,0,0,0,0,1,0.655172413793103,0.647058823529412,0.413793103448276,0,"orthodox"
"11467",20,30,169,170,173,185,137,136,10,10,0,5,6,9,"win_A",-10,-1,-12,1,0,0,0,0,1,0.666666666666667,0.6,0.6,0,"orthodox"
"11470",20,21,169,178,173,178,136,135,7,5,0,0,4,1,"win_A",-1,-9,-5,1,0,0,0,0,1,1,0.571428571428571,0.2,0,"orthodox"
"11483",31,37,187,182,183,188,168,166,28,29,0,0,23,16,"win_A",-6,5,-5,2,0,1,0,0,1,1,0.821428571428571,0.551724137931034,0,"southpaw"
"11547",27,28,178,182,183,180,154,156,14,18,0,4,8,14,"win_A",-1,-4,3,-2,0,0,0,0,1,0.818181818181818,0.571428571428571,0.636363636363636,0,"orthodox"
"11562",36,28,172,175,171,178,122,122,30,21,9,4,9,12,"win_A",8,-3,-7,0,1,0,0,0,0.769230769230769,0.84,0.230769230769231,0.48,0,"orthodox"
"11583",23,26,171,172,179,171,118,118,11,10,2,3,5,2,"win_A",-3,-1,8,0,0,0,0,0,0.846153846153846,0.769230769230769,0.384615384615385,0.153846153846154,0,"orthodox"
"11966",27,30,179,173,182,180,135,135,29,23,2,1,22,15,"win_A",-3,6,2,0,0,0,0,0,0.935483870967742,0.958333333333333,0.709677419354839,0.625,0,"orthodox"
"12078",30,30,163,170,170,165,128,125,22,14,3,7,15,12,"win_A",0,-7,5,3,0,0,0,0,0.88,0.666666666666667,0.6,0.571428571428571,0,"orthodox"
"12080",28,32,163,163,170,163,122,122,21,29,2,4,14,20,"win_A",-4,0,7,0,0,0,0,0,0.91304347826087,0.878787878787879,0.608695652173913,0.606060606060606,0,"orthodox"
"12082",27,32,163,157,170,163,122,121,19,25,2,16,12,15,"win_A",-5,6,7,1,0,0,0,0,0.904761904761905,0.609756097560976,0.571428571428571,0.365853658536585,0,"orthodox"
"12091",23,32,163,168,170,168,123,122,12,35,0,29,7,18,"win_B",-9,-5,2,1,0,0,0,0,1,0.546875,0.583333333333333,0.28125,1,"orthodox"
"12092",23,35,163,165,170,173,121,122,11,51,0,7,6,30,"win_A",-12,-2,-3,-1,0,1,0,0,1,0.879310344827586,0.545454545454545,0.517241379310345,0,"orthodox"
"12095",22,31,163,170,170,170,122,121,8,5,0,1,5,2,"win_A",-9,-7,0,1,0,0,0,0,1,0.833333333333333,0.625,0.333333333333333,0,"orthodox"
"12096",22,32,163,163,170,173,122,122,7,8,0,15,4,1,"win_A",-10,0,-3,0,0,0,0,0,1,0.347826086956522,0.571428571428571,0.0434782608695652,0,"orthodox"
"12114",27,35,175,180,178,188,151,150,17,12,4,4,5,9,"win_A",-8,-5,-10,1,0,1,0,0,0.80952380952381,0.75,0.238095238095238,0.5625,0,"orthodox"
"12116",25,24,175,178,178,188,147,147,15,21,4,2,5,13,"win_A",1,-3,-10,0,0,0,0,0,0.789473684210526,0.91304347826087,0.263157894736842,0.565217391304348,0,"orthodox"
"12119",25,35,175,180,178,183,146,145,12,48,4,44,4,39,"win_A",-10,-5,-5,1,0,1,0,0,0.75,0.521739130434783,0.25,0.423913043478261,0,"orthodox"
"12124",26,23,175,175,177,178,143,143,15,8,0,3,10,4,"win_A",3,0,-1,0,0,0,0,0,1,0.727272727272727,0.666666666666667,0.363636363636364,0,"orthodox"
"12131",18,21,178,175,183,178,154,154,2,3,0,0,1,1,"win_A",-3,3,5,0,0,0,0,0,1,1,0.5,0.333333333333333,0,"orthodox"
"12143",24,21,160,157,185,159,105,104,8,10,3,1,4,5,"win_A",3,3,26,1,0,0,0,0,0.727272727272727,0.909090909090909,0.363636363636364,0.454545454545455,0,"orthodox"
"12226",22,24,175,173,178,175,159,158,14,11,0,3,9,10,"win_A",-2,2,3,1,0,0,0,0,1,0.785714285714286,0.642857142857143,0.714285714285714,0,"Unknown"
"12247",28,35,175,178,175,188,153,148,16,26,0,5,6,15,"win_A",-7,-3,-13,5,0,1,0,0,1,0.838709677419355,0.375,0.483870967741935,0,"orthodox"
"12301",27,29,180,175,185,175,128,130,12,14,0,3,6,8,"win_A",-2,5,10,-2,0,0,0,0,1,0.823529411764706,0.5,0.470588235294118,0,"southpaw"
"12302",27,22,180,171,185,175,130,127,11,5,0,4,6,0,"win_A",5,9,10,3,0,0,0,0,1,0.555555555555556,0.545454545454545,0,0,"southpaw"
"12305",26,27,180,165,185,175,123,123,8,16,0,12,4,7,"win_A",-1,15,10,0,0,0,0,0,1,0.571428571428571,0.5,0.25,0,"southpaw"
"12321",24,32,193,180,198,183,167,168,19,16,0,1,13,11,"win_A",-8,13,15,-1,0,0,0,0,1,0.941176470588235,0.684210526315789,0.647058823529412,0,"southpaw"
"12323",23,29,193,178,198,177,168,167,17,14,0,1,12,7,"win_A",-6,15,21,1,0,0,0,0,1,0.933333333333333,0.705882352941177,0.466666666666667,0,"southpaw"
"12370",21,23,170,170,175,183,135,134,14,5,0,12,10,4,"win_A",-2,0,-8,1,0,0,0,0,1,0.294117647058824,0.714285714285714,0.235294117647059,0,"orthodox"
"12393",29,29,170,170,175,173,137,139,18,14,0,17,10,8,"win_A",0,0,2,-2,0,0,0,0,1,0.451612903225806,0.555555555555556,0.258064516129032,0,"orthodox"
"12395",28,33,170,170,175,170,135,135,16,26,0,11,9,9,"win_A",-5,0,5,0,0,0,0,0,1,0.702702702702703,0.5625,0.243243243243243,0,"orthodox"
"12422",25,28,165,163,170,160,122,123,20,16,1,0,11,9,"win_A",-3,2,10,-1,0,0,0,0,0.952380952380952,1,0.523809523809524,0.5625,0,"orthodox"
"12427",22,36,165,165,170,175,123,122,15,30,0,7,9,21,"win_A",-14,0,-5,1,0,1,0,0,1,0.810810810810811,0.6,0.567567567567568,0,"orthodox"
"12438",21,20,165,161,170,168,121,120,4,6,0,0,3,4,"win_A",1,4,2,1,0,0,0,0,1,1,0.75,0.666666666666667,0,"orthodox"
"12445",24,28,183,178,183,183,160,162,10,23,0,3,9,13,"win_A",-4,5,0,-2,0,0,0,0,1,0.884615384615385,0.9,0.5,0,"orthodox"
"12598",21,34,179,166,178,173,130,130,15,39,0,4,8,21,"win_A",-13,13,5,0,0,0,0,0,1,0.906976744186046,0.533333333333333,0.488372093023256,0,"Unknown"
"12601",20,25,179,170,178,163,130,130,12,15,0,2,7,11,"win_A",-5,9,15,0,0,0,0,0,1,0.882352941176471,0.583333333333333,0.647058823529412,0,"Unknown"
"12610",18,22,179,165,178,170,123,123,3,1,0,2,1,0,"win_A",-4,14,8,0,0,0,0,0,1,0.333333333333333,0.333333333333333,0,0,"Unknown"
"12652",28,28,170,168,182,188,159,161,23,20,3,9,17,13,"win_A",0,2,-6,-2,0,0,0,0,0.884615384615385,0.689655172413793,0.653846153846154,0.448275862068966,0,"orthodox"
"12653",27,32,170,180,182,187,159,159,22,26,3,5,16,12,"win_A",-5,-10,-5,0,0,0,0,0,0.88,0.838709677419355,0.64,0.387096774193548,0,"orthodox"
"12654",27,37,170,180,182,190,162,160,21,11,3,5,15,6,"win_A",-10,-10,-8,2,0,1,0,0,0.875,0.6875,0.625,0.375,0,"orthodox"
"12661",21,33,170,175,182,183,172,172,15,47,1,15,11,26,"win_A",-12,-5,-1,0,0,0,0,0,0.9375,0.758064516129032,0.6875,0.419354838709677,0,"orthodox"
"12710",31,31,183,183,180,183,167,167,24,19,2,7,15,9,"win_A",0,0,-3,0,0,0,0,0,0.923076923076923,0.730769230769231,0.576923076923077,0.346153846153846,0,"orthodox"
"12711",31,35,183,180,180,185,166,168,23,26,2,11,14,16,"win_A",-4,3,-5,-2,0,1,0,0,0.92,0.702702702702703,0.56,0.432432432432432,0,"orthodox"
"12722",30,28,178,183,187,180,159,160,14,14,1,0,10,10,"win_A",2,-5,7,-1,0,0,0,0,0.933333333333333,1,0.666666666666667,0.714285714285714,0,"orthodox"
"12730",26,36,183,175,180,193,168,166,6,10,0,26,5,2,"win_A",-10,8,-13,2,0,1,0,0,1,0.277777777777778,0.833333333333333,0.0555555555555556,0,"orthodox"
"12755",28,27,182,191,178,188,153,153,34,23,1,1,21,13,"win_A",1,-9,-10,0,0,0,0,0,0.971428571428571,0.958333333333333,0.6,0.541666666666667,0,"orthodox"
"12758",26,29,191,178,188,178,153,153,20,32,1,2,12,16,"win_A",-3,13,10,0,0,0,0,0,0.952380952380952,0.941176470588235,0.571428571428571,0.470588235294118,0,"orthodox"
"12759",25,26,191,183,188,183,152,154,19,26,1,3,11,19,"win_A",-1,8,5,-2,0,0,0,0,0.95,0.896551724137931,0.55,0.655172413793103,0,"orthodox"
"12766",23,27,191,175,188,170,148,149,13,15,0,9,8,9,"win_A",-4,16,18,-1,0,0,0,0,1,0.625,0.615384615384615,0.375,0,"orthodox"
"12769",21,35,191,170,188,178,145,143,10,9,0,27,6,4,"win_A",-14,21,10,2,0,1,0,0,1,0.25,0.6,0.111111111111111,0,"orthodox"
"12875",22,26,168,170,184,170,127,127,14,6,0,2,9,4,"win_A",-4,-2,14,0,0,0,0,0,1,0.75,0.642857142857143,0.5,0,"southpaw"
"12876",24,22,165,168,165,184,127,126,9,13,2,0,4,9,"win_B",2,-3,-19,1,0,0,0,0,0.818181818181818,1,0.363636363636364,0.692307692307692,1,"Unknown"
"12880",21,33,168,170,184,173,127,128,9,19,0,12,6,12,"win_A",-12,-2,11,-1,0,0,0,0,1,0.612903225806452,0.666666666666667,0.387096774193548,0,"southpaw"
"12891",26,27,170,164,173,165,118,119,22,18,2,8,18,4,"win_A",-1,6,8,-1,0,0,0,0,0.916666666666667,0.692307692307692,0.75,0.153846153846154,0,"orthodox"
"12892",25,25,170,170,173,173,115,114,14,21,0,2,1,18,"win_B",0,0,0,1,0,0,0,0,1,0.91304347826087,0.0714285714285714,0.782608695652174,1,"orthodox"
"12893",25,26,170,158,173,165,114,114,20,21,2,6,17,12,"win_A",-1,12,8,0,0,0,0,0,0.909090909090909,0.777777777777778,0.772727272727273,0.444444444444444,0,"orthodox"
"12895",24,25,170,158,173,165,114,114,19,20,1,5,17,12,"win_A",-1,12,8,0,0,0,0,0,0.95,0.8,0.85,0.48,0,"orthodox"
"12920",30,29,169,171,178,179,130,130,28,39,2,3,21,23,"win_A",1,-2,-1,0,0,0,0,0,0.933333333333333,0.928571428571429,0.7,0.547619047619048,0,"southpaw"
"12923",28,29,171,175,179,177,131,131,36,26,3,7,21,21,"win_A",-1,-4,2,0,0,0,0,0,0.923076923076923,0.787878787878788,0.538461538461538,0.636363636363636,0,"orthodox"
"12925",27,33,171,165,179,173,127,124,35,25,2,3,21,8,"win_A",-6,6,6,3,0,0,0,0,0.945945945945946,0.892857142857143,0.567567567567568,0.285714285714286,0,"orthodox"
"12926",27,26,171,171,179,170,125,125,35,15,1,0,21,8,"win_B",1,0,9,0,0,0,0,0,0.972222222222222,1,0.583333333333333,0.533333333333333,1,"orthodox"
"12928",26,28,171,170,179,168,126,126,33,32,1,3,20,23,"win_A",-2,1,11,0,0,0,0,0,0.970588235294118,0.914285714285714,0.588235294117647,0.657142857142857,0,"orthodox"
"12941",27,23,170,171,175,179,126,126,35,21,1,0,15,11,"win_A",4,-1,-4,0,0,0,0,0,0.972222222222222,1,0.416666666666667,0.523809523809524,0,"southpaw"
"12948",21,30,171,168,179,173,129,129,14,20,0,12,9,13,"win_A",-9,3,6,0,0,0,0,0,1,0.625,0.642857142857143,0.40625,0,"orthodox"
"12971",30,34,187,191,188,208,238,240,19,29,4,4,13,14,"win_A",-4,-4,-20,-2,0,0,0,0,0.826086956521739,0.878787878787879,0.565217391304348,0.424242424242424,0,"orthodox"
"12974",29,32,187,193,188,206,242,232,16,35,4,0,10,12,"win_A",-3,-6,-18,10,0,0,0,0,0.8,1,0.5,0.342857142857143,0,"orthodox"
"12981",36,26,191,187,201,188,244,273,41,12,8,0,31,7,"win_B",10,4,13,-29,1,0,0,1,0.836734693877551,1,0.63265306122449,0.583333333333333,1,"orthodox"
"12986",24,38,187,188,188,201,254,216,7,26,0,17,4,11,"win_A",-14,-1,-13,38,0,1,1,0,1,0.604651162790698,0.571428571428571,0.255813953488372,0,"orthodox"
"12989",24,23,187,188,188,180,255,236,4,7,0,0,1,2,"win_A",1,-1,8,19,0,0,1,0,1,1,0.25,0.285714285714286,0,"orthodox"
"13013",26,29,183,185,192,197,168,168,17,20,0,1,10,13,"win_A",-3,-2,-5,0,0,0,0,0,1,0.952380952380952,0.588235294117647,0.619047619047619,0,"orthodox"
"13019",24,35,183,175,192,175,162,158,11,11,0,9,7,4,"win_A",-11,8,17,4,0,1,0,0,1,0.55,0.636363636363636,0.2,0,"orthodox"
"13159",23,24,170,170,172,170,133,137,5,3,0,5,2,1,"win_A",-1,0,2,-4,0,0,0,0,1,0.375,0.4,0.125,0,"orthodox"
"13233",28,29,175,165,175,170,122,121,21,26,0,13,15,13,"win_A",-1,10,5,1,0,0,0,0,1,0.666666666666667,0.714285714285714,0.333333333333333,0,"orthodox"
"13307",36,38,187,191,191,198,221,243,48,34,2,9,29,23,"win_A",-2,-4,-7,-22,1,1,0,1,0.96,0.790697674418605,0.58,0.534883720930233,0,"orthodox"
"13308",35,33,187,194,191,208,222,235,46,39,2,7,28,31,"win_A",2,-7,-17,-13,1,0,0,0,0.958333333333333,0.847826086956522,0.583333333333333,0.673913043478261,0,"orthodox"
"13309",35,30,187,185,191,191,225,202,45,36,2,2,28,18,"win_A",5,2,0,23,1,0,1,0,0.957446808510638,0.947368421052632,0.595744680851064,0.473684210526316,0,"orthodox"
"13311",40,34,201,187,201,191,216,243,42,44,2,1,39,28,"win_A",6,14,10,-27,1,0,0,1,0.954545454545455,0.977777777777778,0.886363636363636,0.622222222222222,0,"orthodox"
"13312",34,37,187,198,191,203,215,285,43,35,1,8,28,29,"win_A",-3,-11,-12,-70,0,1,0,1,0.977272727272727,0.813953488372093,0.636363636363636,0.674418604651163,0,"orthodox"
"13314",33,38,187,201,191,218,217,261,41,46,1,3,27,34,"win_A",-5,-14,-27,-44,0,1,0,1,0.976190476190476,0.938775510204082,0.642857142857143,0.693877551020408,0,"orthodox"
"13319",32,26,187,191,191,193,199,200,36,20,1,0,24,14,"win_A",6,-4,-2,-1,0,0,0,0,0.972972972972973,1,0.648648648648649,0.7,0,"orthodox"
"13321",31,33,187,183,191,191,198,199,33,26,1,2,22,24,"win_A",-2,4,0,-1,0,0,0,0,0.970588235294118,0.928571428571429,0.647058823529412,0.857142857142857,0,"orthodox"
"13324",29,31,187,181,191,180,174,175,30,25,0,2,21,18,"win_A",-2,6,11,-1,0,0,0,0,1,0.925925925925926,0.7,0.666666666666667,0,"orthodox"
"13326",28,29,187,181,191,180,174,174,28,23,0,1,20,17,"win_A",-1,6,11,0,0,0,0,0,1,0.958333333333333,0.714285714285714,0.708333333333333,0,"orthodox"
"13358",24,25,175,175,175,185,155,156,15,7,3,4,8,4,"win_A",-1,0,-10,-1,0,0,0,0,0.833333333333333,0.636363636363636,0.444444444444444,0.363636363636364,0,"orthodox"
"13363",21,30,175,165,175,178,149,150,11,26,2,25,5,22,"win_A",-9,10,-3,-1,0,0,0,0,0.846153846153846,0.509803921568627,0.384615384615385,0.431372549019608,0,"orthodox"
"13365",25,21,183,175,185,175,147,146,15,9,1,2,12,3,"win_B",4,8,10,1,0,0,0,0,0.9375,0.818181818181818,0.75,0.272727272727273,1,"Unknown"
"13366",20,30,175,178,175,188,149,146,8,8,2,3,3,5,"win_A",-10,-3,-13,3,0,0,0,0,0.8,0.727272727272727,0.3,0.454545454545455,0,"orthodox"
"13369",19,31,175,170,175,175,146,146,5,32,2,26,2,20,"win_A",-12,5,0,0,0,0,0,0,0.714285714285714,0.551724137931034,0.285714285714286,0.344827586206897,0,"orthodox"
"13779",27,31,183,168,180,170,152,152,7,4,0,3,4,1,"win_A",-4,15,10,0,0,0,0,0,1,0.571428571428571,0.571428571428571,0.142857142857143,0,"orthodox"
"13818",29,23,177,178,194,183,158,158,22,12,2,3,21,4,"win_B",6,-1,11,0,0,0,0,0,0.916666666666667,0.8,0.875,0.266666666666667,1,"orthodox"
"13823",24,34,177,183,194,188,157,156,19,20,0,19,19,13,"win_A",-10,-6,6,1,0,0,0,0,1,0.512820512820513,1,0.333333333333333,0,"orthodox"
"14033",24,27,174,168,183,165,131,130,11,8,0,1,7,3,"win_A",-3,6,18,1,0,0,0,0,1,0.888888888888889,0.636363636363636,0.333333333333333,0,"orthodox"
"14035",23,24,174,178,183,178,130,130,9,8,0,3,5,3,"win_A",-1,-4,5,0,0,0,0,0,1,0.727272727272727,0.555555555555556,0.272727272727273,0,"orthodox"
"14038",22,34,174,168,183,170,131,134,6,8,0,6,2,2,"win_A",-12,6,13,-3,0,0,0,0,1,0.571428571428571,0.333333333333333,0.142857142857143,0,"orthodox"
"14039",22,21,174,170,183,175,131,129,5,3,0,4,2,2,"win_A",1,4,8,2,0,0,0,0,1,0.428571428571429,0.4,0.285714285714286,0,"orthodox"
"14040",22,21,174,165,183,170,134,134,4,3,0,6,2,2,"win_A",1,9,13,0,0,0,0,0,1,0.333333333333333,0.5,0.222222222222222,0,"orthodox"
"14041",22,32,174,173,183,175,134,134,3,0,0,2,2,0,"win_A",-10,1,8,0,0,0,0,0,1,0,0.666666666666667,0,0,"orthodox"
"14052",22,26,175,170,175,168,129,129,12,12,0,1,10,7,"win_A",-4,5,7,0,0,0,0,0,1,0.923076923076923,0.833333333333333,0.538461538461538,0,"orthodox"
"14073",25,34,188,173,202,179,211,211,2,2,0,0,2,1,"win_A",-9,15,23,0,0,0,0,0,1,1,1,0.5,0,"orthodox"
"14141",32,31,171,170,182,168,139,140,18,16,2,0,7,10,"win_B",1,1,14,-1,0,0,0,0,0.9,1,0.35,0.625,1,"orthodox"
"14142",31,31,175,171,177,182,140,140,32,18,0,1,23,7,"win_A",0,4,-5,0,0,0,0,0,1,0.947368421052632,0.71875,0.368421052631579,0,"orthodox"
"14145",26,30,168,171,168,182,140,140,17,15,0,1,11,7,"win_B",-4,-3,-14,0,0,0,0,0,1,0.9375,0.647058823529412,0.4375,1,"orthodox"
"14146",30,28,171,168,182,180,140,140,14,16,1,10,7,5,"win_A",2,3,2,0,0,0,0,0,0.933333333333333,0.615384615384615,0.466666666666667,0.192307692307692,0,"orthodox"
"14147",29,38,171,175,182,175,140,140,13,30,1,7,6,17,"win_A",-9,-4,7,0,0,1,0,0,0.928571428571429,0.810810810810811,0.428571428571429,0.459459459459459,0,"orthodox"
"14148",27,29,165,171,168,182,143,144,29,13,2,0,19,6,"win_A",-2,-6,-14,-1,0,0,0,0,0.935483870967742,1,0.612903225806452,0.461538461538462,0,"orthodox"
"14149",29,23,171,170,182,175,141,142,12,10,0,1,6,3,"win_A",6,1,7,-1,0,0,0,0,1,0.909090909090909,0.5,0.272727272727273,0,"orthodox"
"14254",23,25,173,175,175,176,139,140,12,16,1,1,10,11,"win_A",-2,-2,-1,-1,0,0,0,0,0.923076923076923,0.941176470588235,0.769230769230769,0.647058823529412,0,"orthodox"
"14296",34,32,188,191,196,193,248,247,22,34,1,2,20,30,"win_A",2,-3,3,1,0,0,0,0,0.956521739130435,0.944444444444444,0.869565217391304,0.833333333333333,0,"orthodox"
"14299",32,34,188,193,196,206,238,255,19,20,1,0,18,15,"win_A",-2,-5,-10,-17,0,0,0,1,0.95,1,0.9,0.75,0,"orthodox"
"14300",32,39,188,191,196,202,239,258,18,15,1,31,17,10,"win_A",-7,-3,-6,-19,0,1,0,1,0.947368421052632,0.326086956521739,0.894736842105263,0.217391304347826,0,"orthodox"
"14305",29,42,188,185,196,185,248,229,13,18,1,14,13,8,"win_A",-13,3,11,19,0,1,1,0,0.928571428571429,0.5625,0.928571428571429,0.25,0,"orthodox"
"14306",28,41,188,178,196,183,242,216,12,15,1,4,12,6,"win_A",-13,10,13,26,0,1,1,0,0.923076923076923,0.789473684210526,0.923076923076923,0.315789473684211,0,"orthodox"
"14307",28,22,188,180,196,188,245,270,12,11,0,15,12,9,"win_B",6,8,8,-25,0,0,0,1,1,0.423076923076923,1,0.346153846153846,1,"orthodox"
"14373",31,28,175,180,177,183,140,140,31,24,0,3,22,19,"win_A",3,-5,-6,0,0,0,0,0,1,0.888888888888889,0.709677419354839,0.703703703703704,0,"orthodox"
"14374",31,24,175,178,177,178,140,140,30,27,0,2,22,14,"win_A",7,-3,-1,0,0,0,0,0,1,0.931034482758621,0.733333333333333,0.482758620689655,0,"orthodox"
"14375",30,32,175,183,177,180,139,140,29,25,0,1,21,21,"win_A",-2,-8,-3,-1,0,0,0,0,1,0.961538461538462,0.724137931034483,0.807692307692308,0,"orthodox"
"14379",28,31,175,178,177,180,142,146,25,18,0,7,18,5,"win_A",-3,-3,-3,-4,0,0,0,0,1,0.72,0.72,0.2,0,"orthodox"
"14380",28,34,175,171,177,173,144,144,24,24,0,8,17,14,"win_A",-6,4,4,0,0,0,0,0,1,0.75,0.708333333333333,0.4375,0,"orthodox"
"14381",28,30,175,174,177,178,140,140,23,27,0,9,16,18,"win_A",-2,1,-1,0,0,0,0,0,1,0.75,0.695652173913043,0.5,0,"orthodox"
"14382",28,33,175,170,177,175,142,141,22,25,0,9,15,13,"win_A",-5,5,2,1,0,0,0,0,1,0.735294117647059,0.681818181818182,0.382352941176471,0,"orthodox"
"14383",27,33,175,180,177,191,142,141,21,48,0,10,14,31,"win_A",-6,-5,-14,1,0,0,0,0,1,0.827586206896552,0.666666666666667,0.53448275862069,0,"orthodox"
"14385",27,28,175,170,177,175,142,139,19,17,0,2,13,5,"win_A",-1,5,2,3,0,0,0,0,1,0.894736842105263,0.684210526315789,0.263157894736842,0,"orthodox"
"14388",26,35,175,173,177,180,143,140,16,21,0,9,10,12,"win_A",-9,2,-3,3,0,1,0,0,1,0.7,0.625,0.4,0,"orthodox"
"14392",25,23,175,178,177,180,142,141,11,6,0,8,9,2,"win_A",2,-3,-3,1,0,0,0,0,1,0.428571428571429,0.818181818181818,0.142857142857143,0,"orthodox"
"14393",25,26,175,178,177,183,143,144,10,8,0,3,9,4,"win_A",-1,-3,-6,-1,0,0,0,0,1,0.727272727272727,0.9,0.363636363636364,0,"orthodox"
"14408",22,31,168,165,173,170,118,117,18,12,0,2,10,5,"win_A",-9,3,3,1,0,0,0,0,1,0.857142857142857,0.555555555555556,0.357142857142857,0,"orthodox"
"14666",28,24,168,175,168,170,131,130,17,9,2,5,6,4,"win_A",4,-7,-2,1,0,0,0,0,0.894736842105263,0.642857142857143,0.315789473684211,0.285714285714286,0,"southpaw"
"14668",28,31,168,168,168,168,131,129,16,7,1,14,6,1,"win_A",-3,0,0,2,0,0,0,0,0.941176470588235,0.333333333333333,0.352941176470588,0.0476190476190476,0,"southpaw"
"14695",22,22,164,158,169,164,107,107,12,9,0,0,7,9,"win_B",0,6,5,0,0,0,0,0,1,1,0.583333333333333,1,1,"orthodox"
"14813",21,24,173,170,170,170,132,134,3,3,0,3,1,1,"win_A",-3,3,0,-2,0,0,0,0,1,0.5,0.333333333333333,0.166666666666667,0,"southpaw"
"14821",34,25,164,165,177,169,112,112,12,14,0,0,5,9,"win_A",9,-1,8,0,0,0,0,0,1,1,0.416666666666667,0.642857142857143,0,"orthodox"
"14822",34,27,164,160,177,166,112,112,11,33,0,6,5,19,"win_A",7,4,11,0,0,0,0,0,1,0.846153846153846,0.454545454545455,0.487179487179487,0,"orthodox"
"14876",27,36,170,170,170,180,147,146,11,12,0,11,9,8,"win_A",-9,0,-10,1,0,1,0,0,1,0.521739130434783,0.818181818181818,0.347826086956522,0,"orthodox"
"14885",25,23,170,175,170,180,148,150,2,2,0,0,1,1,"win_A",2,-5,-10,-2,0,0,0,0,1,1,0.5,0.5,0,"orthodox"
"15109",34,26,163,152,174,154,112,112,34,12,2,1,22,8,"win_A",8,11,20,0,0,0,0,0,0.944444444444444,0.923076923076923,0.611111111111111,0.615384615384615,0,"orthodox"
"15140",27,36,178,178,185,180,160,160,17,23,0,9,12,13,"win_A",-9,0,5,0,0,1,0,0,1,0.71875,0.705882352941177,0.40625,0,"southpaw"
"15149",25,32,178,178,185,188,157,156,8,5,0,4,5,4,"win_A",-7,0,-3,1,0,0,0,0,1,0.555555555555556,0.625,0.444444444444444,0,"southpaw"
"15156",24,31,178,180,185,191,161,162,1,2,0,0,1,1,"win_A",-7,-2,-6,-1,0,0,0,0,1,1,1,0.5,0,"southpaw"
"15272",24,21,180,180,191,185,176,176,1,2,0,0,1,2,"win_A",3,0,6,0,0,0,0,0,1,1,1,1,0,"orthodox"
"15336",24,28,180,171,188,183,148,148,7,11,0,3,6,4,"win_A",-4,9,5,0,0,0,0,0,1,0.785714285714286,0.857142857142857,0.285714285714286,0,"orthodox"
"15366",35,27,180,173,184,183,179,177,27,24,0,11,17,15,"win_A",8,7,1,2,1,0,0,0,1,0.685714285714286,0.62962962962963,0.428571428571429,0,"orthodox"
"15370",33,35,180,178,184,180,174,173,23,20,0,6,15,16,"win_A",-2,2,4,1,0,1,0,0,1,0.769230769230769,0.652173913043478,0.615384615384615,0,"orthodox"
"15373",32,29,180,178,184,173,175,173,20,15,0,6,13,6,"win_A",3,2,11,2,0,0,0,0,1,0.714285714285714,0.65,0.285714285714286,0,"orthodox"
"15379",30,34,180,180,184,182,176,174,14,14,0,9,9,11,"win_A",-4,0,2,2,0,0,0,0,1,0.608695652173913,0.642857142857143,0.478260869565217,0,"orthodox"
"15717",24,37,188,183,178,183,200,201,12,9,0,3,9,4,"win_A",-13,5,-5,-1,0,1,0,0,1,0.75,0.75,0.333333333333333,0,"southpaw"
"15730",23,24,175,173,183,173,147,147,17,13,0,2,12,6,"win_A",-1,2,10,0,0,0,0,0,1,0.866666666666667,0.705882352941177,0.4,0,"Unknown"
"15735",21,37,175,175,183,175,154,154,12,18,0,13,9,9,"win_A",-16,0,8,0,0,1,0,0,1,0.580645161290323,0.75,0.290322580645161,0,"Unknown"
"15810",26,32,180,173,184,184,199,193,15,13,1,7,10,7,"win_A",-6,7,0,6,0,0,0,0,0.9375,0.65,0.625,0.35,0,"southpaw"
"15812",31,25,185,180,191,184,199,196,36,13,3,1,18,10,"win_B",6,5,7,3,0,0,0,0,0.923076923076923,0.928571428571429,0.461538461538462,0.714285714285714,1,"orthodox"
"15830",33,31,161,160,170,168,112,112,48,29,7,2,29,25,"win_A",2,1,2,0,0,0,0,0,0.872727272727273,0.935483870967742,0.527272727272727,0.806451612903226,0,"orthodox"
"15831",33,31,161,160,170,165,112,111,47,35,7,2,28,22,"win_A",2,1,5,1,0,0,0,0,0.87037037037037,0.945945945945946,0.518518518518518,0.594594594594595,0,"orthodox"
"15834",32,28,161,155,170,160,112,112,44,33,7,6,27,18,"win_A",4,6,10,0,0,0,0,0,0.862745098039216,0.846153846153846,0.529411764705882,0.461538461538462,0,"orthodox"
"15836",34,32,162,161,161,170,112,112,82,43,3,6,43,26,"win_A",2,1,-9,0,0,0,0,0,0.964705882352941,0.877551020408163,0.505882352941176,0.530612244897959,0,"southpaw"
"15848",29,26,161,159,170,167,108,108,32,26,5,6,17,16,"win_A",3,2,3,0,0,0,0,0,0.864864864864865,0.8125,0.459459459459459,0.5,0,"orthodox"
"15851",28,28,161,168,170,168,108,108,29,26,5,6,15,20,"win_A",0,-7,2,0,0,0,0,0,0.852941176470588,0.8125,0.441176470588235,0.625,0,"orthodox"
"15857",26,28,161,159,170,161,108,108,22,26,5,13,12,15,"win_A",-2,2,9,0,0,0,0,0,0.814814814814815,0.666666666666667,0.444444444444444,0.384615384615385,0,"orthodox"
"15864",24,24,161,153,170,158,108,108,15,15,5,3,9,10,"win_A",0,8,12,0,0,0,0,0,0.75,0.833333333333333,0.45,0.555555555555556,0,"orthodox"
"15867",24,35,161,165,170,170,111,111,12,32,5,6,7,29,"win_A",-11,-4,0,0,0,1,0,0,0.705882352941177,0.842105263157895,0.411764705882353,0.763157894736842,0,"orthodox"
"15868",22,24,160,161,165,170,108,108,14,12,0,4,10,7,"win_A",-2,-1,-5,0,0,0,0,0,1,0.75,0.714285714285714,0.4375,0,"orthodox"
"15875",20,22,168,161,160,170,109,108,4,8,2,1,1,5,"win_A",-2,7,-10,1,0,0,0,0,0.666666666666667,0.888888888888889,0.166666666666667,0.555555555555556,0,"orthodox"
"15879",19,21,160,161,165,170,109,107,6,5,0,0,4,2,"win_A",-2,-1,-5,2,0,0,0,0,1,1,0.666666666666667,0.4,0,"orthodox"
"15933",30,33,175,180,178,183,148,147,16,29,2,7,12,21,"win_A",-3,-5,-5,1,0,0,0,0,0.888888888888889,0.805555555555556,0.666666666666667,0.583333333333333,0,"orthodox"
"15941",27,28,175,160,178,170,141,145,9,5,0,8,7,0,"win_A",-1,15,8,-4,0,0,0,0,1,0.384615384615385,0.777777777777778,0,0,"orthodox"
"15994",26,31,192,188,193,191,231,230,19,17,1,1,14,14,"win_A",-5,4,2,1,0,0,0,0,0.95,0.944444444444444,0.7,0.777777777777778,0,"southpaw"
"16051",22,23,178,178,185,183,144,143,7,10,0,1,3,9,"win_A",-1,0,2,1,0,0,0,0,1,0.909090909090909,0.428571428571429,0.818181818181818,0,"orthodox"
"16110",30,29,191,193,193,201,228,245,33,18,2,1,29,14,"win_A",1,-2,-8,-17,0,0,0,1,0.942857142857143,0.947368421052632,0.828571428571429,0.736842105263158,0,"orthodox"
"16178",28,31,168,172,172,164,143,143,34,19,2,1,24,14,"win_A",-3,-4,8,0,0,0,0,0,0.944444444444444,0.95,0.666666666666667,0.7,0,"orthodox"
"16191",22,29,168,168,172,174,135,138,22,22,0,6,15,14,"win_A",-7,0,-2,-3,0,0,0,0,1,0.785714285714286,0.681818181818182,0.5,0,"orthodox"
"16248",31,41,182,185,185,191,200,222,27,29,6,29,16,16,"win_A",-10,-3,-6,-22,0,1,0,1,0.818181818181818,0.5,0.484848484848485,0.275862068965517,0,"southpaw"
"16282",24,37,173,163,174,168,127,124,14,36,1,28,11,28,"win_A",-13,10,6,3,0,1,0,0,0.933333333333333,0.5625,0.733333333333333,0.4375,0,"southpaw"
"16283",24,26,173,168,174,173,126,126,14,22,0,1,11,18,"win_B",-2,5,1,0,0,0,0,0,1,0.956521739130435,0.785714285714286,0.782608695652174,1,"southpaw"
"16338",27,36,175,185,183,208,160,161,12,10,0,26,9,7,"win_A",-9,-10,-25,-1,0,1,0,0,1,0.277777777777778,0.75,0.194444444444444,0,"orthodox"
"16341",26,33,175,175,183,177,160,165,9,2,0,5,6,1,"win_A",-7,0,6,-5,0,0,0,0,1,0.285714285714286,0.666666666666667,0.142857142857143,0,"orthodox"
"16402",19,22,168,165,173,178,121,120,4,2,0,4,1,0,"win_A",-3,3,-5,1,0,0,0,0,1,0.333333333333333,0.25,0,0,"orthodox"
"16412",29,31,178,178,187,165,159,157,13,15,0,0,10,7,"win_A",-2,0,22,2,0,0,0,0,1,1,0.769230769230769,0.466666666666667,0,"orthodox"
"16420",28,31,178,178,187,193,160,159,5,3,0,18,5,3,"win_A",-3,0,-6,1,0,0,0,0,1,0.142857142857143,1,0.142857142857143,0,"orthodox"
"16422",26,38,178,178,187,178,164,168,3,5,0,9,3,1,"win_A",-12,0,9,-4,0,1,0,0,1,0.357142857142857,1,0.0714285714285714,0,"orthodox"
"16433",24,25,168,168,164,169,115,115,28,19,3,4,18,12,"win_A",-1,0,-5,0,0,0,0,0,0.903225806451613,0.826086956521739,0.580645161290323,0.521739130434783,0,"orthodox"
"16440",28,22,163,168,173,169,115,115,27,14,1,2,16,9,"win_A",6,-5,4,0,0,0,0,0,0.964285714285714,0.875,0.571428571428571,0.5625,0,"orthodox"
"16442",34,22,166,168,164,169,114,115,33,13,2,1,27,9,"win_A",12,-2,-5,-1,0,0,0,0,0.942857142857143,0.928571428571429,0.771428571428571,0.642857142857143,0,"southpaw"
"16444",31,21,166,168,170,169,116,116,35,11,4,1,26,8,"win_B",10,-2,1,0,0,0,0,0,0.897435897435897,0.916666666666667,0.666666666666667,0.666666666666667,1,"orthodox"
"16502",26,27,168,165,170,168,132,132,20,24,0,12,5,16,"win_A",-1,3,2,0,0,0,0,0,1,0.666666666666667,0.25,0.444444444444444,0,"orthodox"
"16513",20,35,168,170,170,173,128,128,9,19,0,12,4,4,"win_A",-15,-2,-3,0,0,1,0,0,1,0.612903225806452,0.444444444444444,0.129032258064516,0,"orthodox"
"16516",19,23,168,170,170,163,125,125,6,3,0,1,3,0,"win_A",-4,-2,7,0,0,0,0,0,1,0.75,0.5,0,0,"orthodox"
"16596",36,32,198,202,206,208,251,247,58,27,3,0,50,15,"win_A",4,-4,-2,4,1,0,0,0,0.950819672131147,1,0.819672131147541,0.555555555555556,0,"orthodox"
"16597",32,37,202,203,208,208,247,256,26,49,0,4,14,44,"win_A",-5,-1,0,-9,0,1,0,0,1,0.924528301886792,0.538461538461538,0.830188679245283,0,"orthodox"
"16598",31,34,202,188,208,193,248,248,25,21,0,8,13,10,"win_A",-3,14,15,0,0,0,0,0,1,0.724137931034483,0.52,0.344827586206897,0,"orthodox"
"16601",30,29,202,183,208,188,259,260,22,34,0,14,10,21,"win_A",1,19,20,-1,0,0,0,0,1,0.708333333333333,0.454545454545455,0.4375,0,"orthodox"
"16663",24,31,173,175,180,189,140,140,20,15,1,1,10,7,"win_A",-7,-2,-9,0,0,0,0,0,0.952380952380952,0.9375,0.476190476190476,0.4375,0,"orthodox"
"16670",21,26,173,175,180,188,135,136,13,6,0,2,7,3,"win_A",-5,-2,-8,-1,0,0,0,0,1,0.75,0.538461538461538,0.375,0,"orthodox"
"16671",21,24,173,168,180,169,136,133,12,24,0,4,6,14,"win_A",-3,5,11,3,0,0,0,0,1,0.857142857142857,0.5,0.5,0,"orthodox"
"16672",21,22,173,178,180,178,136,135,11,6,0,3,5,2,"win_A",-1,-5,2,1,0,0,0,0,1,0.666666666666667,0.454545454545455,0.222222222222222,0,"orthodox"
"16673",20,23,173,180,180,183,136,135,10,10,0,3,5,4,"win_A",-3,-7,-3,1,0,0,0,0,1,0.769230769230769,0.5,0.307692307692308,0,"orthodox"
"16675",20,31,173,165,180,168,135,137,8,7,0,12,3,0,"win_A",-11,8,12,-2,0,0,0,0,1,0.368421052631579,0.375,0,0,"orthodox"
"16715",28,37,170,173,178,185,134,135,23,33,0,16,18,19,"win_A",-9,-3,-7,-1,0,1,0,0,1,0.673469387755102,0.782608695652174,0.387755102040816,0,"orthodox"
"16720",27,20,170,174,178,178,150,150,18,8,0,6,15,6,"win_A",7,-4,0,0,0,0,0,0,1,0.571428571428571,0.833333333333333,0.428571428571429,0,"orthodox"
"16725",26,25,170,170,178,183,136,136,13,4,0,2,11,2,"win_A",1,0,-5,0,0,0,0,0,1,0.666666666666667,0.846153846153846,0.333333333333333,0,"orthodox"
"16793",29,38,191,198,192,203,244,235,10,24,0,4,7,13,"win_A",-9,-7,-11,9,0,1,0,0,1,0.857142857142857,0.7,0.464285714285714,0,"orthodox"
"16798",28,27,191,188,192,192,262,242,5,9,0,3,3,2,"win_A",1,3,0,20,0,0,1,0,1,0.75,0.6,0.166666666666667,0,"orthodox"
"17084",24,36,170,170,183,170,134,138,13,28,0,19,10,11,"win_A",-12,0,13,-4,0,1,0,0,1,0.595744680851064,0.769230769230769,0.234042553191489,0,"orthodox"
"17090",22,30,170,168,183,180,134,135,7,5,0,2,5,2,"win_A",-8,2,3,-1,0,0,0,0,1,0.714285714285714,0.714285714285714,0.285714285714286,0,"orthodox"
"17137",26,24,185,180,197,193,169,168,10,10,0,0,7,6,"win_A",2,5,4,1,0,0,0,0,1,1,0.7,0.6,0,"orthodox"
"17151",24,34,179,168,188,174,140,140,17,29,0,9,14,16,"win_A",-10,11,14,0,0,0,0,0,1,0.763157894736842,0.823529411764706,0.421052631578947,0,"orthodox"
"17152",24,26,179,178,188,182,140,138,16,25,0,2,14,18,"win_A",-2,1,6,2,0,0,0,0,1,0.925925925925926,0.875,0.666666666666667,0,"orthodox"
"17153",24,23,179,171,188,177,140,139,15,19,0,2,13,16,"win_A",1,8,11,1,0,0,0,0,1,0.904761904761905,0.866666666666667,0.761904761904762,0,"orthodox"
"17159",22,27,179,175,188,183,140,138,8,16,0,2,7,7,"win_A",-5,4,5,2,0,0,0,0,1,0.888888888888889,0.875,0.388888888888889,0,"orthodox"
"17173",27,21,165,162,169,166,112,112,19,18,1,1,11,6,"win_A",6,3,3,0,0,0,0,0,0.95,0.947368421052632,0.55,0.315789473684211,0,"orthodox"
"17244",35,40,193,192,193,206,257,244,32,26,9,20,30,21,"win_A",-5,1,-13,13,1,1,0,0,0.780487804878049,0.565217391304348,0.731707317073171,0.456521739130435,0,"southpaw"
"17249",25,32,206,193,216,193,241,274,21,29,0,7,15,28,"win_A",-7,13,23,-33,0,0,0,1,1,0.805555555555556,0.714285714285714,0.777777777777778,0,"orthodox"
"17257",27,35,193,180,193,193,244,231,23,11,4,14,22,9,"win_A",-8,13,0,13,0,1,0,0,0.851851851851852,0.44,0.814814814814815,0.36,0,"southpaw"
"17258",27,27,193,183,193,188,244,245,22,32,4,10,21,19,"win_A",0,10,5,-1,0,0,0,0,0.846153846153846,0.761904761904762,0.807692307692308,0.452380952380952,0,"southpaw"
"17259",27,36,193,188,193,198,245,257,21,34,4,36,20,29,"win_A",-9,5,-5,-12,0,1,0,0,0.84,0.485714285714286,0.8,0.414285714285714,0,"southpaw"
"17276",25,38,193,180,193,203,249,211,8,15,0,33,8,7,"win_A",-13,13,-10,38,0,1,1,0,1,0.3125,1,0.145833333333333,0,"southpaw"
"17280",24,43,193,193,193,206,255,240,4,1,0,6,4,1,"win_A",-19,0,-13,15,0,1,1,0,1,0.142857142857143,1,0.142857142857143,0,"southpaw"
"17311",20,26,170,165,170,168,119,119,20,15,0,1,13,7,"win_A",-6,5,2,0,0,0,0,0,1,0.9375,0.65,0.4375,0,"orthodox"
"17315",25,25,165,174,168,178,119,119,11,20,1,3,4,18,"win_A",0,-9,-10,0,0,0,0,0,0.916666666666667,0.869565217391304,0.333333333333333,0.782608695652174,0,"orthodox"
"17326",22,17,165,170,168,175,119,119,1,2,0,1,1,1,"win_A",5,-5,-7,0,0,0,0,0,1,0.666666666666667,1,0.333333333333333,0,"orthodox"
"17431",27,38,180,183,180,186,187,187,14,28,0,44,11,17,"win_A",-11,-3,-6,0,0,1,0,0,1,0.388888888888889,0.785714285714286,0.236111111111111,0,"orthodox"
"17447",35,19,164,159,164,171,112,111,7,15,1,2,2,10,"win_A",16,5,-7,1,1,0,0,0,0.875,0.882352941176471,0.25,0.588235294117647,0,"orthodox"
"17449",33,33,164,158,164,157,112,112,5,28,0,0,1,13,"win_A",0,6,7,0,0,0,0,0,1,1,0.2,0.464285714285714,0,"orthodox"
"17534",28,32,168,175,170,183,136,136,32,22,2,12,24,14,"win_A",-4,-7,-13,0,0,0,0,0,0.941176470588235,0.647058823529412,0.705882352941177,0.411764705882353,0,"orthodox"
"17537",26,31,168,168,170,168,134,133,29,7,1,12,21,1,"win_A",-5,0,2,1,0,0,0,0,0.966666666666667,0.368421052631579,0.7,0.0526315789473684,0,"orthodox"
"17553",22,26,168,178,170,191,136,136,13,5,1,3,11,4,"win_A",-4,-10,-21,0,0,0,0,0,0.928571428571429,0.625,0.785714285714286,0.5,0,"orthodox"
"17554",21,36,168,163,170,173,135,133,12,9,1,31,10,1,"win_A",-15,5,-3,2,0,1,0,0,0.923076923076923,0.225,0.769230769230769,0.025,0,"orthodox"
"17564",20,22,168,173,170,173,133,135,2,1,1,2,2,0,"win_A",-2,-5,-3,-2,0,0,0,0,0.666666666666667,0.333333333333333,0.666666666666667,0,0,"orthodox"
"17597",20,23,173,178,170,178,129,129,10,5,0,2,7,2,"win_A",-3,-5,-8,0,0,0,0,0,1,0.714285714285714,0.7,0.285714285714286,0,"orthodox"
"17606",18,24,173,168,170,173,127,126,1,1,0,1,1,0,"win_A",-6,5,-3,1,0,0,0,0,1,0.5,1,0,0,"orthodox"
"17665",35,27,179,183,183,185,178,178,31,16,5,0,18,13,"win_A",8,-4,-2,0,1,0,0,0,0.861111111111111,1,0.5,0.8125,0,"orthodox"
"17669",25,28,183,183,185,188,177,173,12,12,0,3,11,5,"win_A",-3,0,-3,4,0,0,0,0,1,0.8,0.916666666666667,0.333333333333333,0,"orthodox"
"17751",27,26,170,169,180,169,123,123,6,5,2,1,1,4,"win_B",1,1,11,0,0,0,0,0,0.75,0.833333333333333,0.125,0.666666666666667,1,"southpaw"
"17753",24,25,169,163,169,173,122,121,3,4,1,4,3,0,"win_A",-1,6,-4,1,0,0,0,0,0.75,0.5,0.75,0,0,"orthodox"
"17872",20,25,180,170,182,172,153,150,6,8,0,22,3,7,"win_A",-5,10,10,3,0,0,0,0,1,0.266666666666667,0.5,0.233333333333333,0,"orthodox"
"17881",42,35,185,183,188,189,232,233,20,18,1,2,15,10,"win_A",7,2,-1,-1,1,1,0,0,0.952380952380952,0.9,0.714285714285714,0.5,0,"southpaw"
"17882",41,38,185,201,188,210,229,240,19,14,0,1,14,6,"win_A",3,-16,-22,-11,1,1,0,0,1,0.933333333333333,0.736842105263158,0.4,0,"southpaw"
"17883",41,37,185,193,188,203,226,249,18,26,0,17,14,11,"win_A",4,-8,-15,-23,1,1,0,1,1,0.604651162790698,0.777777777777778,0.255813953488372,0,"southpaw"
"17884",40,35,185,188,188,193,234,247,17,21,0,13,13,10,"win_A",5,-3,-5,-13,1,1,0,0,1,0.617647058823529,0.764705882352941,0.294117647058824,0,"southpaw"
"17885",40,30,185,193,188,188,236,206,16,23,0,15,12,11,"win_A",10,-8,0,30,1,0,1,0,1,0.605263157894737,0.75,0.289473684210526,0,"southpaw"
"17886",39,36,185,185,188,201,226,211,15,32,0,12,11,28,"win_A",3,0,-13,15,1,1,1,0,1,0.727272727272727,0.733333333333333,0.636363636363636,0,"southpaw"
"17887",39,36,185,191,188,198,223,227,14,33,0,7,11,22,"win_A",3,-6,-10,-4,1,1,0,0,1,0.825,0.785714285714286,0.55,0,"southpaw"
"17889",38,36,185,188,188,188,217,226,12,21,0,9,9,12,"win_A",2,-3,0,-9,1,1,0,0,1,0.7,0.75,0.4,0,"southpaw"
"17890",38,32,185,193,188,208,223,235,11,11,0,6,8,5,"win_A",6,-8,-20,-12,1,0,0,0,1,0.647058823529412,0.727272727272727,0.294117647058824,0,"southpaw"
"17990",27,18,165,161,169,165,112,112,20,15,1,0,12,6,"win_A",9,4,4,0,0,0,0,0,0.952380952380952,1,0.571428571428571,0.4,0,"orthodox"
"18118",29,32,177,175,175,180,147,147,31,19,6,2,18,4,"win_A",-3,2,-5,0,0,0,0,0,0.837837837837838,0.904761904761905,0.486486486486487,0.19047619047619,0,"orthodox"
"18120",29,28,170,177,175,175,145,147,33,30,3,5,30,18,"win_A",1,-7,0,-2,0,0,0,0,0.916666666666667,0.857142857142857,0.833333333333333,0.514285714285714,0,"orthodox"
"18129",23,29,177,175,175,174,140,140,22,23,2,3,13,15,"win_B",-6,2,1,0,0,0,0,0,0.916666666666667,0.884615384615385,0.541666666666667,0.576923076923077,1,"orthodox"
"18136",20,21,170,177,185,175,135,135,12,16,1,1,3,9,"win_A",-1,-7,10,0,0,0,0,0,0.923076923076923,0.941176470588235,0.230769230769231,0.529411764705882,0,"orthodox"
"18140",20,24,177,180,175,183,128,130,12,16,1,2,8,4,"win_A",-4,-3,-8,-2,0,0,0,0,0.923076923076923,0.888888888888889,0.615384615384615,0.222222222222222,0,"orthodox"
"18147",19,23,177,173,175,168,134,134,5,6,1,1,4,5,"win_A",-4,4,7,0,0,0,0,0,0.833333333333333,0.857142857142857,0.666666666666667,0.714285714285714,0,"orthodox"
"18157",33,33,166,170,166,173,118,117,28,34,4,8,22,25,"win_A",0,-4,-7,1,0,0,0,0,0.875,0.80952380952381,0.6875,0.595238095238095,0,"orthodox"
"18159",29,30,166,168,166,175,118,118,27,19,1,0,22,14,"win_B",-1,-2,-9,0,0,0,0,0,0.964285714285714,1,0.785714285714286,0.736842105263158,1,"orthodox"
"18189",28,34,175,180,178,183,150,150,30,34,5,13,23,13,"win_A",-6,-5,-5,0,0,0,0,0,0.857142857142857,0.723404255319149,0.657142857142857,0.276595744680851,0,"southpaw"
"18193",23,32,175,180,178,188,142,142,27,29,2,4,21,19,"win_A",-9,-5,-10,0,0,0,0,0,0.931034482758621,0.878787878787879,0.724137931034483,0.575757575757576,0,"southpaw"
"18194",23,38,175,170,178,178,140,139,26,33,2,5,21,25,"win_A",-15,5,0,1,0,1,0,0,0.928571428571429,0.868421052631579,0.75,0.657894736842105,0,"southpaw"
"18196",22,33,175,175,178,178,144,144,24,46,2,5,19,29,"win_A",-11,0,0,0,0,0,0,0,0.923076923076923,0.901960784313726,0.730769230769231,0.568627450980392,0,"southpaw"
"18198",22,29,175,178,178,178,140,140,23,21,1,2,18,10,"win_A",-7,-3,0,0,0,0,0,0,0.958333333333333,0.91304347826087,0.75,0.434782608695652,0,"southpaw"
"18199",21,31,175,180,178,191,140,140,22,22,1,2,17,13,"win_A",-10,-5,-13,0,0,0,0,0,0.956521739130435,0.916666666666667,0.739130434782609,0.541666666666667,0,"southpaw"
"18201",21,34,175,175,178,188,144,142,20,31,1,12,15,25,"win_A",-13,0,-10,2,0,0,0,0,0.952380952380952,0.720930232558139,0.714285714285714,0.581395348837209,0,"southpaw"
"18203",20,33,175,171,178,173,143,143,18,24,1,7,13,14,"win_A",-13,4,5,0,0,0,0,0,0.947368421052632,0.774193548387097,0.684210526315789,0.451612903225806,0,"southpaw"
"18204",20,31,175,178,178,196,143,143,17,9,1,5,12,5,"win_A",-11,-3,-18,0,0,0,0,0,0.944444444444444,0.642857142857143,0.666666666666667,0.357142857142857,0,"southpaw"
"18210",19,20,175,173,178,178,139,139,11,11,1,0,7,7,"win_A",-1,2,0,0,0,0,0,0,0.916666666666667,1,0.583333333333333,0.636363636363636,0,"southpaw"
"18217",18,19,175,175,178,190,136,137,5,1,0,3,3,1,"win_A",-1,0,-12,-1,0,0,0,0,1,0.25,0.6,0.25,0,"southpaw"
"18220",17,28,175,175,178,178,137,138,2,2,0,1,1,2,"win_A",-11,0,0,-1,0,0,0,0,1,0.666666666666667,0.5,0.666666666666667,0,"southpaw"
"18333",28,29,165,163,173,173,125,125,11,6,1,17,6,0,"win_A",-1,2,0,0,0,0,0,0,0.916666666666667,0.260869565217391,0.5,0,0,"Unknown"
"18339",24,34,165,169,173,173,135,137,5,13,0,14,4,7,"win_A",-10,-4,0,-2,0,0,0,0,1,0.481481481481481,0.8,0.259259259259259,0,"Unknown"
"18565",24,33,180,175,178,173,148,147,21,17,0,3,19,12,"win_A",-9,5,5,1,0,0,0,0,1,0.85,0.904761904761905,0.6,0,"orthodox"
"18571",43,22,165,180,168,178,148,150,26,15,15,0,17,14,"win_B",21,-15,-10,-2,1,0,0,0,0.634146341463415,1,0.414634146341463,0.933333333333333,1,"orthodox"
"18589",26,29,161,157,166,163,115,114,13,16,3,5,4,9,"win_A",-3,4,3,1,0,0,0,0,0.8125,0.761904761904762,0.25,0.428571428571429,0,"orthodox"
"18594",23,24,163,161,168,166,115,115,16,9,2,1,8,3,"win_A",-1,2,2,0,0,0,0,0,0.888888888888889,0.9,0.444444444444444,0.3,0,"orthodox"
"18720",25,33,188,173,203,184,195,193,16,16,0,9,11,9,"win_A",-8,15,19,2,0,0,0,0,1,0.64,0.6875,0.36,0,"orthodox"
"18769",36,33,188,173,197,174,196,184,25,24,4,16,23,14,"win_A",3,15,23,12,1,0,0,0,0.862068965517241,0.6,0.793103448275862,0.35,0,"orthodox"
"18771",36,33,188,179,197,188,198,181,23,18,3,7,21,16,"win_A",3,9,9,17,1,0,1,0,0.884615384615385,0.72,0.807692307692308,0.64,0,"orthodox"
"18784",32,42,188,183,197,185,197,197,9,17,1,11,8,10,"win_A",-10,5,12,0,0,1,0,0,0.9,0.607142857142857,0.8,0.357142857142857,0,"orthodox"
"18785",24,31,182,188,180,197,212,237,11,9,0,0,10,8,"win_A",-7,-6,-17,-25,0,0,0,1,1,1,0.909090909090909,0.888888888888889,0,"orthodox"
"18818",18,23,171,173,177,173,136,137,1,3,0,3,1,1,"win_A",-5,-2,4,-1,0,0,0,0,1,0.5,1,0.166666666666667,0,"southpaw"
"18871",27,30,175,170,178,174,130,129,16,14,2,3,6,11,"win_A",-3,5,4,1,0,0,0,0,0.888888888888889,0.823529411764706,0.333333333333333,0.647058823529412,0,"orthodox"
"18872",27,27,175,178,178,178,132,132,15,14,1,4,6,5,"win_A",0,-3,0,0,0,0,0,0,0.9375,0.777777777777778,0.375,0.277777777777778,0,"orthodox"
"18876",25,28,175,170,178,178,130,130,11,11,1,1,5,8,"win_A",-3,5,0,0,0,0,0,0,0.916666666666667,0.916666666666667,0.416666666666667,0.666666666666667,0,"orthodox"
"18877",25,27,175,173,178,178,130,130,10,14,1,1,5,7,"win_A",-2,2,0,0,0,0,0,0,0.909090909090909,0.933333333333333,0.454545454545455,0.466666666666667,0,"orthodox"
"18879",27,25,168,175,165,178,131,131,8,8,0,1,3,4,"win_B",2,-7,-13,0,0,0,0,0,1,0.888888888888889,0.375,0.444444444444444,1,"orthodox"
"18893",22,29,179,177,183,180,151,151,3,22,0,3,3,13,"win_A",-7,2,3,0,0,0,0,0,1,0.88,1,0.52,0,"orthodox"
"18976",24,32,183,183,188,193,175,170,6,4,0,1,4,2,"win_A",-8,0,-5,5,0,0,0,0,1,0.8,0.666666666666667,0.4,0,"orthodox"
"19094",27,30,191,188,213,188,230,226,14,25,0,9,6,18,"win_A",-3,3,25,4,0,0,0,0,1,0.735294117647059,0.428571428571429,0.529411764705882,0,"orthodox"
"19095",27,28,191,191,213,188,225,244,13,25,0,1,6,18,"win_A",-1,0,25,-19,0,0,0,1,1,0.961538461538462,0.461538461538462,0.692307692307692,0,"orthodox"
"19099",32,26,193,191,208,213,223,227,11,9,7,0,5,4,"win_B",6,2,-5,-4,0,0,0,0,0.611111111111111,1,0.277777777777778,0.444444444444444,1,"orthodox"
"19125",25,32,200,191,201,198,252,246,7,18,0,3,3,9,"win_A",-7,9,3,6,0,0,0,0,1,0.857142857142857,0.428571428571429,0.428571428571429,0,"orthodox"
"19147",26,30,165,160,169,173,111,112,17,26,1,2,10,14,"win_A",-4,5,-4,-1,0,0,0,0,0.944444444444444,0.928571428571429,0.555555555555556,0.5,0,"orthodox"
"19263",26,20,168,170,170,173,128,128,15,3,1,1,6,3,"win_A",6,-2,-3,0,0,0,0,0,0.9375,0.75,0.375,0.75,0,"orthodox"
"19266",25,26,168,168,170,173,124,123,12,5,1,2,6,1,"win_A",-1,0,-3,1,0,0,0,0,0.923076923076923,0.714285714285714,0.461538461538462,0.142857142857143,0,"orthodox"
"19280",25,29,183,178,185,184,173,172,28,17,1,3,14,16,"win_A",-4,5,1,1,0,0,0,0,0.96551724137931,0.85,0.482758620689655,0.8,0,"southpaw"
"19317",28,30,170,177,165,179,147,147,22,29,0,1,17,16,"win_A",-2,-7,-14,0,0,0,0,0,1,0.966666666666667,0.772727272727273,0.533333333333333,0,"orthodox"
"19319",29,33,177,171,179,173,146,147,27,35,1,8,15,11,"win_A",-4,6,6,-1,0,0,0,0,0.964285714285714,0.813953488372093,0.535714285714286,0.255813953488372,0,"southpaw"
"19321",26,28,170,177,165,179,147,147,19,26,0,0,15,14,"win_A",-2,-7,-14,0,0,0,0,0,1,1,0.789473684210526,0.538461538461538,0,"orthodox"
"19380",24,25,173,178,173,178,142,141,13,20,0,2,9,9,"win_A",-1,-5,-5,1,0,0,0,0,1,0.909090909090909,0.692307692307692,0.409090909090909,0,"orthodox"
"19385",23,35,173,168,173,170,142,142,8,17,0,15,6,15,"win_A",-12,5,3,0,0,1,0,0,1,0.53125,0.75,0.46875,0,"orthodox"
"19387",22,30,173,178,173,191,141,141,6,12,0,21,4,7,"win_A",-8,-5,-18,0,0,0,0,0,1,0.363636363636364,0.666666666666667,0.212121212121212,0,"orthodox"
"19429",29,29,173,175,171,183,146,146,23,18,2,2,7,7,"win_A",0,-2,-12,0,0,0,0,0,0.92,0.9,0.28,0.35,0,"southpaw"
"19430",28,35,173,180,171,188,146,148,23,30,1,9,7,19,"win_B",-7,-7,-17,-2,0,1,0,0,0.958333333333333,0.769230769230769,0.291666666666667,0.487179487179487,1,"southpaw"
"19431",28,24,173,168,171,178,146,149,22,11,1,7,7,4,"win_A",4,5,-7,-3,0,0,0,0,0.956521739130435,0.611111111111111,0.304347826086957,0.222222222222222,0,"southpaw"
"19433",28,35,173,173,171,177,152,151,20,21,1,10,7,14,"win_A",-7,0,-6,1,0,1,0,0,0.952380952380952,0.67741935483871,0.333333333333333,0.451612903225806,0,"southpaw"
"19456",30,23,183,178,183,175,160,160,11,17,4,0,3,10,"win_A",7,5,8,0,0,0,0,0,0.733333333333333,1,0.2,0.588235294117647,0,"orthodox"
"19459",22,35,178,171,175,184,161,157,14,21,0,21,8,10,"win_A",-13,7,-9,4,0,1,0,0,1,0.5,0.571428571428571,0.238095238095238,0,"orthodox"
"19602",20,31,178,182,185,185,160,160,17,18,0,4,14,12,"win_A",-11,-4,0,0,0,0,0,0,1,0.818181818181818,0.823529411764706,0.545454545454545,0,"orthodox"
"19654",24,37,168,170,168,183,141,139,22,35,0,17,12,7,"win_A",-13,-2,-15,2,0,1,0,0,1,0.673076923076923,0.545454545454545,0.134615384615385,0,"southpaw"
"19656",23,39,168,170,168,193,142,142,20,26,0,11,12,17,"win_A",-16,-2,-25,0,0,1,0,0,1,0.702702702702703,0.6,0.459459459459459,0,"southpaw"
"19663",22,25,168,170,168,173,143,140,13,8,0,3,7,3,"win_A",-3,-2,-5,3,0,0,0,0,1,0.727272727272727,0.538461538461538,0.272727272727273,0,"southpaw"
"19669",21,31,168,173,168,175,141,139,7,4,0,0,5,0,"win_A",-10,-5,-7,2,0,0,0,0,1,1,0.714285714285714,0,0,"southpaw"
"19760",24,33,180,175,178,173,148,147,21,17,0,3,19,12,"win_A",-9,5,5,1,0,0,0,0,1,0.85,0.904761904761905,0.6,0,"orthodox"
"19766",43,22,165,180,168,178,148,150,26,15,15,0,17,14,"win_B",21,-15,-10,-2,1,0,0,0,0.634146341463415,1,0.414634146341463,0.933333333333333,1,"orthodox"
"19784",26,29,161,157,166,163,115,114,13,16,3,5,4,9,"win_A",-3,4,3,1,0,0,0,0,0.8125,0.761904761904762,0.25,0.428571428571429,0,"orthodox"
"19789",23,24,163,161,168,166,115,115,16,9,2,1,8,3,"win_A",-1,2,2,0,0,0,0,0,0.888888888888889,0.9,0.444444444444444,0.3,0,"orthodox"
"19915",25,33,188,173,203,184,195,193,16,16,0,9,11,9,"win_A",-8,15,19,2,0,0,0,0,1,0.64,0.6875,0.36,0,"orthodox"
"19964",36,33,188,173,197,174,196,184,25,24,4,16,23,14,"win_A",3,15,23,12,1,0,0,0,0.862068965517241,0.6,0.793103448275862,0.35,0,"orthodox"
"19966",36,33,188,179,197,188,198,181,23,18,3,7,21,16,"win_A",3,9,9,17,1,0,1,0,0.884615384615385,0.72,0.807692307692308,0.64,0,"orthodox"
"19979",32,42,188,183,197,185,197,197,9,17,1,11,8,10,"win_A",-10,5,12,0,0,1,0,0,0.9,0.607142857142857,0.8,0.357142857142857,0,"orthodox"
"19980",24,31,182,188,180,197,212,237,11,9,0,0,10,8,"win_A",-7,-6,-17,-25,0,0,0,1,1,1,0.909090909090909,0.888888888888889,0,"orthodox"
"20013",18,23,171,173,177,173,136,137,1,3,0,3,1,1,"win_A",-5,-2,4,-1,0,0,0,0,1,0.5,1,0.166666666666667,0,"southpaw"
"20066",27,30,175,170,178,174,130,129,16,14,2,3,6,11,"win_A",-3,5,4,1,0,0,0,0,0.888888888888889,0.823529411764706,0.333333333333333,0.647058823529412,0,"orthodox"
"20067",27,27,175,178,178,178,132,132,15,14,1,4,6,5,"win_A",0,-3,0,0,0,0,0,0,0.9375,0.777777777777778,0.375,0.277777777777778,0,"orthodox"
"20071",25,28,175,170,178,178,130,130,11,11,1,1,5,8,"win_A",-3,5,0,0,0,0,0,0,0.916666666666667,0.916666666666667,0.416666666666667,0.666666666666667,0,"orthodox"
"20072",25,27,175,173,178,178,130,130,10,14,1,1,5,7,"win_A",-2,2,0,0,0,0,0,0,0.909090909090909,0.933333333333333,0.454545454545455,0.466666666666667,0,"orthodox"
"20074",27,25,168,175,165,178,131,131,8,8,0,1,3,4,"win_B",2,-7,-13,0,0,0,0,0,1,0.888888888888889,0.375,0.444444444444444,1,"orthodox"
"20088",22,29,179,177,183,180,151,151,3,22,0,3,3,13,"win_A",-7,2,3,0,0,0,0,0,1,0.88,1,0.52,0,"orthodox"
"20171",24,32,183,183,188,193,175,170,6,4,0,1,4,2,"win_A",-8,0,-5,5,0,0,0,0,1,0.8,0.666666666666667,0.4,0,"orthodox"
"20289",27,30,191,188,213,188,230,226,14,25,0,9,6,18,"win_A",-3,3,25,4,0,0,0,0,1,0.735294117647059,0.428571428571429,0.529411764705882,0,"orthodox"
"20290",27,28,191,191,213,188,225,244,13,25,0,1,6,18,"win_A",-1,0,25,-19,0,0,0,1,1,0.961538461538462,0.461538461538462,0.692307692307692,0,"orthodox"
"20294",32,26,193,191,208,213,223,227,11,9,7,0,5,4,"win_B",6,2,-5,-4,0,0,0,0,0.611111111111111,1,0.277777777777778,0.444444444444444,1,"orthodox"
"20320",25,32,200,191,201,198,252,246,7,18,0,3,3,9,"win_A",-7,9,3,6,0,0,0,0,1,0.857142857142857,0.428571428571429,0.428571428571429,0,"orthodox"
"20342",26,30,165,160,169,173,111,112,17,26,1,2,10,14,"win_A",-4,5,-4,-1,0,0,0,0,0.944444444444444,0.928571428571429,0.555555555555556,0.5,0,"orthodox"
"20458",26,20,168,170,170,173,128,128,15,3,1,1,6,3,"win_A",6,-2,-3,0,0,0,0,0,0.9375,0.75,0.375,0.75,0,"orthodox"
"20461",25,26,168,168,170,173,124,123,12,5,1,2,6,1,"win_A",-1,0,-3,1,0,0,0,0,0.923076923076923,0.714285714285714,0.461538461538462,0.142857142857143,0,"orthodox"
"20475",25,29,183,178,185,184,173,172,28,17,1,3,14,16,"win_A",-4,5,1,1,0,0,0,0,0.96551724137931,0.85,0.482758620689655,0.8,0,"southpaw"
"20512",28,30,170,177,165,179,147,147,22,29,0,1,17,16,"win_A",-2,-7,-14,0,0,0,0,0,1,0.966666666666667,0.772727272727273,0.533333333333333,0,"orthodox"
"20514",29,33,177,171,179,173,146,147,27,35,1,8,15,11,"win_A",-4,6,6,-1,0,0,0,0,0.964285714285714,0.813953488372093,0.535714285714286,0.255813953488372,0,"southpaw"
"20516",26,28,170,177,165,179,147,147,19,26,0,0,15,14,"win_A",-2,-7,-14,0,0,0,0,0,1,1,0.789473684210526,0.538461538461538,0,"orthodox"
"20575",24,25,173,178,173,178,142,141,13,20,0,2,9,9,"win_A",-1,-5,-5,1,0,0,0,0,1,0.909090909090909,0.692307692307692,0.409090909090909,0,"orthodox"
"20580",23,35,173,168,173,170,142,142,8,17,0,15,6,15,"win_A",-12,5,3,0,0,1,0,0,1,0.53125,0.75,0.46875,0,"orthodox"
"20582",22,30,173,178,173,191,141,141,6,12,0,21,4,7,"win_A",-8,-5,-18,0,0,0,0,0,1,0.363636363636364,0.666666666666667,0.212121212121212,0,"orthodox"
"20624",29,29,173,175,171,183,146,146,23,18,2,2,7,7,"win_A",0,-2,-12,0,0,0,0,0,0.92,0.9,0.28,0.35,0,"southpaw"
"20625",28,35,173,180,171,188,146,148,23,30,1,9,7,19,"win_B",-7,-7,-17,-2,0,1,0,0,0.958333333333333,0.769230769230769,0.291666666666667,0.487179487179487,1,"southpaw"
"20626",28,24,173,168,171,178,146,149,22,11,1,7,7,4,"win_A",4,5,-7,-3,0,0,0,0,0.956521739130435,0.611111111111111,0.304347826086957,0.222222222222222,0,"southpaw"
"20628",28,35,173,173,171,177,152,151,20,21,1,10,7,14,"win_A",-7,0,-6,1,0,1,0,0,0.952380952380952,0.67741935483871,0.333333333333333,0.451612903225806,0,"southpaw"
"20651",30,23,183,178,183,175,160,160,11,17,4,0,3,10,"win_A",7,5,8,0,0,0,0,0,0.733333333333333,1,0.2,0.588235294117647,0,"orthodox"
"20654",22,35,178,171,175,184,161,157,14,21,0,21,8,10,"win_A",-13,7,-9,4,0,1,0,0,1,0.5,0.571428571428571,0.238095238095238,0,"orthodox"
"20797",20,31,178,182,185,185,160,160,17,18,0,4,14,12,"win_A",-11,-4,0,0,0,0,0,0,1,0.818181818181818,0.823529411764706,0.545454545454545,0,"orthodox"
"20849",24,37,168,170,168,183,141,139,22,35,0,17,12,7,"win_A",-13,-2,-15,2,0,1,0,0,1,0.673076923076923,0.545454545454545,0.134615384615385,0,"southpaw"
"20851",23,39,168,170,168,193,142,142,20,26,0,11,12,17,"win_A",-16,-2,-25,0,0,1,0,0,1,0.702702702702703,0.6,0.459459459459459,0,"southpaw"
"20858",22,25,168,170,168,173,143,140,13,8,0,3,7,3,"win_A",-3,-2,-5,3,0,0,0,0,1,0.727272727272727,0.538461538461538,0.272727272727273,0,"southpaw"
"20864",21,31,168,173,168,175,141,139,7,4,0,0,5,0,"win_A",-10,-5,-7,2,0,0,0,0,1,1,0.714285714285714,0,0,"southpaw"
"21047",32,39,198,188,208,191,250,235,14,22,0,17,10,9,"win_A",-7,10,17,15,0,1,1,0,1,0.564102564102564,0.714285714285714,0.230769230769231,0,"orthodox"
"21048",32,28,198,192,208,195,246,244,13,19,0,8,10,13,"win_A",4,6,13,2,0,0,0,0,1,0.703703703703704,0.769230769230769,0.481481481481481,0,"orthodox"
"21054",31,40,198,180,208,193,240,266,7,35,0,12,5,19,"win_A",-9,18,15,-26,0,1,0,1,1,0.74468085106383,0.714285714285714,0.404255319148936,0,"orthodox"
"21113",24,25,178,180,178,183,168,167,14,20,2,0,2,12,"win_B",-1,-2,-5,1,0,0,0,0,0.875,1,0.125,0.6,1,"orthodox"
"21312",33,23,170,171,168,165,142,143,18,17,1,2,11,12,"win_B",10,-1,3,-1,0,0,0,0,0.947368421052632,0.894736842105263,0.578947368421053,0.631578947368421,1,"orthodox"
"21313",29,23,178,171,183,165,141,142,18,17,0,1,8,12,"win_A",6,7,18,-1,0,0,0,0,1,0.944444444444444,0.444444444444444,0.666666666666667,0,"orthodox"
"21316",21,26,171,180,165,193,143,146,14,6,1,0,10,6,"win_A",-5,-9,-28,-3,0,0,0,0,0.933333333333333,1,0.666666666666667,1,0,"orthodox"
"21329",18,28,171,175,165,183,141,141,2,4,0,9,2,1,"win_A",-10,-4,-18,0,0,0,0,0,1,0.307692307692308,1,0.0769230769230769,0,"orthodox"
"21345",30,29,173,164,176,166,115,115,34,14,12,2,23,9,"win_A",1,9,10,0,0,0,0,0,0.739130434782609,0.875,0.5,0.5625,0,"southpaw"
"21360",34,26,163,173,165,176,117,118,49,21,5,8,33,13,"win_A",8,-10,-11,-1,0,0,0,0,0.907407407407407,0.724137931034483,0.611111111111111,0.448275862068966,0,"southpaw"
"21368",21,24,173,163,176,168,116,115,15,19,5,1,8,14,"win_A",-3,10,8,1,0,0,0,0,0.75,0.95,0.4,0.7,0,"southpaw"
"21374",18,23,173,163,176,168,109,109,12,6,2,0,7,4,"win_B",-5,10,8,0,0,0,0,0,0.857142857142857,1,0.5,0.666666666666667,1,"southpaw"
"21376",18,20,173,157,176,163,112,113,11,4,1,0,7,4,"win_B",-2,16,13,-1,0,0,0,0,0.916666666666667,1,0.583333333333333,1,1,"southpaw"
"21869",25,30,182,185,179,196,159,160,19,19,0,12,12,14,"win_A",-5,-3,-17,-1,0,0,0,0,1,0.612903225806452,0.631578947368421,0.451612903225806,0,"orthodox"
"21870",25,24,182,178,179,183,159,159,18,15,0,3,11,5,"win_A",1,4,-4,0,0,0,0,0,1,0.833333333333333,0.611111111111111,0.277777777777778,0,"orthodox"
"21875",24,36,182,175,179,183,158,157,13,24,0,15,7,9,"win_A",-12,7,-4,1,0,1,0,0,1,0.615384615384615,0.538461538461538,0.230769230769231,0,"orthodox"
"21889",23,35,192,183,193,183,199,188,19,21,1,9,14,12,"win_A",-12,9,10,11,0,1,0,0,0.95,0.7,0.7,0.4,0,"orthodox"
"21975",34,30,183,183,185,179,160,160,27,23,3,1,9,14,"win_A",4,0,6,0,0,0,0,0,0.9,0.958333333333333,0.3,0.583333333333333,0,"orthodox"
"21980",23,28,180,183,185,179,154,154,18,19,0,0,10,12,"win_A",-5,-3,6,0,0,0,0,0,1,1,0.555555555555556,0.631578947368421,0,"orthodox"
"22071",28,38,175,168,178,183,140,140,18,42,5,13,8,25,"win_A",-10,7,-5,0,0,1,0,0,0.782608695652174,0.763636363636364,0.347826086956522,0.454545454545455,0,"Unknown"
"22073",28,38,175,168,178,183,145,147,16,42,5,12,8,25,"win_A",-10,7,-5,-2,0,1,0,0,0.761904761904762,0.777777777777778,0.380952380952381,0.462962962962963,0,"Unknown"
"22082",24,27,175,169,178,175,147,147,9,15,0,9,5,11,"win_A",-3,6,3,0,0,0,0,0,1,0.625,0.555555555555556,0.458333333333333,0,"Unknown"
"22156",27,31,166,168,166,176,122,122,29,20,2,2,17,12,"win_A",-4,-2,-10,0,0,0,0,0,0.935483870967742,0.909090909090909,0.548387096774194,0.545454545454545,0,"orthodox"
"22159",24,30,168,168,177,176,118,118,28,19,1,0,10,11,"win_A",-6,0,1,0,0,0,0,0,0.96551724137931,1,0.344827586206897,0.578947368421053,0,"southpaw"
"22160",30,26,168,174,176,178,118,118,18,22,0,3,10,16,"win_A",4,-6,-2,0,0,0,0,0,1,0.88,0.555555555555556,0.64,0,"orthodox"
"22218",24,32,183,175,191,180,154,153,14,7,1,2,13,5,"win_A",-8,8,11,1,0,0,0,0,0.933333333333333,0.777777777777778,0.866666666666667,0.555555555555556,0,"orthodox"
"22269",35,28,167,170,173,170,139,140,33,17,3,7,24,4,"win_B",7,-3,3,-1,1,0,0,0,0.916666666666667,0.708333333333333,0.666666666666667,0.166666666666667,1,"orthodox"
"22281",23,27,170,172,170,175,129,130,7,9,3,8,2,2,"win_A",-4,-2,-5,-1,0,0,0,0,0.7,0.529411764705882,0.2,0.117647058823529,0,"orthodox"
"22297",20,27,175,170,174,175,143,140,10,8,0,4,9,6,"win_A",-7,5,-1,3,0,0,0,0,1,0.666666666666667,0.9,0.5,0,"orthodox"
"22298",20,36,175,175,174,185,141,141,9,14,0,8,8,8,"win_A",-16,0,-11,0,0,1,0,0,1,0.636363636363636,0.888888888888889,0.363636363636364,0,"orthodox"
"22448",28,22,165,168,170,175,117,118,14,11,0,1,6,4,"win_A",6,-3,-5,-1,0,0,0,0,1,0.916666666666667,0.428571428571429,0.333333333333333,0,"southpaw"
"22564",29,35,177,170,179,170,140,140,32,53,1,9,13,31,"win_A",-6,7,9,0,0,1,0,0,0.96969696969697,0.854838709677419,0.393939393939394,0.5,0,"orthodox"
"22711",24,29,193,178,201,175,162,163,19,17,0,3,8,11,"win_A",-5,15,26,-1,0,0,0,0,1,0.85,0.421052631578947,0.55,0,"orthodox"
"22731",32,30,180,178,183,175,154,154,22,20,3,4,12,14,"win_A",2,2,8,0,0,0,0,0,0.88,0.833333333333333,0.48,0.583333333333333,0,"orthodox"
"22750",25,22,180,180,183,183,159,159,3,2,1,1,3,0,"win_A",3,0,0,0,0,0,0,0,0.75,0.666666666666667,0.75,0,0,"orthodox"
"22757",33,26,178,188,185,197,154,154,12,14,0,9,6,11,"win_A",7,-10,-12,0,0,0,0,0,1,0.608695652173913,0.5,0.478260869565217,0,"Unknown"
"22837",18,26,168,175,175,193,123,122,3,4,0,9,3,1,"win_A",-8,-7,-18,1,0,0,0,0,1,0.307692307692308,1,0.0769230769230769,0,"orthodox"
"22945",32,28,163,166,169,166,122,122,46,32,3,2,36,19,"win_B",4,-3,3,0,0,0,0,0,0.938775510204082,0.941176470588235,0.73469387755102,0.558823529411765,1,"orthodox"
"22960",25,21,166,175,166,175,126,126,17,17,1,5,7,12,"win_A",4,-9,-9,0,0,0,0,0,0.944444444444444,0.772727272727273,0.388888888888889,0.545454545454545,0,"orthodox"
"23004",25,27,171,165,180,168,129,129,25,25,4,1,23,17,"win_A",-2,6,12,0,0,0,0,0,0.862068965517241,0.961538461538462,0.793103448275862,0.653846153846154,0,"southpaw"
"23005",26,25,165,168,168,168,123,122,24,17,1,1,16,10,"win_A",1,-3,0,1,0,0,0,0,0.96,0.944444444444444,0.64,0.555555555555556,0,"orthodox"
"23010",24,23,165,165,168,175,122,122,19,17,0,7,12,14,"win_A",1,0,-7,0,0,0,0,0,1,0.708333333333333,0.631578947368421,0.583333333333333,0,"orthodox"
"23014",38,23,166,165,178,168,127,130,34,15,6,0,15,9,"win_B",15,1,10,-3,1,0,0,0,0.85,1,0.375,0.6,1,"orthodox"
"23018",28,22,170,165,173,168,123,123,10,11,1,0,6,6,"win_B",6,5,5,0,0,0,0,0,0.909090909090909,1,0.545454545454545,0.545454545454545,1,"orthodox"
"23087",27,24,163,163,174,169,121,122,8,5,0,5,4,4,"win_A",3,0,5,-1,0,0,0,0,1,0.5,0.5,0.4,0,"orthodox"
"23266",29,34,170,163,171,170,133,135,15,26,2,13,2,14,"win_A",-5,7,1,-2,0,0,0,0,0.882352941176471,0.666666666666667,0.117647058823529,0.358974358974359,0,"orthodox"
"23268",29,27,170,180,171,173,137,133,14,14,1,6,2,11,"win_A",2,-10,-2,4,0,0,0,0,0.933333333333333,0.7,0.133333333333333,0.55,0,"orthodox"
"23279",25,28,170,178,171,193,140,141,4,18,0,24,2,5,"win_A",-3,-8,-22,-1,0,0,0,0,1,0.428571428571429,0.5,0.119047619047619,0,"orthodox"
"23368",36,29,191,198,194,211,238,231,31,19,12,1,15,15,"win_B",7,-7,-17,7,1,0,0,0,0.720930232558139,0.95,0.348837209302326,0.75,1,"orthodox"
"23381",21,37,198,178,211,178,186,185,7,5,0,7,5,1,"win_A",-16,20,33,1,0,1,0,0,1,0.416666666666667,0.714285714285714,0.0833333333333333,0,"orthodox"
"23390",36,21,162,163,163,163,108,108,13,8,6,0,7,5,"win_B",15,-1,0,0,1,0,0,0,0.684210526315789,1,0.368421052631579,0.625,1,"southpaw"
"23473",33,36,173,171,180,183,146,147,32,42,5,8,7,29,"win_A",-3,2,-3,-1,0,1,0,0,0.864864864864865,0.84,0.189189189189189,0.58,0,"orthodox"
"23474",34,24,171,170,183,175,138,138,41,26,7,0,28,15,"win_A",10,1,8,0,0,0,0,0,0.854166666666667,1,0.583333333333333,0.576923076923077,0,"southpaw"
"23475",24,33,174,171,180,183,140,140,25,41,1,6,17,28,"win_A",-9,3,-3,0,0,0,0,0,0.961538461538462,0.872340425531915,0.653846153846154,0.595744680851064,0,"orthodox"
"23477",32,29,171,178,183,188,141,143,38,28,6,4,26,17,"win_A",3,-7,-5,-2,0,0,0,0,0.863636363636364,0.875,0.590909090909091,0.53125,0,"southpaw"
"23478",32,32,171,175,183,185,145,145,37,22,6,19,25,10,"win_A",0,-4,-2,0,0,0,0,0,0.86046511627907,0.536585365853659,0.581395348837209,0.24390243902439,0,"southpaw"
"23480",30,30,173,171,178,183,143,147,34,36,2,5,21,25,"win_A",0,2,-5,-4,0,0,0,0,0.944444444444444,0.878048780487805,0.583333333333333,0.609756097560976,0,"orthodox"
"23487",27,26,171,177,183,180,146,147,32,34,2,2,23,11,"win_A",1,-6,3,-1,0,0,0,0,0.941176470588235,0.944444444444444,0.676470588235294,0.305555555555556,0,"southpaw"
"23489",26,38,171,183,183,188,147,147,30,38,2,5,22,31,"win_A",-12,-12,-5,0,0,1,0,0,0.9375,0.883720930232558,0.6875,0.720930232558139,0,"southpaw"
"23490",26,26,177,171,180,183,146,147,32,30,2,1,11,22,"win_A",0,6,-3,-1,0,0,0,0,0.941176470588235,0.967741935483871,0.323529411764706,0.709677419354839,0,"southpaw"
"23491",26,31,171,170,183,168,140,140,29,30,1,4,21,26,"win_A",-5,1,15,0,0,0,0,0,0.966666666666667,0.882352941176471,0.7,0.764705882352941,0,"southpaw"
"23493",24,29,171,170,183,183,140,140,27,35,1,3,21,16,"win_A",-5,1,0,0,0,0,0,0,0.964285714285714,0.921052631578947,0.75,0.421052631578947,0,"southpaw"
"23501",21,30,171,173,183,165,143,142,20,26,0,5,15,10,"win_A",-9,-2,18,1,0,0,0,0,1,0.838709677419355,0.75,0.32258064516129,0,"southpaw"
"23514",19,23,171,177,183,181,141,140,7,3,0,6,6,1,"win_A",-4,-6,2,1,0,0,0,0,1,0.333333333333333,0.857142857142857,0.111111111111111,0,"southpaw"
"23585",21,31,170,165,173,170,131,133,11,28,0,19,3,14,"win_A",-10,5,3,-2,0,0,0,0,1,0.595744680851064,0.272727272727273,0.297872340425532,0,"orthodox"
"23586",20,26,170,173,173,179,132,132,10,9,0,4,3,2,"win_A",-6,-3,-6,0,0,0,0,0,1,0.692307692307692,0.3,0.153846153846154,0,"orthodox"
"23686",35,32,163,174,165,178,130,129,23,26,4,7,11,20,"win_A",3,-11,-13,1,1,0,0,0,0.851851851851852,0.787878787878788,0.407407407407407,0.606060606060606,0,"southpaw"
"23694",30,24,163,169,165,168,126,126,16,19,2,0,7,12,"win_A",6,-6,-3,0,0,0,0,0,0.888888888888889,1,0.388888888888889,0.631578947368421,0,"southpaw"
"23695",29,28,165,163,178,165,128,126,37,16,2,1,31,7,"win_A",1,2,13,2,0,0,0,0,0.948717948717949,0.941176470588235,0.794871794871795,0.411764705882353,0,"southpaw"
"23696",30,28,170,163,185,165,126,125,18,16,4,0,11,7,"win_A",2,7,20,1,0,0,0,0,0.818181818181818,1,0.5,0.4375,0,"southpaw"
"23697",27,26,163,170,165,175,127,127,15,30,0,0,6,28,"win_A",1,-7,-10,0,0,0,0,0,1,1,0.4,0.933333333333333,0,"southpaw"
"23701",25,36,163,168,165,168,131,132,11,29,0,30,6,17,"win_A",-11,-5,-3,-1,0,1,0,0,1,0.491525423728814,0.545454545454545,0.288135593220339,0,"southpaw"
"23715",29,29,178,170,183,175,149,149,22,14,4,5,11,11,"win_A",0,8,8,0,0,0,0,0,0.846153846153846,0.736842105263158,0.423076923076923,0.578947368421053,0,"orthodox"
"23720",37,27,179,178,185,183,148,148,33,17,6,3,19,8,"win_B",10,1,2,0,1,0,0,0,0.846153846153846,0.85,0.487179487179487,0.4,1,"orthodox"
"23721",27,34,178,175,183,188,150,150,16,30,3,5,8,20,"win_A",-7,3,-5,0,0,0,0,0,0.842105263157895,0.857142857142857,0.421052631578947,0.571428571428571,0,"orthodox"
"23722",27,28,178,188,183,196,156,157,15,5,3,13,8,3,"win_A",-1,-10,-13,-1,0,0,0,0,0.833333333333333,0.277777777777778,0.444444444444444,0.166666666666667,0,"orthodox"
"23725",26,33,178,185,183,208,148,150,12,10,3,11,6,7,"win_A",-7,-7,-25,-2,0,0,0,0,0.8,0.476190476190476,0.4,0.333333333333333,0,"orthodox"
"23726",24,23,178,175,183,178,154,158,11,7,2,2,5,6,"win_A",1,3,5,-4,0,0,0,0,0.846153846153846,0.777777777777778,0.384615384615385,0.666666666666667,0,"orthodox"
"23731",27,21,170,178,168,183,147,148,5,8,0,0,5,4,"win_A",6,-8,-15,-1,0,0,0,0,1,1,1,0.5,0,"orthodox"
"23733",21,23,178,188,183,196,153,154,6,5,0,6,3,3,"win_A",-2,-10,-13,-1,0,0,0,0,1,0.454545454545455,0.5,0.272727272727273,0,"orthodox"
"23807",20,30,170,168,183,168,131,128,2,6,0,9,1,1,"win_A",-10,2,15,3,0,0,0,0,1,0.4,0.5,0.0666666666666667,0,"orthodox"
"23894",29,34,174,182,178,178,132,129,24,27,4,21,16,21,"win_A",-5,-8,0,3,0,0,0,0,0.857142857142857,0.5625,0.571428571428571,0.4375,0,"orthodox"
"23899",24,35,174,163,178,168,125,125,17,34,0,22,13,26,"win_A",-11,11,10,0,0,1,0,0,1,0.607142857142857,0.764705882352941,0.464285714285714,0,"orthodox"
"23902",22,33,174,157,178,157,123,123,14,28,0,14,11,19,"win_A",-11,17,21,0,0,0,0,0,1,0.666666666666667,0.785714285714286,0.452380952380952,0,"orthodox"
"23918",26,29,178,177,185,180,147,147,12,19,0,2,5,18,"win_A",-3,1,5,0,0,0,0,0,1,0.904761904761905,0.416666666666667,0.857142857142857,0,"southpaw"
"23927",25,40,177,168,180,175,140,143,11,23,0,45,10,18,"win_A",-15,9,5,-3,0,1,0,0,1,0.338235294117647,0.909090909090909,0.264705882352941,0,"orthodox"
"23943",28,24,173,180,173,185,154,154,19,32,4,2,12,22,"win_A",4,-7,-12,0,0,0,0,0,0.826086956521739,0.941176470588235,0.521739130434783,0.647058823529412,0,"orthodox"
"23944",24,23,180,185,185,197,154,154,31,35,2,2,22,32,"win_A",1,-5,-12,0,0,0,0,0,0.939393939393939,0.945945945945946,0.666666666666667,0.864864864864865,0,"orthodox"
"23945",23,37,180,179,185,185,154,154,30,33,2,5,22,19,"win_A",-14,1,0,0,0,1,0,0,0.9375,0.868421052631579,0.6875,0.5,0,"orthodox"
"23946",23,33,180,172,185,180,147,147,29,22,2,6,22,17,"win_A",-10,8,5,0,0,0,0,0,0.935483870967742,0.785714285714286,0.709677419354839,0.607142857142857,0,"orthodox"
"23948",24,22,170,180,178,185,151,151,31,28,4,1,19,21,"win_A",2,-10,-7,0,0,0,0,0,0.885714285714286,0.96551724137931,0.542857142857143,0.724137931034483,0,"orthodox"
"23950",24,21,170,180,178,185,150,150,29,27,4,0,18,20,"win_A",3,-10,-7,0,0,0,0,0,0.878787878787879,1,0.545454545454545,0.740740740740741,0,"orthodox"
"23963",19,25,180,170,185,173,144,142,14,11,0,6,10,6,"win_A",-6,10,12,2,0,0,0,0,1,0.647058823529412,0.714285714285714,0.352941176470588,0,"orthodox"
"24017",22,27,178,183,188,185,156,159,20,29,2,6,9,27,"win_A",-5,-5,3,-3,0,0,0,0,0.909090909090909,0.828571428571429,0.409090909090909,0.771428571428571,0,"orthodox"
"24029",19,26,178,178,188,175,161,161,9,3,0,0,6,2,"win_A",-7,0,13,0,0,0,0,0,1,1,0.666666666666667,0.666666666666667,0,"orthodox"
"24149",28,33,177,178,180,180,139,138,16,41,0,2,13,17,"win_A",-5,-1,0,1,0,0,0,0,1,0.953488372093023,0.8125,0.395348837209302,0,"southpaw"
"24152",26,34,177,166,180,165,134,134,12,11,0,8,11,8,"win_A",-8,11,15,0,0,0,0,0,1,0.578947368421053,0.916666666666667,0.421052631578947,0,"southpaw"
"24154",26,28,177,178,180,191,140,135,10,7,0,14,9,5,"win_A",-2,-1,-11,5,0,0,0,0,1,0.333333333333333,0.9,0.238095238095238,0,"southpaw"
"24205",32,31,203,187,208,193,271,240,19,9,3,2,16,8,"win_A",1,16,15,31,0,0,1,0,0.863636363636364,0.818181818181818,0.727272727272727,0.727272727272727,0,"orthodox"
"24210",30,41,203,196,208,207,250,259,15,37,1,3,13,25,"win_B",-11,7,1,-9,0,1,0,0,0.9375,0.925,0.8125,0.625,1,"orthodox"
"24211",41,29,196,203,207,208,247,262,36,15,3,0,24,13,"win_A",12,-7,-1,-15,1,0,0,1,0.923076923076923,1,0.615384615384615,0.866666666666667,0,"southpaw"
"24213",29,40,203,197,208,218,247,245,13,28,0,5,11,21,"win_A",-11,6,-10,2,0,1,0,0,1,0.848484848484849,0.846153846153846,0.636363636363636,0,"orthodox"
"24217",27,27,203,191,208,196,246,265,9,35,0,9,7,28,"win_A",0,12,12,-19,0,0,0,1,1,0.795454545454545,0.777777777777778,0.636363636363636,0,"orthodox"
"24339",26,21,178,175,185,180,146,147,10,8,0,8,5,1,"win_A",5,3,5,-1,0,0,0,0,1,0.5,0.5,0.0625,0,"southpaw"
"24597",28,30,167,159,171,167,112,112,15,34,1,10,10,24,"win_A",-2,8,4,0,0,0,0,0,0.9375,0.772727272727273,0.625,0.545454545454545,0,"southpaw"
"24598",27,27,167,155,171,160,112,112,14,33,1,5,10,18,"win_A",0,12,11,0,0,0,0,0,0.933333333333333,0.868421052631579,0.666666666666667,0.473684210526316,0,"southpaw"
"24606",27,24,168,167,170,171,112,112,13,7,3,0,5,5,"win_A",3,1,-1,0,0,0,0,0,0.8125,1,0.3125,0.714285714285714,0,"orthodox"
"24804",29,30,160,162,166,165,114,115,33,11,8,3,19,6,"win_A",-1,-2,1,-1,0,0,0,0,0.804878048780488,0.785714285714286,0.463414634146341,0.428571428571429,0,"orthodox"
"24820",20,21,165,160,168,166,113,112,14,18,1,5,4,11,"win_A",-1,5,2,1,0,0,0,0,0.933333333333333,0.782608695652174,0.266666666666667,0.478260869565217,0,"southpaw"
"24846",25,27,178,166,182,173,144,140,23,26,2,28,16,21,"win_A",-2,12,9,4,0,0,0,0,0.92,0.481481481481481,0.64,0.388888888888889,0,"orthodox"
"24859",22,28,178,178,182,185,140,138,11,14,1,4,9,7,"win_A",-6,0,-3,2,0,0,0,0,0.916666666666667,0.777777777777778,0.75,0.388888888888889,0,"orthodox"
"24954",23,37,161,160,156,150,105,105,30,62,0,7,12,32,"win_A",-14,1,6,0,0,1,0,0,1,0.898550724637681,0.4,0.463768115942029,0,"southpaw"
"25035",27,30,173,165,178,175,135,135,25,37,4,18,18,29,"win_A",-3,8,3,0,0,0,0,0,0.862068965517241,0.672727272727273,0.620689655172414,0.527272727272727,0,"orthodox"
"25042",21,35,173,163,178,168,123,123,19,33,1,20,14,26,"win_A",-14,10,10,0,0,1,0,0,0.95,0.622641509433962,0.7,0.490566037735849,0,"orthodox"
"25220",24,33,206,191,216,208,240,248,19,28,0,2,14,13,"win_A",-9,15,8,-8,0,0,0,0,1,0.933333333333333,0.736842105263158,0.433333333333333,0,"orthodox"
"25231",28,41,191,187,208,198,242,221,19,38,0,6,6,34,"win_A",-13,4,10,21,0,1,1,0,1,0.863636363636364,0.315789473684211,0.772727272727273,0,"orthodox"
"25235",27,27,191,191,208,193,229,253,15,22,0,1,6,16,"win_A",0,0,15,-24,0,0,0,1,1,0.956521739130435,0.4,0.695652173913043,0,"orthodox"
"25240",27,21,191,180,208,188,236,264,10,9,0,14,5,7,"win_A",6,11,20,-28,0,0,0,1,1,0.391304347826087,0.5,0.304347826086957,0,"orthodox"
"25244",25,32,191,188,208,196,232,270,6,7,0,1,4,5,"win_A",-7,3,12,-38,0,0,0,1,1,0.875,0.666666666666667,0.625,0,"orthodox"
"25252",28,29,175,173,184,188,135,135,17,9,0,1,12,6,"win_A",-1,2,-4,0,0,0,0,0,1,0.9,0.705882352941177,0.6,0,"orthodox"
"25254",26,34,175,170,184,178,135,135,15,11,0,11,11,4,"win_A",-8,5,6,0,0,0,0,0,1,0.5,0.733333333333333,0.181818181818182,0,"orthodox"
"25257",24,31,175,168,184,178,130,130,12,4,0,9,9,2,"win_A",-7,7,6,0,0,0,0,0,1,0.307692307692308,0.75,0.153846153846154,0,"orthodox"
"25327",20,21,170,170,169,168,122,122,10,11,0,2,6,5,"win_A",-1,0,1,0,0,0,0,0,1,0.846153846153846,0.6,0.384615384615385,0,"southpaw"
"25483",25,27,175,183,178,183,178,180,5,12,0,4,3,6,"win_A",-2,-8,-5,-2,0,0,0,0,1,0.75,0.6,0.375,0,"orthodox"
"25593",21,25,163,168,168,163,123,125,2,4,0,5,2,1,"win_A",-4,-5,5,-2,0,0,0,0,1,0.444444444444444,1,0.111111111111111,0,"Unknown"
"25604",23,30,168,174,164,179,125,125,15,20,0,5,7,14,"win_A",-7,-6,-15,0,0,0,0,0,1,0.8,0.466666666666667,0.56,0,"orthodox"
"25615",20,37,168,163,164,173,130,128,3,9,0,32,3,1,"win_A",-17,5,-9,2,0,1,0,0,1,0.219512195121951,1,0.024390243902439,0,"orthodox"
"25648",25,29,173,175,173,183,145,145,20,17,2,5,9,7,"win_A",-4,-2,-10,0,0,0,0,0,0.909090909090909,0.772727272727273,0.409090909090909,0.318181818181818,0,"orthodox"
"25651",31,22,170,173,168,173,139,139,15,18,0,0,9,8,"win_A",9,-3,-5,0,0,0,0,0,1,1,0.6,0.444444444444444,0,"orthodox"
"25657",21,24,173,175,173,180,145,144,12,15,0,2,6,11,"win_A",-3,-2,-7,1,0,0,0,0,1,0.882352941176471,0.5,0.647058823529412,0,"orthodox"
"25803",28,34,168,170,166,185,147,145,5,5,0,10,5,4,"win_A",-6,-2,-19,2,0,0,0,0,1,0.333333333333333,1,0.266666666666667,0,"Unknown"
"25984",27,27,160,159,168,167,108,108,21,28,1,7,17,18,"win_A",0,1,1,0,0,0,0,0,0.954545454545455,0.8,0.772727272727273,0.514285714285714,0,"southpaw"
"26073",20,23,175,173,185,180,120,121,14,21,0,6,11,15,"win_A",-3,2,5,-1,0,0,0,0,1,0.777777777777778,0.785714285714286,0.555555555555556,0,"orthodox"
"26075",20,37,175,163,185,175,122,123,12,19,0,10,10,10,"win_A",-17,12,10,-1,0,1,0,0,1,0.655172413793103,0.833333333333333,0.344827586206897,0,"orthodox"
"26282",25,27,180,179,183,184,172,170,16,37,0,17,13,11,"win_A",-2,1,-1,2,0,0,0,0,1,0.685185185185185,0.8125,0.203703703703704,0,"orthodox"
"26284",25,28,180,177,183,177,164,167,14,19,0,15,12,8,"win_A",-3,3,6,-3,0,0,0,0,1,0.558823529411765,0.857142857142857,0.235294117647059,0,"orthodox"
"26291",22,25,180,177,183,177,162,165,7,11,0,4,6,5,"win_A",-3,3,6,-3,0,0,0,0,1,0.733333333333333,0.857142857142857,0.333333333333333,0,"orthodox"
"26414",23,28,170,168,175,165,126,127,13,10,0,1,10,2,"win_A",-5,2,10,-1,0,0,0,0,1,0.909090909090909,0.769230769230769,0.181818181818182,0,"orthodox"
"26418",22,29,170,170,175,173,127,129,9,8,0,17,7,4,"win_A",-7,0,2,-2,0,0,0,0,1,0.32,0.777777777777778,0.16,0,"orthodox"
"26601",21,28,170,163,178,173,125,125,7,5,0,15,3,0,"win_A",-7,7,5,0,0,0,0,0,1,0.25,0.428571428571429,0,0,"Unknown"
"26646",29,29,168,175,168,175,121,121,30,15,11,6,16,9,"win_A",0,-7,-7,0,0,0,0,0,0.731707317073171,0.714285714285714,0.390243902439024,0.428571428571429,0,"orthodox"
"26649",27,24,168,170,168,165,118,118,27,17,10,1,15,11,"win_A",3,-2,3,0,0,0,0,0,0.72972972972973,0.944444444444444,0.405405405405405,0.611111111111111,0,"orthodox"
"26657",25,23,155,168,160,168,114,112,25,22,5,6,16,11,"win_A",2,-13,-8,2,0,0,0,0,0.833333333333333,0.785714285714286,0.533333333333333,0.392857142857143,0,"orthodox"
"26666",20,28,168,159,168,161,112,112,14,26,4,14,9,15,"win_A",-8,9,7,0,0,0,0,0,0.777777777777778,0.65,0.5,0.375,0,"orthodox"
"26667",19,26,168,165,168,165,112,112,13,21,4,6,8,7,"win_A",-7,3,3,0,0,0,0,0,0.764705882352941,0.777777777777778,0.470588235294118,0.259259259259259,0,"orthodox"
"26721",27,34,173,180,183,188,148,148,20,34,2,5,15,28,"win_B",-7,-7,-5,0,0,0,0,0,0.909090909090909,0.871794871794872,0.681818181818182,0.717948717948718,1,"orthodox"
"26734",24,30,180,175,188,183,147,148,22,25,0,6,20,19,"win_A",-6,5,5,-1,0,0,0,0,1,0.806451612903226,0.909090909090909,0.612903225806452,0,"orthodox"
"26740",22,24,180,179,188,183,145,147,16,14,0,1,15,8,"win_A",-2,1,5,-2,0,0,0,0,1,0.933333333333333,0.9375,0.533333333333333,0,"orthodox"
"26742",22,32,180,173,188,178,147,148,14,23,0,9,13,15,"win_A",-10,7,10,-1,0,0,0,0,1,0.71875,0.928571428571429,0.46875,0,"orthodox"
"26877",24,30,172,173,173,186,133,134,11,29,0,6,8,22,"win_A",-6,-1,-13,-1,0,0,0,0,1,0.828571428571429,0.727272727272727,0.628571428571429,0,"orthodox"
"26879",24,22,172,173,173,173,135,135,9,6,0,2,7,1,"win_A",2,-1,0,0,0,0,0,0,1,0.75,0.777777777777778,0.125,0,"orthodox"
"26974",29,37,188,184,190,188,175,173,23,29,2,2,8,25,"win_A",-8,4,2,2,0,1,0,0,0.92,0.935483870967742,0.32,0.806451612903226,0,"southpaw"
"27017",29,32,178,168,183,175,171,179,37,8,11,31,27,3,"win_A",-3,10,8,-8,0,0,0,0,0.770833333333333,0.205128205128205,0.5625,0.0769230769230769,0,"orthodox"
"27020",25,36,178,180,183,188,146,146,33,12,8,6,23,9,"win_A",-11,-2,-5,0,0,1,0,0,0.804878048780488,0.666666666666667,0.560975609756098,0.5,0,"orthodox"
"27021",25,30,178,173,183,173,146,146,32,19,8,2,22,10,"win_A",-5,5,10,0,0,0,0,0,0.8,0.904761904761905,0.55,0.476190476190476,0,"orthodox"
"27022",32,25,178,178,180,183,145,147,28,31,3,8,20,21,"win_B",7,0,-3,-2,0,0,0,0,0.903225806451613,0.794871794871795,0.645161290322581,0.538461538461538,1,"southpaw"
"27024",24,37,178,173,183,185,146,146,29,41,8,5,19,18,"win_A",-13,5,-2,0,0,1,0,0,0.783783783783784,0.891304347826087,0.513513513513513,0.391304347826087,0,"orthodox"
"27027",24,37,178,180,183,183,147,151,26,56,8,54,16,45,"win_A",-13,-2,0,-4,0,1,0,0,0.764705882352941,0.509090909090909,0.470588235294118,0.409090909090909,0,"orthodox"
"27031",23,28,178,183,183,188,153,154,22,13,7,5,14,11,"win_A",-5,-5,-5,-1,0,0,0,0,0.758620689655172,0.722222222222222,0.482758620689655,0.611111111111111,0,"orthodox"
"27033",22,28,178,175,183,175,152,158,20,21,7,2,12,13,"win_A",-6,3,8,-6,0,0,0,0,0.740740740740741,0.91304347826087,0.444444444444444,0.565217391304348,0,"orthodox"
"27036",26,22,177,178,183,183,148,150,22,18,3,6,16,10,"win_A",4,-1,0,-2,0,0,0,0,0.88,0.75,0.64,0.416666666666667,0,"orthodox"
"27041",21,26,178,183,183,188,153,154,13,11,6,2,7,9,"win_A",-5,-5,-5,-1,0,0,0,0,0.684210526315789,0.846153846153846,0.368421052631579,0.692307692307692,0,"orthodox"
"27043",21,26,178,183,183,188,153,153,12,11,5,1,7,9,"win_A",-5,-5,-5,0,0,0,0,0,0.705882352941177,0.916666666666667,0.411764705882353,0.75,0,"orthodox"
"27044",27,20,175,178,188,183,152,151,19,12,1,3,16,7,"win_A",7,-3,5,1,0,0,0,0,0.95,0.8,0.8,0.466666666666667,0,"orthodox"
"27048",19,26,178,175,183,175,158,164,9,1,2,4,5,1,"win_A",-7,3,8,-6,0,0,0,0,0.818181818181818,0.2,0.454545454545455,0.2,0,"orthodox"
"27049",19,20,178,168,183,183,160,161,8,3,2,4,4,3,"win_A",-1,10,0,-1,0,0,0,0,0.8,0.428571428571429,0.4,0.428571428571429,0,"orthodox"
"27050",27,19,168,178,183,183,150,149,12,8,3,1,11,4,"win_A",8,-10,0,1,0,0,0,0,0.8,0.888888888888889,0.733333333333333,0.444444444444444,0,"orthodox"
"27057",18,23,178,178,183,190,150,148,2,5,0,2,2,5,"win_A",-5,0,-7,2,0,0,0,0,1,0.714285714285714,1,0.714285714285714,0,"orthodox"
"27138",20,25,168,156,170,159,108,108,22,20,2,0,14,11,"win_A",-5,12,11,0,0,0,0,0,0.916666666666667,1,0.583333333333333,0.55,0,"orthodox"
"27243",29,42,173,175,173,180,156,154,21,31,4,12,13,18,"win_A",-13,-2,-7,2,0,1,0,0,0.84,0.720930232558139,0.52,0.418604651162791,0,"orthodox"
"27244",28,36,173,180,173,188,154,154,20,32,4,9,12,19,"win_A",-8,-7,-15,0,0,1,0,0,0.833333333333333,0.780487804878049,0.5,0.463414634146341,0,"orthodox"
"27271",23,26,178,178,178,178,130,130,13,12,1,4,8,4,"win_B",-3,0,0,0,0,0,0,0,0.928571428571429,0.75,0.571428571428571,0.25,1,"orthodox"
"27292",29,29,170,173,168,170,150,150,11,17,0,6,7,3,"win_A",0,-3,-2,0,0,0,0,0,1,0.739130434782609,0.636363636363636,0.130434782608696,0,"orthodox"
"27294",28,35,170,180,168,183,149,150,8,50,0,46,5,40,"win_A",-7,-10,-15,-1,0,1,0,0,1,0.520833333333333,0.625,0.416666666666667,0,"orthodox"
"27422",26,25,161,164,163,162,112,112,28,18,0,8,15,7,"win_B",1,-3,1,0,0,0,0,0,1,0.692307692307692,0.535714285714286,0.269230769230769,1,"southpaw"
"27424",32,24,161,164,168,162,112,112,46,17,1,7,20,6,"win_A",8,-3,6,0,0,0,0,0,0.978723404255319,0.708333333333333,0.425531914893617,0.25,0,"orthodox"
"27426",28,23,163,164,168,162,112,112,32,16,4,6,15,5,"win_A",5,-1,6,0,0,0,0,0,0.888888888888889,0.727272727272727,0.416666666666667,0.227272727272727,0,"orthodox"
"27436",24,20,168,164,170,162,112,112,5,10,1,2,2,2,"win_A",4,4,8,0,0,0,0,0,0.833333333333333,0.833333333333333,0.333333333333333,0.166666666666667,0,"orthodox"
"27480",33,29,166,164,164,168,115,115,31,51,1,4,25,39,"win_A",4,2,-4,0,0,0,0,0,0.96875,0.927272727272727,0.78125,0.709090909090909,0,"southpaw"
"27485",30,28,166,166,164,170,112,112,25,31,0,1,20,23,"win_A",2,0,-6,0,0,0,0,0,1,0.96875,0.8,0.71875,0,"southpaw"
"27493",27,32,166,165,164,173,112,112,17,48,0,4,13,28,"win_A",-5,1,-9,0,0,0,0,0,1,0.923076923076923,0.764705882352941,0.538461538461538,0,"southpaw"
"27529",26,23,179,185,180,193,140,141,10,18,0,0,10,12,"win_A",3,-6,-13,-1,0,0,0,0,1,1,1,0.666666666666667,0,"southpaw"
"27563",26,22,166,163,172,168,112,112,30,7,4,2,21,5,"win_A",4,3,4,0,0,0,0,0,0.882352941176471,0.777777777777778,0.617647058823529,0.555555555555556,0,"orthodox"
"27594",25,23,156,162,159,162,105,105,19,27,0,3,11,20,"win_A",2,-6,-3,0,0,0,0,0,1,0.9,0.578947368421053,0.666666666666667,0,"orthodox"
"27595",23,29,162,157,162,165,107,106,26,15,3,6,19,11,"win_A",-6,5,-3,1,0,0,0,0,0.896551724137931,0.714285714285714,0.655172413793103,0.523809523809524,0,"orthodox"
"27762",26,35,193,183,201,188,231,230,16,44,0,33,11,25,"win_A",-9,10,13,1,0,1,0,0,1,0.571428571428571,0.6875,0.324675324675325,0,"orthodox"
"27766",39,25,185,193,201,201,223,226,40,12,20,0,34,9,"win_B",14,-8,0,-3,1,0,0,0,0.666666666666667,1,0.566666666666667,0.75,1,"orthodox"
"27767",25,43,193,188,201,191,223,225,11,32,0,7,9,18,"win_A",-18,5,10,-2,0,1,0,0,1,0.82051282051282,0.818181818181818,0.461538461538462,0,"orthodox"
"27769",24,39,193,188,201,196,220,231,9,14,0,15,7,7,"win_A",-15,5,5,-11,0,1,0,0,1,0.482758620689655,0.777777777777778,0.241379310344828,0,"orthodox"
"27772",23,29,193,183,201,203,224,291,6,6,0,12,5,0,"win_A",-6,10,-2,-67,0,0,0,1,1,0.333333333333333,0.833333333333333,0,0,"orthodox"
"27787",17,23,175,170,180,180,136,132,9,5,0,2,5,2,"win_A",-6,5,0,4,0,0,0,0,1,0.714285714285714,0.555555555555556,0.285714285714286,0,"orthodox"
"27790",17,29,175,168,180,168,135,134,6,4,0,1,4,4,"win_A",-12,7,12,1,0,0,0,0,1,0.8,0.666666666666667,0.8,0,"orthodox"
"27966",21,39,183,178,185,185,161,163,9,17,0,12,9,4,"win_A",-18,5,0,-2,0,1,0,0,1,0.586206896551724,1,0.137931034482759,0,"Unknown"
"27969",21,36,183,175,185,183,161,160,6,12,0,14,6,6,"win_A",-15,8,2,1,0,1,0,0,1,0.461538461538462,1,0.230769230769231,0,"Unknown"
"28213",31,35,178,170,175,170,134,134,15,17,1,3,8,9,"win_A",-4,8,5,0,0,1,0,0,0.9375,0.85,0.5,0.45,0,"southpaw"
"28250",23,39,178,175,185,177,158,157,12,19,1,12,5,9,"win_A",-16,3,8,1,0,1,0,0,0.923076923076923,0.612903225806452,0.384615384615385,0.290322580645161,0,"orthodox"
"28256",20,26,178,183,185,196,158,158,6,7,0,13,3,7,"win_A",-6,-5,-11,0,0,0,0,0,1,0.35,0.5,0.35,0,"orthodox"
"28267",34,27,170,175,170,178,143,141,36,12,6,6,11,7,"win_A",7,-5,-8,2,0,0,0,0,0.857142857142857,0.666666666666667,0.261904761904762,0.388888888888889,0,"orthodox"
"28273",31,35,170,178,170,185,155,155,31,13,5,6,9,4,"win_A",-4,-8,-15,0,0,1,0,0,0.861111111111111,0.684210526315789,0.25,0.210526315789474,0,"orthodox"
"28331",20,30,170,170,170,173,118,118,19,26,2,4,17,21,"win_A",-10,0,-3,0,0,0,0,0,0.904761904761905,0.866666666666667,0.80952380952381,0.7,0,"orthodox"
"28336",28,27,157,170,163,173,115,115,21,24,7,1,12,19,"win_A",1,-13,-10,0,0,0,0,0,0.75,0.96,0.428571428571429,0.76,0,"orthodox"
"28379",30,27,173,168,178,188,159,160,10,18,0,7,6,11,"win_A",3,5,-10,-1,0,0,0,0,1,0.72,0.6,0.44,0,"orthodox"
"28385",25,25,173,173,178,173,158,161,4,7,0,9,4,4,"win_A",0,0,5,-3,0,0,0,0,1,0.4375,1,0.25,0,"orthodox"
"28408",31,27,178,170,173,165,143,143,26,25,6,4,16,21,"win_A",4,8,8,0,0,0,0,0,0.8125,0.862068965517241,0.5,0.724137931034483,0,"orthodox"
"28410",30,26,178,180,173,183,136,136,24,14,6,6,14,6,"win_A",4,-2,-10,0,0,0,0,0,0.8,0.7,0.466666666666667,0.3,0,"orthodox"
"28417",25,30,178,168,173,178,135,135,17,17,5,2,9,14,"win_A",-5,10,-5,0,0,0,0,0,0.772727272727273,0.894736842105263,0.409090909090909,0.736842105263158,0,"orthodox"
"28419",24,34,178,175,173,175,135,135,15,29,5,2,8,17,"win_A",-10,3,-2,0,0,0,0,0,0.75,0.935483870967742,0.4,0.548387096774194,0,"orthodox"
"28420",28,23,173,178,173,173,133,135,25,15,4,4,12,8,"win_A",5,-5,0,-2,0,0,0,0,0.862068965517241,0.789473684210526,0.413793103448276,0.421052631578947,0,"southpaw"
"28422",26,22,173,178,175,173,135,135,19,13,2,4,13,6,"win_B",4,-5,2,0,0,0,0,0,0.904761904761905,0.764705882352941,0.619047619047619,0.352941176470588,1,"orthodox"
"28544",24,33,175,168,178,174,147,147,27,26,3,9,20,15,"win_B",-9,7,4,0,0,0,0,0,0.9,0.742857142857143,0.666666666666667,0.428571428571429,1,"orthodox"
"28550",35,21,173,175,183,178,140,140,51,23,7,0,35,18,"win_A",14,-2,5,0,1,0,0,0,0.879310344827586,1,0.603448275862069,0.782608695652174,0,"orthodox"
"28553",21,20,175,178,178,185,130,130,20,17,0,3,15,15,"win_A",1,-3,-7,0,0,0,0,0,1,0.85,0.75,0.75,0,"orthodox"
"28663",25,26,175,178,175,180,130,130,19,17,4,2,5,8,"win_B",-1,-3,-5,0,0,0,0,0,0.826086956521739,0.894736842105263,0.217391304347826,0.421052631578947,1,"orthodox"
"28666",25,24,178,170,180,183,133,133,14,16,0,7,6,8,"win_A",1,8,-3,0,0,0,0,0,1,0.695652173913043,0.428571428571429,0.347826086956522,0,"orthodox"
"28696",28,22,183,183,194,191,160,160,5,8,2,0,3,6,"win_A",6,0,3,0,0,0,0,0,0.714285714285714,1,0.428571428571429,0.75,0,"Unknown"
"28785",21,28,183,179,180,178,154,154,10,14,0,4,8,7,"win_A",-7,4,2,0,0,0,0,0,1,0.777777777777778,0.8,0.388888888888889,0,"orthodox"
"28940",23,25,178,180,185,185,142,141,9,4,0,1,7,2,"win_A",-2,-2,0,1,0,0,0,0,1,0.8,0.777777777777778,0.4,0,"orthodox"
"28987",33,34,183,175,185,188,154,154,27,30,6,4,15,20,"win_A",-1,8,-3,0,0,0,0,0,0.818181818181818,0.882352941176471,0.454545454545455,0.588235294117647,0,"orthodox"
"28990",30,35,175,170,188,178,148,143,27,36,1,12,18,21,"win_A",-5,5,10,5,0,1,0,0,0.964285714285714,0.75,0.642857142857143,0.4375,0,"orthodox"
"28994",29,37,175,175,188,175,146,146,23,25,1,16,18,14,"win_A",-8,0,13,0,0,1,0,0,0.958333333333333,0.609756097560976,0.75,0.341463414634146,0,"orthodox"
"28995",28,34,175,180,188,183,150,149,22,39,1,35,17,34,"win_A",-6,-5,5,1,0,0,0,0,0.956521739130435,0.527027027027027,0.739130434782609,0.459459459459459,0,"orthodox"
"28996",28,33,175,175,188,180,147,148,21,30,1,6,17,17,"win_A",-5,0,8,-1,0,0,0,0,0.954545454545455,0.833333333333333,0.772727272727273,0.472222222222222,0,"orthodox"
"29002",24,30,175,173,188,180,150,152,15,22,0,21,14,10,"win_A",-6,2,8,-2,0,0,0,0,1,0.511627906976744,0.933333333333333,0.232558139534884,0,"orthodox"
"29003",24,22,175,178,188,178,150,149,14,10,0,3,14,2,"win_A",2,-3,10,1,0,0,0,0,1,0.769230769230769,1,0.153846153846154,0,"orthodox"
"29021",26,29,180,183,191,183,160,159,12,9,2,1,4,1,"win_A",-3,-3,8,1,0,0,0,0,0.857142857142857,0.9,0.285714285714286,0.1,0,"Unknown"
"29158",25,27,169,165,177,175,118,117,18,15,1,9,12,6,"win_A",-2,4,2,1,0,0,0,0,0.947368421052632,0.625,0.631578947368421,0.25,0,"orthodox"
"29223",42,30,180,188,188,193,193,193,54,14,8,5,40,2,"win_A",12,-8,-5,0,1,0,0,0,0.870967741935484,0.736842105263158,0.645161290322581,0.105263157894737,0,"Unknown"
"29224",45,41,185,180,191,188,175,175,50,54,5,6,32,40,"win_A",4,5,3,0,1,1,0,0,0.909090909090909,0.9,0.581818181818182,0.666666666666667,0,"orthodox"
"29226",40,32,180,179,188,188,174,172,53,25,5,2,39,17,"win_A",8,1,0,2,1,0,0,0,0.913793103448276,0.925925925925926,0.672413793103448,0.62962962962963,0,"Unknown"
"29230",38,29,180,180,188,183,175,175,50,21,4,0,38,14,"win_A",9,0,5,0,1,0,0,0,0.925925925925926,1,0.703703703703704,0.666666666666667,0,"Unknown"
"29232",36,36,188,180,191,188,173,175,23,49,3,3,18,38,"win_A",0,8,3,-2,1,1,0,0,0.884615384615385,0.942307692307692,0.692307692307692,0.730769230769231,0,"southpaw"
"29233",35,35,175,180,191,188,175,174,40,49,9,2,27,38,"win_A",0,-5,3,1,1,1,0,0,0.816326530612245,0.96078431372549,0.551020408163265,0.745098039215686,0,"orthodox"
"29234",35,35,188,180,191,188,174,175,21,49,2,1,17,38,"win_A",0,8,3,-1,1,1,0,0,0.91304347826087,0.98,0.739130434782609,0.76,0,"southpaw"
"29235",34,34,180,188,188,191,175,175,48,21,1,1,38,17,"win_A",0,-8,-3,0,0,0,0,0,0.979591836734694,0.954545454545455,0.775510204081633,0.772727272727273,0,"Unknown"
"29236",34,31,180,188,188,198,193,226,47,38,1,4,38,27,"win_A",3,-8,-10,-33,0,0,0,1,0.979166666666667,0.904761904761905,0.791666666666667,0.642857142857143,0,"Unknown"
"29240",32,31,180,185,188,198,174,175,43,20,1,1,35,10,"win_A",1,-5,-10,-1,0,0,0,0,0.977272727272727,0.952380952380952,0.795454545454545,0.476190476190476,0,"Unknown"
"29243",30,31,180,185,188,188,175,175,40,23,1,2,33,19,"win_A",-1,-5,0,0,0,0,0,0,0.975609756097561,0.92,0.804878048780488,0.76,0,"Unknown"
"29244",32,30,178,180,183,188,174,171,39,39,5,1,24,33,"win_B",2,-2,-5,3,0,0,0,0,0.886363636363636,0.975,0.545454545454545,0.825,1,"southpaw"
"29245",39,29,183,180,191,188,175,174,18,38,3,1,7,32,"win_B",10,3,3,1,1,0,0,0,0.857142857142857,0.974358974358974,0.333333333333333,0.82051282051282,1,"southpaw"
"29246",29,30,180,177,188,180,171,172,37,31,1,1,31,17,"win_A",-1,3,8,-1,0,0,0,0,0.973684210526316,0.96875,0.815789473684211,0.53125,0,"Unknown"
"29247",29,30,180,183,188,188,175,175,36,27,1,1,31,19,"win_A",-1,-3,0,0,0,0,0,0,0.972972972972973,0.964285714285714,0.837837837837838,0.678571428571429,0,"Unknown"
"29249",27,28,170,180,178,188,175,174,27,34,0,1,18,29,"win_B",-1,-10,-10,1,0,0,0,0,1,0.971428571428571,0.666666666666667,0.828571428571429,1,"orthodox"
"29250",26,28,170,180,178,188,175,175,26,34,0,0,18,29,"win_A",-2,-10,-10,0,0,0,0,0,1,1,0.692307692307692,0.852941176470588,0,"orthodox"
"29251",27,39,180,182,188,189,173,175,33,49,0,3,29,36,"win_A",-12,-2,-1,-2,0,1,0,0,1,0.942307692307692,0.878787878787879,0.692307692307692,0,"Unknown"
"29254",26,30,180,187,188,188,171,171,30,26,0,4,26,22,"win_A",-4,-7,0,0,0,0,0,0,1,0.866666666666667,0.866666666666667,0.733333333333333,0,"Unknown"
"29256",32,26,171,180,179,188,168,168,40,28,5,0,27,24,"win_B",6,-9,-9,0,0,0,0,0,0.888888888888889,1,0.6,0.857142857142857,1,"orthodox"
"29258",25,26,180,178,188,183,168,167,26,44,0,0,23,29,"win_A",-1,2,5,1,0,0,0,0,1,1,0.884615384615385,0.659090909090909,0,"Unknown"
"29269",22,32,180,179,188,185,158,155,15,48,0,9,15,40,"win_A",-10,1,3,3,0,0,0,0,1,0.842105263157895,1,0.701754385964912,0,"Unknown"
"29320",23,26,163,165,173,175,122,121,9,12,1,7,1,3,"win_A",-3,-2,-2,1,0,0,0,0,0.9,0.631578947368421,0.1,0.157894736842105,0,"southpaw"
"29324",22,21,168,163,175,173,118,120,9,5,0,1,4,0,"win_B",1,5,2,-2,0,0,0,0,1,0.833333333333333,0.444444444444444,0,1,"Unknown"
"29335",29,30,173,175,188,185,135,132,32,20,1,4,21,13,"win_A",-1,-2,3,3,0,0,0,0,0.96969696969697,0.833333333333333,0.636363636363636,0.541666666666667,0,"orthodox"
"29337",26,32,173,170,188,170,137,136,30,26,1,8,20,9,"win_A",-6,3,18,1,0,0,0,0,0.967741935483871,0.764705882352941,0.645161290322581,0.264705882352941,0,"orthodox"
"29338",24,31,173,170,188,180,137,137,29,16,0,7,19,12,"win_A",-7,3,8,0,0,0,0,0,1,0.695652173913043,0.655172413793103,0.521739130434783,0,"orthodox"
"29339",24,30,173,173,188,175,137,137,28,21,0,8,19,14,"win_A",-6,0,13,0,0,0,0,0,1,0.724137931034483,0.678571428571429,0.482758620689655,0,"orthodox"
"29340",23,34,173,170,188,180,136,136,27,53,0,14,19,36,"win_A",-11,3,8,0,0,0,0,0,1,0.791044776119403,0.703703703703704,0.537313432835821,0,"orthodox"
"29341",23,33,173,173,188,185,133,132,26,30,0,12,19,18,"win_A",-10,0,3,1,0,0,0,0,1,0.714285714285714,0.730769230769231,0.428571428571429,0,"orthodox"
"29344",22,23,173,173,188,178,138,136,23,25,0,28,17,6,"win_A",-1,0,10,2,0,0,0,0,1,0.471698113207547,0.739130434782609,0.113207547169811,0,"orthodox"
"29350",21,25,173,170,188,170,135,135,17,14,0,4,14,5,"win_A",-4,3,18,0,0,0,0,0,1,0.777777777777778,0.823529411764706,0.277777777777778,0,"orthodox"
"29351",21,24,173,173,188,173,136,138,16,13,0,0,13,6,"win_A",-3,0,15,-2,0,0,0,0,1,1,0.8125,0.461538461538462,0,"orthodox"
"29364",19,22,173,178,188,180,137,139,3,4,0,4,3,2,"win_A",-3,-5,8,-2,0,0,0,0,1,0.5,1,0.25,0,"orthodox"
"29470",25,39,177,175,183,183,167,168,17,26,0,102,11,18,"win_A",-14,2,0,-1,0,1,0,0,1,0.203125,0.647058823529412,0.140625,0,"Unknown"
"29756",21,33,175,168,173,180,136,140,4,5,1,3,4,2,"win_A",-12,7,-7,-4,0,0,0,0,0.8,0.625,0.8,0.25,0,"Unknown"
"29758",19,20,175,175,177,173,130,133,3,3,0,0,3,3,"win_A",-1,0,4,-3,0,0,0,0,1,1,1,1,0,"orthodox"
"29837",26,21,170,171,168,172,133,135,22,18,0,2,20,10,"win_A",5,-1,-4,-2,0,0,0,0,1,0.9,0.909090909090909,0.5,0,"orthodox"
"29840",20,23,171,168,172,178,134,135,16,17,1,9,10,7,"win_A",-3,3,-6,-1,0,0,0,0,0.941176470588235,0.653846153846154,0.588235294117647,0.269230769230769,0,"southpaw"
"29851",18,22,171,178,172,180,125,124,6,8,0,5,6,2,"win_A",-4,-7,-8,1,0,0,0,0,1,0.615384615384615,1,0.153846153846154,0,"southpaw"
"30110",28,37,178,173,183,175,136,135,25,28,3,14,21,18,"win_A",-9,5,8,1,0,1,0,0,0.892857142857143,0.666666666666667,0.75,0.428571428571429,0,"orthodox"
"30427",29,27,171,175,168,180,136,130,4,15,0,16,2,6,"win_A",2,-4,-12,6,0,0,0,0,1,0.483870967741935,0.5,0.193548387096774,0,"orthodox"
"30655",26,29,165,161,168,163,117,118,29,36,1,1,17,19,"win_A",-3,4,5,-1,0,0,0,0,0.966666666666667,0.972972972972973,0.566666666666667,0.513513513513513,0,"southpaw"
"30697",25,25,183,170,185,183,147,145,16,7,2,5,12,1,"win_A",0,13,2,2,0,0,0,0,0.888888888888889,0.583333333333333,0.666666666666667,0.0833333333333333,0,"Unknown"
"30700",21,25,178,183,173,185,147,146,9,13,0,1,4,11,"win_B",-4,-5,-12,1,0,0,0,0,1,0.928571428571429,0.444444444444444,0.785714285714286,1,"orthodox"
"30759",25,27,185,188,183,183,177,177,16,15,3,1,10,8,"win_A",-2,-3,0,0,0,0,0,0,0.842105263157895,0.9375,0.526315789473684,0.5,0,"southpaw"
"30841",28,37,178,173,183,175,136,135,25,28,3,14,21,18,"win_A",-9,5,8,1,0,1,0,0,0.892857142857143,0.666666666666667,0.75,0.428571428571429,0,"orthodox"
"31158",29,27,171,175,168,180,136,130,4,15,0,16,2,6,"win_A",2,-4,-12,6,0,0,0,0,1,0.483870967741935,0.5,0.193548387096774,0,"orthodox"
"31386",26,29,165,161,168,163,117,118,29,36,1,1,17,19,"win_A",-3,4,5,-1,0,0,0,0,0.966666666666667,0.972972972972973,0.566666666666667,0.513513513513513,0,"southpaw"
"31428",25,25,183,170,185,183,147,145,16,7,2,5,12,1,"win_A",0,13,2,2,0,0,0,0,0.888888888888889,0.583333333333333,0.666666666666667,0.0833333333333333,0,"Unknown"
"31431",21,25,178,183,173,185,147,146,9,13,0,1,4,11,"win_B",-4,-5,-12,1,0,0,0,0,1,0.928571428571429,0.444444444444444,0.785714285714286,1,"orthodox"
"31490",25,27,185,188,183,183,177,177,16,15,3,1,10,8,"win_A",-2,-3,0,0,0,0,0,0,0.842105263157895,0.9375,0.526315789473684,0.5,0,"southpaw"
"31683",30,31,158,162,159,170,105,105,26,17,6,5,10,2,"win_A",-1,-4,-11,0,0,0,0,0,0.8125,0.772727272727273,0.3125,0.0909090909090909,0,"orthodox"
"31834",26,24,177,173,177,175,138,140,23,16,0,6,20,11,"win_A",2,4,2,-2,0,0,0,0,1,0.727272727272727,0.869565217391304,0.5,0,"orthodox"
"31841",24,24,177,175,177,190,143,141,15,9,0,16,13,5,"win_A",0,2,-13,2,0,0,0,0,1,0.36,0.866666666666667,0.2,0,"orthodox"
"31895",28,29,173,173,174,170,135,136,26,11,3,10,8,7,"win_A",-1,0,4,-1,0,0,0,0,0.896551724137931,0.523809523809524,0.275862068965517,0.333333333333333,0,"orthodox"
"31896",27,28,173,173,174,170,133,136,25,10,2,5,7,6,"win_A",-1,0,4,-3,0,0,0,0,0.925925925925926,0.666666666666667,0.259259259259259,0.4,0,"orthodox"
"31898",26,30,173,165,174,170,129,129,24,27,1,17,7,13,"win_A",-4,8,4,0,0,0,0,0,0.96,0.613636363636364,0.28,0.295454545454545,0,"orthodox"
"31905",24,25,173,175,174,180,129,128,18,13,0,10,4,5,"win_A",-1,-2,-6,1,0,0,0,0,1,0.565217391304348,0.222222222222222,0.217391304347826,0,"orthodox"
"31908",23,26,173,160,174,170,127,129,15,5,0,3,3,1,"win_A",-3,13,4,-2,0,0,0,0,1,0.625,0.2,0.125,0,"orthodox"
"32082",22,25,180,178,180,170,148,148,12,10,0,2,10,5,"win_B",-3,2,10,0,0,0,0,0,1,0.833333333333333,0.833333333333333,0.416666666666667,1,"orthodox"
"32097",28,32,185,185,183,188,169,169,6,8,0,15,5,4,"win_A",-4,0,-5,0,0,0,0,0,1,0.347826086956522,0.833333333333333,0.173913043478261,0,"southpaw"
"32192",27,42,170,170,178,178,139,139,9,48,0,27,7,28,"win_A",-15,0,0,0,0,1,0,0,1,0.64,0.777777777777778,0.373333333333333,0,"Unknown"
"32196",25,26,170,168,178,170,144,142,5,1,0,9,3,1,"win_A",-1,2,8,2,0,0,0,0,1,0.1,0.6,0.1,0,"Unknown"
"32199",24,21,170,170,178,173,143,144,2,6,0,0,1,3,"win_A",3,0,5,-1,0,0,0,0,1,1,0.5,0.5,0,"Unknown"
"32336",22,23,178,175,183,178,157,158,7,10,0,2,6,4,"win_A",-1,3,5,-1,0,0,0,0,1,0.833333333333333,0.857142857142857,0.333333333333333,0,"southpaw"
"32488",20,25,178,175,183,178,149,149,10,12,0,1,6,7,"win_A",-5,3,5,0,0,0,0,0,1,0.923076923076923,0.6,0.538461538461538,0,"orthodox"
"32494",19,33,178,175,183,173,153,151,4,3,0,2,2,1,"win_A",-14,3,10,2,0,0,0,0,1,0.6,0.5,0.2,0,"orthodox"
"32561",28,28,173,175,173,175,149,146,24,11,0,7,13,4,"win_A",0,-2,-2,3,0,0,0,0,1,0.611111111111111,0.541666666666667,0.222222222222222,0,"orthodox"
"32563",27,24,173,173,173,183,149,149,22,5,0,10,12,0,"win_A",3,0,-10,0,0,0,0,0,1,0.333333333333333,0.545454545454545,0,0,"orthodox"
"32578",22,24,173,178,173,180,152,154,7,9,0,12,6,4,"win_A",-2,-5,-7,-2,0,0,0,0,1,0.428571428571429,0.857142857142857,0.19047619047619,0,"orthodox"
"32623",24,31,164,157,169,165,113,115,16,24,1,6,10,14,"win_A",-7,7,4,-2,0,0,0,0,0.941176470588235,0.8,0.588235294117647,0.466666666666667,0,"orthodox"
"32679",23,32,157,160,157,160,107,110,14,15,1,13,11,6,"win_A",-9,-3,-3,-3,0,0,0,0,0.933333333333333,0.535714285714286,0.733333333333333,0.214285714285714,0,"southpaw"
"32681",31,22,160,157,168,157,112,112,29,13,3,0,25,11,"win_A",9,3,11,0,0,0,0,0,0.90625,1,0.78125,0.846153846153846,0,"southpaw"
"32683",21,31,157,165,157,173,114,113,11,13,0,7,10,4,"win_A",-10,-8,-16,1,0,0,0,0,1,0.65,0.909090909090909,0.2,0,"southpaw"
"32691",20,23,157,160,157,168,114,113,3,4,0,3,3,1,"win_A",-3,-3,-11,1,0,0,0,0,1,0.571428571428571,1,0.142857142857143,0,"southpaw"
"32837",31,25,160,160,168,152,112,112,30,36,3,3,26,26,"win_A",6,0,16,0,0,0,0,0,0.909090909090909,0.923076923076923,0.787878787878788,0.666666666666667,0,"southpaw"
"32838",24,30,160,165,152,168,112,112,35,23,3,7,26,17,"win_A",-6,-5,-16,0,0,0,0,0,0.921052631578947,0.766666666666667,0.684210526315789,0.566666666666667,0,"southpaw"
"32841",23,24,160,165,152,168,112,115,32,25,2,2,25,5,"win_A",-1,-5,-16,-3,0,0,0,0,0.941176470588235,0.925925925925926,0.735294117647059,0.185185185185185,0,"southpaw"
"32844",22,31,160,163,152,168,114,114,27,27,2,23,20,15,"win_A",-9,-3,-16,0,0,0,0,0,0.931034482758621,0.54,0.689655172413793,0.3,0,"southpaw"
"32848",20,22,160,163,152,165,115,115,24,25,0,5,18,19,"win_A",-2,-3,-13,0,0,0,0,0,1,0.833333333333333,0.75,0.633333333333333,0,"southpaw"
"33013",26,29,178,175,178,180,149,148,26,23,1,11,20,15,"win_A",-3,3,-2,1,0,0,0,0,0.962962962962963,0.676470588235294,0.740740740740741,0.441176470588235,0,"orthodox"
"33015",25,35,178,175,178,184,150,150,24,13,0,9,19,13,"win_A",-10,3,-6,0,0,1,0,0,1,0.590909090909091,0.791666666666667,0.590909090909091,0,"orthodox"
"33024",23,32,178,173,178,178,152,153,15,23,0,8,11,15,"win_A",-9,5,0,-1,0,0,0,0,1,0.741935483870968,0.733333333333333,0.483870967741935,0,"orthodox"
"33033",21,33,178,175,178,175,157,158,6,4,0,7,4,2,"win_A",-12,3,3,-1,0,0,0,0,1,0.363636363636364,0.666666666666667,0.181818181818182,0,"orthodox"
"33054",23,29,183,185,184,180,175,171,8,1,1,0,6,0,"win_A",-6,-2,4,4,0,0,0,0,0.888888888888889,1,0.666666666666667,0,0,"southpaw"
"33057",21,28,183,169,184,171,165,166,5,5,0,2,3,4,"win_A",-7,14,13,-1,0,0,0,0,1,0.714285714285714,0.6,0.571428571428571,0,"southpaw"
"33058",18,21,188,183,190,184,167,170,2,4,1,0,1,2,"win_B",-3,5,6,-3,0,0,0,0,0.666666666666667,1,0.333333333333333,0.5,1,"orthodox"
"33060",24,21,181,183,185,184,168,137,1,2,0,0,0,1,"win_B",3,-2,1,31,0,0,1,0,1,1,0,0.5,1,"orthodox"
"33204",31,43,168,180,188,185,164,162,21,32,16,20,13,28,"win_A",-12,-12,3,2,0,1,0,0,0.567567567567568,0.615384615384615,0.351351351351351,0.538461538461538,0,"orthodox"
"33207",28,33,168,191,188,185,166,166,19,26,8,3,12,20,"win_A",-5,-23,3,0,0,0,0,0,0.703703703703704,0.896551724137931,0.444444444444444,0.689655172413793,0,"orthodox"
"33209",42,27,177,168,178,188,160,157,22,18,7,6,11,11,"win_A",15,9,-10,3,1,0,0,0,0.758620689655172,0.75,0.379310344827586,0.458333333333333,0,"orthodox"
"33210",30,27,180,168,187,188,160,159,23,18,5,5,11,11,"win_A",3,12,-1,1,0,0,0,0,0.821428571428571,0.782608695652174,0.392857142857143,0.478260869565217,0,"orthodox"
"33213",27,26,180,168,179,188,162,161,12,17,0,3,8,11,"win_A",1,12,-9,1,0,0,0,0,1,0.85,0.666666666666667,0.55,0,"southpaw"
"33216",25,31,168,170,188,178,160,160,14,19,3,2,9,12,"win_A",-6,-2,10,0,0,0,0,0,0.823529411764706,0.904761904761905,0.529411764705882,0.571428571428571,0,"orthodox"
"33221",23,38,168,175,188,180,163,160,8,6,2,22,5,3,"win_A",-15,-7,8,3,0,1,0,0,0.8,0.214285714285714,0.5,0.107142857142857,0,"orthodox"
"33224",22,22,183,168,180,188,161,161,9,6,0,1,5,5,"win_A",0,15,-8,0,0,0,0,0,1,0.857142857142857,0.555555555555556,0.714285714285714,0,"orthodox"
"33229",23,21,170,168,175,188,157,159,3,2,0,0,0,2,"win_A",2,2,-13,-2,0,0,0,0,1,1,0,1,0,"orthodox"
"33232",30,32,164,157,172,165,109,110,22,25,1,9,15,15,"win_A",-2,7,7,-1,0,0,0,0,0.956521739130435,0.735294117647059,0.652173913043478,0.441176470588235,0,"orthodox"
"33236",29,37,164,154,172,161,111,113,18,15,1,9,11,7,"win_A",-8,10,11,-2,0,1,0,0,0.947368421052632,0.625,0.578947368421053,0.291666666666667,0,"orthodox"
"33239",27,29,164,157,172,165,104,104,15,23,0,4,9,13,"win_A",-2,7,7,0,0,0,0,0,1,0.851851851851852,0.6,0.481481481481481,0,"orthodox"
"33240",27,28,164,152,172,168,105,105,14,23,0,11,9,6,"win_A",-1,12,4,0,0,0,0,0,1,0.676470588235294,0.642857142857143,0.176470588235294,0,"orthodox"
"33243",26,31,164,165,172,168,112,114,11,2,0,1,6,1,"win_A",-5,-1,4,-2,0,0,0,0,1,0.666666666666667,0.545454545454545,0.333333333333333,0,"orthodox"
"33273",31,42,191,196,193,203,239,240,30,23,1,5,22,22,"win_A",-11,-5,-10,-1,0,1,0,0,0.967741935483871,0.821428571428571,0.709677419354839,0.785714285714286,0,"orthodox"
"33274",30,39,191,185,193,201,234,224,29,41,1,21,21,35,"win_A",-9,6,-8,10,0,1,0,0,0.966666666666667,0.661290322580645,0.7,0.564516129032258,0,"orthodox"
"33283",25,37,191,175,193,175,223,238,20,27,1,14,16,18,"win_A",-12,16,18,-15,0,1,0,1,0.952380952380952,0.658536585365854,0.761904761904762,0.439024390243902,0,"orthodox"
"33289",23,37,191,180,193,185,221,235,15,26,0,18,12,14,"win_A",-14,11,8,-14,0,1,0,0,1,0.590909090909091,0.8,0.318181818181818,0,"orthodox"
"33290",23,45,191,180,193,191,224,230,14,19,0,23,11,15,"win_A",-22,11,2,-6,0,1,0,0,1,0.452380952380952,0.785714285714286,0.357142857142857,0,"orthodox"
"33325",31,21,170,180,170,190,126,126,29,17,2,2,18,7,"win_A",10,-10,-20,0,0,0,0,0,0.935483870967742,0.894736842105263,0.580645161290323,0.368421052631579,0,"orthodox"
"33330",20,29,180,170,190,168,126,126,12,6,2,15,6,4,"win_A",-9,10,22,0,0,0,0,0,0.857142857142857,0.285714285714286,0.428571428571429,0.19047619047619,0,"orthodox"
"33353",28,25,183,178,185,183,147,147,22,26,2,2,13,12,"win_A",3,5,2,0,0,0,0,0,0.916666666666667,0.928571428571429,0.541666666666667,0.428571428571429,0,"orthodox"
"33356",26,24,183,175,185,170,145,147,20,14,1,5,12,8,"win_B",2,8,15,-2,0,0,0,0,0.952380952380952,0.736842105263158,0.571428571428571,0.421052631578947,1,"orthodox"
"33362",25,32,183,183,185,188,148,149,14,19,1,10,7,13,"win_A",-7,0,-3,-1,0,0,0,0,0.933333333333333,0.655172413793103,0.466666666666667,0.448275862068966,0,"orthodox"
"33368",21,31,183,168,185,170,143,143,9,30,0,32,5,19,"win_A",-10,15,15,0,0,0,0,0,1,0.483870967741935,0.555555555555556,0.306451612903226,0,"orthodox"
"33369",21,26,183,173,185,183,145,147,8,5,0,5,5,3,"win_A",-5,10,2,-2,0,0,0,0,1,0.5,0.625,0.3,0,"orthodox"
"33507",27,37,178,183,178,183,239,208,17,9,4,1,10,4,"win_A",-10,-5,-5,31,0,1,1,0,0.80952380952381,0.9,0.476190476190476,0.4,0,"orthodox"
"33748",20,31,173,170,183,168,123,123,12,28,0,6,8,15,"win_A",-11,3,15,0,0,0,0,0,1,0.823529411764706,0.666666666666667,0.441176470588235,0,"orthodox"
"33750",20,30,173,165,183,178,123,128,10,10,0,4,7,5,"win_A",-10,8,5,-5,0,0,0,0,1,0.714285714285714,0.7,0.357142857142857,0,"orthodox"
"33832",33,24,180,173,185,185,157,157,16,14,2,2,2,8,"win_A",9,7,0,0,0,0,0,0,0.888888888888889,0.875,0.111111111111111,0.5,0,"southpaw"
"33837",22,26,173,173,185,178,154,149,9,26,0,43,5,6,"win_A",-4,0,7,5,0,0,0,0,1,0.376811594202899,0.555555555555556,0.0869565217391304,0,"southpaw"
"33945",25,40,183,165,191,173,140,140,21,41,8,21,18,25,"win_A",-15,18,18,0,0,1,0,0,0.724137931034483,0.661290322580645,0.620689655172414,0.403225806451613,0,"Unknown"
"34007",28,30,165,158,169,165,112,112,21,62,1,4,13,38,"win_A",-2,7,4,0,0,0,0,0,0.954545454545455,0.939393939393939,0.590909090909091,0.575757575757576,0,"orthodox"
"34099",28,23,165,165,175,175,121,120,25,15,2,2,17,9,"win_A",5,0,0,1,0,0,0,0,0.925925925925926,0.882352941176471,0.62962962962963,0.529411764705882,0,"southpaw"
"34103",26,43,165,165,175,170,121,118,21,38,1,12,15,34,"win_A",-17,0,5,3,0,1,0,0,0.954545454545455,0.76,0.681818181818182,0.68,0,"southpaw"
"34104",25,32,165,163,175,170,120,120,20,12,1,4,15,4,"win_A",-7,2,5,0,0,0,0,0,0.952380952380952,0.75,0.714285714285714,0.25,0,"southpaw"
"34106",24,38,165,165,175,157,115,115,18,39,0,8,14,32,"win_A",-14,0,18,0,0,1,0,0,1,0.829787234042553,0.777777777777778,0.680851063829787,0,"southpaw"
"34107",23,37,165,152,175,165,114,116,17,40,0,6,13,30,"win_A",-14,13,10,-2,0,1,0,0,1,0.869565217391304,0.764705882352941,0.652173913043478,0,"southpaw"
"34109",23,31,165,157,175,157,112,111,15,27,0,8,11,18,"win_A",-8,8,18,1,0,0,0,0,1,0.771428571428571,0.733333333333333,0.514285714285714,0,"southpaw"
"34110",22,30,165,168,175,178,110,110,14,23,0,4,10,16,"win_A",-8,-3,-3,0,0,0,0,0,1,0.851851851851852,0.714285714285714,0.592592592592593,0,"southpaw"
"34111",22,37,165,160,175,168,110,111,13,27,0,12,9,18,"win_A",-15,5,7,-1,0,1,0,0,1,0.692307692307692,0.692307692307692,0.461538461538462,0,"southpaw"
"34230",27,32,175,179,177,170,130,130,24,32,1,6,16,16,"win_A",-5,-4,7,0,0,0,0,0,0.96,0.842105263157895,0.64,0.421052631578947,0,"orthodox"
"34232",25,28,175,170,177,188,140,140,21,28,1,5,15,16,"win_A",-3,5,-11,0,0,0,0,0,0.954545454545455,0.848484848484849,0.681818181818182,0.484848484848485,0,"orthodox"
"34233",30,25,172,175,182,177,130,130,13,21,0,0,10,15,"win_A",5,-3,5,0,0,0,0,0,1,1,0.769230769230769,0.714285714285714,0,"orthodox"
"34236",22,27,175,175,177,178,131,131,17,25,0,6,13,21,"win_A",-5,0,-1,0,0,0,0,0,1,0.806451612903226,0.764705882352941,0.67741935483871,0,"orthodox"
"34237",21,32,175,168,177,170,123,125,16,24,0,8,13,9,"win_A",-11,7,7,-2,0,0,0,0,1,0.75,0.8125,0.28125,0,"orthodox"
"34567",27,26,178,178,199,178,156,156,24,27,1,7,18,14,"win_A",1,0,21,0,0,0,0,0,0.96,0.794117647058823,0.72,0.411764705882353,0,"Unknown"
"34627",24,33,170,172,178,180,147,147,32,22,4,5,19,17,"win_A",-9,-2,-2,0,0,0,0,0,0.888888888888889,0.814814814814815,0.527777777777778,0.62962962962963,0,"orthodox"
"34630",23,23,170,175,178,180,147,147,27,13,4,3,17,5,"win_A",0,-5,-2,0,0,0,0,0,0.870967741935484,0.8125,0.548387096774194,0.3125,0,"orthodox"
"34632",37,23,171,170,175,178,147,147,62,26,10,3,53,17,"win_B",14,1,-3,0,1,0,0,0,0.861111111111111,0.896551724137931,0.736111111111111,0.586206896551724,1,"orthodox"
"34641",20,31,170,173,178,185,138,139,19,18,1,17,11,10,"win_A",-11,-3,-7,-1,0,0,0,0,0.95,0.514285714285714,0.55,0.285714285714286,0,"orthodox"
"34643",19,26,170,170,178,173,145,141,17,12,1,5,10,9,"win_A",-7,0,5,4,0,0,0,0,0.944444444444444,0.705882352941177,0.555555555555556,0.529411764705882,0,"orthodox"
"34651",18,25,170,165,178,168,141,139,10,6,0,2,7,5,"win_A",-7,5,10,2,0,0,0,0,1,0.75,0.7,0.625,0,"orthodox"
"34656",18,30,170,175,178,178,137,139,5,2,0,3,5,2,"win_A",-12,-5,0,-2,0,0,0,0,1,0.4,1,0.4,0,"orthodox"
"34778",30,33,188,185,203,201,200,199,23,29,0,7,14,25,"win_A",-3,3,2,1,0,0,0,0,1,0.805555555555556,0.608695652173913,0.694444444444444,0,"orthodox"
"34781",29,33,188,178,203,191,200,200,20,22,0,5,13,19,"win_A",-4,10,12,0,0,0,0,0,1,0.814814814814815,0.65,0.703703703703704,0,"orthodox"
"34788",26,29,188,183,203,186,215,208,13,19,0,18,9,11,"win_A",-3,5,17,7,0,0,0,0,1,0.513513513513513,0.692307692307692,0.297297297297297,0,"orthodox"
"34798",24,31,188,185,203,180,206,199,3,2,0,0,2,1,"win_A",-7,3,23,7,0,0,0,0,1,1,0.666666666666667,0.5,0,"orthodox"
"35002",20,27,183,183,185,193,146,147,6,6,0,1,5,2,"win_A",-7,0,-8,-1,0,0,0,0,1,0.857142857142857,0.833333333333333,0.285714285714286,0,"orthodox"
"35031",27,35,175,168,184,175,147,147,26,48,4,3,24,27,"win_A",-8,7,9,0,0,1,0,0,0.866666666666667,0.941176470588235,0.8,0.529411764705882,0,"southpaw"
"35349",20,26,170,171,188,163,150,152,11,10,0,0,8,6,"win_A",-6,-1,25,-2,0,0,0,0,1,1,0.727272727272727,0.6,0,"orthodox"
"35352",19,35,170,175,188,175,154,154,8,11,0,8,6,4,"win_A",-16,-5,13,0,0,1,0,0,1,0.578947368421053,0.75,0.210526315789474,0,"orthodox"
"35354",19,33,170,178,188,193,154,154,6,6,0,1,5,4,"win_A",-14,-8,-5,0,0,0,0,0,1,0.857142857142857,0.833333333333333,0.571428571428571,0,"orthodox"
"35432",26,32,173,168,170,170,149,148,5,4,0,6,5,1,"win_A",-6,5,0,1,0,0,0,0,1,0.4,1,0.1,0,"southpaw"
"35923",31,24,165,164,165,165,120,120,25,16,2,4,20,3,"win_A",7,1,0,0,0,0,0,0,0.925925925925926,0.8,0.740740740740741,0.15,0,"orthodox"
"35925",30,29,165,160,165,160,120,119,23,18,1,5,18,10,"win_A",1,5,5,1,0,0,0,0,0.958333333333333,0.782608695652174,0.75,0.434782608695652,0,"orthodox"
"35929",28,22,165,160,165,171,115,115,20,17,0,2,16,12,"win_B",6,5,-6,0,0,0,0,0,1,0.894736842105263,0.8,0.631578947368421,1,"orthodox"
"35931",26,26,165,163,165,165,115,115,17,27,0,3,13,20,"win_A",0,2,0,0,0,0,0,0,1,0.9,0.764705882352941,0.666666666666667,0,"orthodox"
"35944",23,22,165,165,165,155,113,112,4,3,0,0,2,1,"win_A",1,0,10,1,0,0,0,0,1,1,0.5,0.333333333333333,0,"orthodox"
"36087",30,31,184,171,193,184,166,172,19,19,2,17,9,8,"win_A",-1,13,9,-6,0,0,0,0,0.904761904761905,0.527777777777778,0.428571428571429,0.222222222222222,0,"orthodox"
"36090",30,29,180,171,185,184,158,153,14,16,1,13,2,6,"win_A",1,9,1,5,0,0,0,0,0.933333333333333,0.551724137931034,0.133333333333333,0.206896551724138,0,"southpaw"
"36096",22,26,178,171,180,184,161,161,19,13,1,7,11,5,"win_A",-4,7,-4,0,0,0,0,0,0.95,0.65,0.55,0.25,0,"southpaw"
"36102",24,26,180,171,188,184,157,157,20,10,1,4,15,4,"win_A",-2,9,4,0,0,0,0,0,0.952380952380952,0.714285714285714,0.714285714285714,0.285714285714286,0,"orthodox"
"36118",32,22,171,168,170,170,135,141,9,8,8,0,6,6,"win_B",10,3,0,-6,0,0,0,0,0.529411764705882,1,0.352941176470588,0.75,1,"southpaw"
"36119",21,29,168,175,170,177,132,134,7,5,0,1,6,4,"win_A",-8,-7,-7,-2,0,0,0,0,1,0.833333333333333,0.857142857142857,0.666666666666667,0,"southpaw"
"36121",17,21,172,168,176,170,133,133,1,5,0,0,0,5,"win_B",-4,4,6,0,0,0,0,0,1,1,0,1,1,"Unknown"
"36130",24,29,175,174,175,179,130,130,17,19,1,4,5,14,"win_A",-5,1,-4,0,0,0,0,0,0.944444444444444,0.826086956521739,0.277777777777778,0.608695652173913,0,"orthodox"
"36131",34,28,163,174,165,179,122,122,36,19,7,3,26,14,"win_A",6,-11,-14,0,0,0,0,0,0.837209302325581,0.863636363636364,0.604651162790698,0.636363636363636,0,"southpaw"
"36229",31,27,168,170,175,183,133,133,22,23,1,4,12,14,"win_A",4,-2,-8,0,0,0,0,0,0.956521739130435,0.851851851851852,0.521739130434783,0.518518518518518,0,"orthodox"
"36234",29,30,168,178,175,185,132,132,18,15,0,6,8,7,"win_A",-1,-10,-10,0,0,0,0,0,1,0.714285714285714,0.444444444444444,0.333333333333333,0,"orthodox"
"36241",25,26,168,172,175,178,131,131,11,8,0,0,5,7,"win_A",-1,-4,-3,0,0,0,0,0,1,1,0.454545454545455,0.875,0,"orthodox"
"36421",33,18,158,162,159,167,105,105,30,10,8,1,12,5,"win_A",15,-4,-8,0,0,0,0,0,0.789473684210526,0.909090909090909,0.315789473684211,0.454545454545455,0,"orthodox"
"36872",31,24,165,164,165,165,120,120,25,16,2,4,20,3,"win_A",7,1,0,0,0,0,0,0,0.925925925925926,0.8,0.740740740740741,0.15,0,"orthodox"
"36874",30,29,165,160,165,160,120,119,23,18,1,5,18,10,"win_A",1,5,5,1,0,0,0,0,0.958333333333333,0.782608695652174,0.75,0.434782608695652,0,"orthodox"
"36878",28,22,165,160,165,171,115,115,20,17,0,2,16,12,"win_B",6,5,-6,0,0,0,0,0,1,0.894736842105263,0.8,0.631578947368421,1,"orthodox"
"36880",26,26,165,163,165,165,115,115,17,27,0,3,13,20,"win_A",0,2,0,0,0,0,0,0,1,0.9,0.764705882352941,0.666666666666667,0,"orthodox"
"36893",23,22,165,165,165,155,113,112,4,3,0,0,2,1,"win_A",1,0,10,1,0,0,0,0,1,1,0.5,0.333333333333333,0,"orthodox"
"37036",30,31,184,171,193,184,166,172,19,19,2,17,9,8,"win_A",-1,13,9,-6,0,0,0,0,0.904761904761905,0.527777777777778,0.428571428571429,0.222222222222222,0,"orthodox"
"37039",30,29,180,171,185,184,158,153,14,16,1,13,2,6,"win_A",1,9,1,5,0,0,0,0,0.933333333333333,0.551724137931034,0.133333333333333,0.206896551724138,0,"southpaw"
"37045",22,26,178,171,180,184,161,161,19,13,1,7,11,5,"win_A",-4,7,-4,0,0,0,0,0,0.95,0.65,0.55,0.25,0,"southpaw"
"37051",24,26,180,171,188,184,157,157,20,10,1,4,15,4,"win_A",-2,9,4,0,0,0,0,0,0.952380952380952,0.714285714285714,0.714285714285714,0.285714285714286,0,"orthodox"
"37067",32,22,171,168,170,170,135,141,9,8,8,0,6,6,"win_B",10,3,0,-6,0,0,0,0,0.529411764705882,1,0.352941176470588,0.75,1,"southpaw"
"37068",21,29,168,175,170,177,132,134,7,5,0,1,6,4,"win_A",-8,-7,-7,-2,0,0,0,0,1,0.833333333333333,0.857142857142857,0.666666666666667,0,"southpaw"
"37070",17,21,172,168,176,170,133,133,1,5,0,0,0,5,"win_B",-4,4,6,0,0,0,0,0,1,1,0,1,1,"Unknown"
"37079",24,29,175,174,175,179,130,130,17,19,1,4,5,14,"win_A",-5,1,-4,0,0,0,0,0,0.944444444444444,0.826086956521739,0.277777777777778,0.608695652173913,0,"orthodox"
"37080",34,28,163,174,165,179,122,122,36,19,7,3,26,14,"win_A",6,-11,-14,0,0,0,0,0,0.837209302325581,0.863636363636364,0.604651162790698,0.636363636363636,0,"southpaw"
"37178",31,27,168,170,175,183,133,133,22,23,1,4,12,14,"win_A",4,-2,-8,0,0,0,0,0,0.956521739130435,0.851851851851852,0.521739130434783,0.518518518518518,0,"orthodox"
"37183",29,30,168,178,175,185,132,132,18,15,0,6,8,7,"win_A",-1,-10,-10,0,0,0,0,0,1,0.714285714285714,0.444444444444444,0.333333333333333,0,"orthodox"
"37190",25,26,168,172,175,178,131,131,11,8,0,0,5,7,"win_A",-1,-4,-3,0,0,0,0,0,1,1,0.454545454545455,0.875,0,"orthodox"
"37370",33,18,158,162,159,167,105,105,30,10,8,1,12,5,"win_A",15,-4,-8,0,0,0,0,0,0.789473684210526,0.909090909090909,0.315789473684211,0.454545454545455,0,"orthodox"
"37392",20,24,172,170,173,173,131,135,7,15,1,8,2,6,"win_A",-4,2,0,-4,0,0,0,0,0.875,0.652173913043478,0.25,0.260869565217391,0,"orthodox"
"37395",20,29,170,178,173,185,127,127,12,12,3,2,5,9,"win_A",-9,-8,-12,0,0,0,0,0,0.8,0.857142857142857,0.333333333333333,0.642857142857143,0,"orthodox"
"37540",23,26,174,175,174,183,129,130,27,19,1,0,19,15,"win_A",-3,-1,-9,-1,0,0,0,0,0.964285714285714,1,0.678571428571429,0.789473684210526,0,"orthodox"
"37542",23,35,174,169,174,168,128,124,25,27,1,7,18,14,"win_A",-12,5,6,4,0,1,0,0,0.961538461538462,0.794117647058823,0.692307692307692,0.411764705882353,0,"orthodox"
"37544",22,30,174,168,174,175,125,125,24,38,0,7,17,25,"win_A",-8,6,-1,0,0,0,0,0,1,0.844444444444444,0.708333333333333,0.555555555555556,0,"orthodox"
"37548",20,35,174,168,174,173,127,127,19,25,0,21,14,14,"win_A",-15,6,1,0,0,1,0,0,1,0.543478260869565,0.736842105263158,0.304347826086957,0,"orthodox"
"37553",24,19,168,174,183,174,126,125,19,14,2,0,8,12,"win_B",5,-6,9,1,0,0,0,0,0.904761904761905,1,0.380952380952381,0.857142857142857,1,"orthodox"
"37555",18,20,174,168,174,173,126,126,12,17,0,6,11,9,"win_A",-2,6,1,0,0,0,0,0,1,0.739130434782609,0.916666666666667,0.391304347826087,0,"orthodox"
"37716",42,38,170,180,178,188,145,143,48,32,28,11,28,19,"win_A",4,-10,-10,2,1,1,0,0,0.631578947368421,0.744186046511628,0.368421052631579,0.441860465116279,0,"southpaw"
"37725",40,35,170,170,178,170,133,135,41,28,22,18,25,11,"win_A",5,0,8,-2,1,1,0,0,0.650793650793651,0.608695652173913,0.396825396825397,0.239130434782609,0,"southpaw"
"37727",26,39,166,170,165,178,140,140,17,40,2,21,9,24,"win_A",-13,-4,-13,0,0,1,0,0,0.894736842105263,0.655737704918033,0.473684210526316,0.39344262295082,0,"orthodox"
"37730",32,37,174,170,178,178,138,141,23,38,1,19,12,22,"win_B",-5,4,0,-3,0,1,0,0,0.958333333333333,0.666666666666667,0.5,0.385964912280702,1,"southpaw"
"37731",37,30,170,171,178,175,137,140,37,18,19,0,22,3,"win_A",7,-1,3,-3,1,0,0,0,0.660714285714286,1,0.392857142857143,0.166666666666667,0,"southpaw"
"37740",34,31,170,170,178,193,139,140,33,12,11,3,19,7,"win_A",3,0,-15,-1,0,0,0,0,0.75,0.8,0.431818181818182,0.466666666666667,0,"southpaw"
"37750",24,30,170,170,170,178,137,140,22,29,0,3,18,16,"win_A",-6,0,-8,-3,0,0,0,0,1,0.90625,0.818181818181818,0.5,0,"orthodox"
"37752",27,29,173,170,183,178,140,140,31,28,0,2,21,16,"win_A",-2,3,5,0,0,0,0,0,1,0.933333333333333,0.67741935483871,0.533333333333333,0,"orthodox"
"37753",28,28,170,175,178,178,139,140,27,26,1,2,16,26,"win_A",0,-5,0,-1,0,0,0,0,0.964285714285714,0.928571428571429,0.571428571428571,0.928571428571429,0,"southpaw"
"37754",27,28,170,178,178,193,140,140,26,23,1,3,16,17,"win_A",-1,-8,-15,0,0,0,0,0,0.962962962962963,0.884615384615385,0.592592592592593,0.653846153846154,0,"southpaw"
"37755",27,25,170,170,178,178,140,140,25,17,1,2,15,11,"win_A",2,0,0,0,0,0,0,0,0.961538461538462,0.894736842105263,0.576923076923077,0.578947368421053,0,"southpaw"
"37756",26,30,170,175,178,180,142,143,24,12,1,7,15,9,"win_A",-4,-5,-2,-1,0,0,0,0,0.96,0.631578947368421,0.6,0.473684210526316,0,"southpaw"
"37761",25,25,170,178,178,193,140,142,19,21,1,2,11,17,"win_A",0,-8,-15,-2,0,0,0,0,0.95,0.91304347826087,0.55,0.739130434782609,0,"southpaw"
"37764",26,24,175,170,173,178,141,141,13,17,7,0,5,10,"win_A",2,5,-5,0,0,0,0,0,0.65,1,0.25,0.588235294117647,0,"Unknown"
"37767",24,26,170,170,178,178,143,139,14,7,0,6,8,4,"win_A",-2,0,0,4,0,0,0,0,1,0.538461538461538,0.571428571428571,0.307692307692308,0,"southpaw"
"37931",21,17,173,165,183,163,112,112,12,2,2,4,7,0,"win_A",4,8,20,0,0,0,0,0,0.857142857142857,0.333333333333333,0.5,0,0,"orthodox"
"37947",44,34,193,173,193,184,239,205,39,16,3,10,30,9,"win_A",10,20,9,34,1,0,1,0,0.928571428571429,0.615384615384615,0.714285714285714,0.346153846153846,0,"orthodox"
"37952",34,32,193,179,193,183,213,227,33,21,3,12,26,18,"win_A",2,14,10,-14,0,0,0,0,0.916666666666667,0.636363636363636,0.722222222222222,0.545454545454545,0,"orthodox"
"37960",28,34,193,177,193,185,164,164,25,11,2,6,21,9,"win_A",-6,16,8,0,0,0,0,0,0.925925925925926,0.647058823529412,0.777777777777778,0.529411764705882,0,"orthodox"
"38101",21,31,168,166,171,175,115,115,19,28,2,17,9,15,"win_A",-10,2,-4,0,0,0,0,0,0.904761904761905,0.622222222222222,0.428571428571429,0.333333333333333,0,"orthodox"
"38251",24,31,173,175,177,172,128,128,15,24,0,2,7,10,"win_A",-7,-2,5,0,0,0,0,0,1,0.923076923076923,0.466666666666667,0.384615384615385,0,"orthodox"
"38262",21,30,173,175,177,165,139,139,4,1,0,8,2,0,"win_A",-9,-2,12,0,0,0,0,0,1,0.111111111111111,0.5,0,0,"orthodox"
"38290",22,37,173,163,185,163,131,138,18,31,0,18,12,22,"win_A",-15,10,22,-7,0,1,0,0,1,0.63265306122449,0.666666666666667,0.448979591836735,0,"orthodox"
"38569",33,33,180,178,184,180,154,154,15,20,1,4,9,13,"win_A",0,2,4,0,0,0,0,0,0.9375,0.833333333333333,0.5625,0.541666666666667,0,"southpaw"
"38577",27,31,178,182,180,185,154,154,15,18,0,2,12,12,"win_A",-4,-4,-5,0,0,0,0,0,1,0.9,0.8,0.6,0,"orthodox"
"38701",24,46,172,165,174,173,151,154,13,2,1,0,7,0,"win_A",-22,7,1,-3,0,1,0,0,0.928571428571429,1,0.5,0,0,"orthodox"
"38707",21,26,172,175,174,180,135,133,8,15,0,14,5,6,"win_A",-5,-3,-6,2,0,0,0,0,1,0.517241379310345,0.625,0.206896551724138,0,"orthodox"
"38708",21,32,172,161,174,159,132,126,7,2,0,13,4,1,"win_A",-11,11,15,6,0,0,0,0,1,0.133333333333333,0.571428571428571,0.0666666666666667,0,"orthodox"
"38809",23,28,178,175,185,173,141,141,17,37,3,10,15,22,"win_A",-5,3,12,0,0,0,0,0,0.85,0.787234042553192,0.75,0.468085106382979,0,"orthodox"
"38810",25,23,175,178,175,185,147,147,30,16,4,3,21,15,"win_B",2,-3,-10,0,0,0,0,0,0.882352941176471,0.842105263157895,0.617647058823529,0.789473684210526,1,"southpaw"
"38847",20,25,175,170,177,177,135,135,7,7,0,8,4,6,"win_A",-5,5,0,0,0,0,0,0,1,0.466666666666667,0.571428571428571,0.4,0,"orthodox"
"38884",26,33,170,159,172,173,123,121,10,32,0,23,3,18,"win_A",-7,11,-1,2,0,0,0,0,1,0.581818181818182,0.3,0.327272727272727,0,"southpaw"
"38885",26,23,170,172,172,172,126,124,9,6,0,1,2,1,"win_A",3,-2,0,2,0,0,0,0,1,0.857142857142857,0.222222222222222,0.142857142857143,0,"southpaw"
"38886",25,24,170,170,172,170,121,121,8,8,0,0,2,2,"win_A",1,0,2,0,0,0,0,0,1,1,0.25,0.25,0,"southpaw"
"38887",25,23,170,162,172,165,121,122,7,2,0,3,2,1,"win_A",2,8,7,-1,0,0,0,0,1,0.4,0.285714285714286,0.2,0,"southpaw"
"38890",24,20,170,168,172,168,122,122,4,0,0,1,1,0,"win_A",4,2,4,0,0,0,0,0,1,0,0.25,0,0,"southpaw"
"38891",20,24,168,170,169,172,121,124,0,3,1,0,0,0,"win_B",-4,-2,-3,-3,0,0,0,0,0,1,0,0,1,"orthodox"
"39032",40,32,188,191,203,194,239,226,35,28,7,6,23,14,"win_A",8,-3,9,13,1,0,0,0,0.833333333333333,0.823529411764706,0.547619047619048,0.411764705882353,0,"orthodox"
"39033",33,32,194,191,208,194,236,249,39,26,8,5,31,14,"win_B",1,3,14,-13,0,0,0,0,0.829787234042553,0.838709677419355,0.659574468085106,0.451612903225806,1,"orthodox"
"39035",41,32,197,191,218,194,236,237,30,28,6,5,21,14,"win_A",9,6,24,-1,1,0,0,0,0.833333333333333,0.848484848484849,0.583333333333333,0.424242424242424,0,"southpaw"
"39046",27,46,191,185,194,196,232,258,17,35,1,6,10,26,"win_A",-19,6,-2,-26,0,1,0,1,0.944444444444444,0.853658536585366,0.555555555555556,0.634146341463415,0,"orthodox"
"39049",24,26,185,191,191,194,248,215,27,15,0,0,15,9,"win_A",-2,-6,-3,33,0,0,1,0,1,1,0.555555555555556,0.6,0,"orthodox"
"39050",26,40,191,178,194,183,250,226,14,15,0,3,8,6,"win_A",-14,13,11,24,0,1,1,0,1,0.833333333333333,0.571428571428571,0.333333333333333,0,"orthodox"
"39053",26,21,191,180,194,188,248,262,11,9,0,13,7,7,"win_A",5,11,6,-14,0,0,0,0,1,0.409090909090909,0.636363636363636,0.318181818181818,0,"orthodox"
"39448",30,25,179,175,182,176,139,138,6,7,0,0,1,6,"win_B",5,4,6,1,0,0,0,0,1,1,0.166666666666667,0.857142857142857,1,"southpaw"
"39449",24,33,175,171,176,170,140,141,6,9,0,9,5,6,"win_A",-9,4,6,-1,0,0,0,0,1,0.5,0.833333333333333,0.333333333333333,0,"orthodox"
"39450",24,22,175,175,176,178,139,139,5,3,0,1,5,0,"win_A",2,0,-2,0,0,0,0,0,1,0.75,1,0,0,"orthodox"
"40037",21,22,173,173,188,183,148,139,3,2,0,11,2,0,"win_A",-1,0,5,9,0,0,0,0,1,0.153846153846154,0.666666666666667,0,0,"southpaw"
"40091",27,24,170,171,172,173,142,145,4,1,0,1,2,1,"win_A",3,-1,-1,-3,0,0,0,0,1,0.5,0.5,0.5,0,"orthodox"
"40134",27,24,170,171,172,173,142,145,4,1,0,1,2,1,"win_A",3,-1,-1,-3,0,0,0,0,1,0.5,0.5,0.5,0,"orthodox"
"40188",21,33,168,168,170,175,139,139,4,9,0,10,3,3,"win_A",-12,0,-5,0,0,0,0,0,1,0.473684210526316,0.75,0.157894736842105,0,"southpaw"
"40284",26,38,173,173,178,175,138,138,14,28,1,15,10,18,"win_A",-12,0,3,0,0,1,0,0,0.933333333333333,0.651162790697674,0.666666666666667,0.418604651162791,0,"Unknown"
"40365",28,26,178,175,188,175,149,149,33,24,3,8,22,16,"win_A",2,3,13,0,0,0,0,0,0.916666666666667,0.75,0.611111111111111,0.5,0,"orthodox"
"40375",24,25,178,170,188,173,148,149,23,15,3,0,14,8,"win_A",-1,8,15,-1,0,0,0,0,0.884615384615385,1,0.538461538461538,0.533333333333333,0,"orthodox"
"40383",22,25,178,178,188,180,155,149,15,9,2,19,9,4,"win_A",-3,0,8,6,0,0,0,0,0.882352941176471,0.321428571428571,0.529411764705882,0.142857142857143,0,"orthodox"
"40388",21,30,178,170,188,180,150,149,11,9,1,4,7,6,"win_B",-9,8,8,1,0,0,0,0,0.916666666666667,0.692307692307692,0.583333333333333,0.461538461538462,1,"orthodox"
"40422",26,35,170,173,173,183,154,154,17,30,1,9,10,17,"win_A",-9,-3,-10,0,0,1,0,0,0.944444444444444,0.769230769230769,0.555555555555556,0.435897435897436,0,"southpaw"
"40430",23,29,170,178,173,185,149,149,9,12,0,3,3,7,"win_A",-6,-8,-12,0,0,0,0,0,1,0.8,0.333333333333333,0.466666666666667,0,"southpaw"
"40436",22,37,170,180,173,183,152,156,3,2,0,3,1,1,"win_A",-15,-10,-10,-4,0,1,0,0,1,0.4,0.333333333333333,0.2,0,"southpaw"
"40627",36,23,163,170,169,175,126,126,53,19,4,2,39,14,"win_A",13,-7,-6,0,1,0,0,0,0.929824561403509,0.904761904761905,0.684210526315789,0.666666666666667,0,"orthodox"
"40805",25,23,165,173,164,185,123,124,30,10,2,0,21,9,"win_A",2,-8,-21,-1,0,0,0,0,0.9375,1,0.65625,0.9,0,"southpaw"
"40863",24,23,183,202,198,201,223,255,13,10,0,1,11,7,"win_B",1,-19,-3,-32,0,0,0,1,1,0.909090909090909,0.846153846153846,0.636363636363636,1,"orthodox"
"40868",23,32,183,183,198,180,219,227,8,6,0,1,7,4,"win_A",-9,0,18,-8,0,0,0,0,1,0.857142857142857,0.875,0.571428571428571,0,"orthodox"
"41066",28,33,185,175,180,174,135,135,22,17,0,7,13,11,"win_A",-5,10,6,0,0,0,0,0,1,0.708333333333333,0.590909090909091,0.458333333333333,0,"orthodox"
"41073",23,29,185,168,180,170,135,135,15,18,0,3,9,11,"win_A",-6,17,10,0,0,0,0,0,1,0.857142857142857,0.6,0.523809523809524,0,"orthodox"
"41077",22,30,185,165,180,168,138,137,11,7,0,9,8,0,"win_A",-8,20,12,1,0,0,0,0,1,0.4375,0.727272727272727,0,0,"orthodox"
"41336",41,31,175,188,191,185,168,167,50,29,14,2,34,20,"win_A",10,-13,6,1,1,0,0,0,0.78125,0.935483870967742,0.53125,0.645161290322581,0,"orthodox"
"41339",29,29,188,188,185,191,168,168,27,21,1,2,19,14,"win_A",0,0,-6,0,0,0,0,0,0.964285714285714,0.91304347826087,0.678571428571429,0.608695652173913,0,"orthodox"
"41344",26,27,178,188,197,185,162,162,27,23,1,0,24,16,"win_A",-1,-10,12,0,0,0,0,0,0.964285714285714,1,0.857142857142857,0.695652173913043,0,"orthodox"
"41350",26,21,188,188,185,185,167,167,17,9,0,0,11,9,"win_A",5,0,0,0,0,0,0,0,1,1,0.647058823529412,1,0,"orthodox"
"41437",29,23,173,170,170,165,131,129,25,27,1,1,16,17,"win_A",6,3,5,2,0,0,0,0,0.961538461538462,0.964285714285714,0.615384615384615,0.607142857142857,0,"orthodox"
"41440",21,22,170,168,165,183,133,133,24,23,1,3,17,15,"win_A",-1,2,-18,0,0,0,0,0,0.96,0.884615384615385,0.68,0.576923076923077,0,"Unknown"
"41441",21,32,170,175,165,173,135,135,23,11,1,6,16,7,"win_A",-11,-5,-8,0,0,0,0,0,0.958333333333333,0.647058823529412,0.666666666666667,0.411764705882353,0,"Unknown"
"41481",23,24,168,180,175,173,132,131,11,14,0,0,3,9,"win_A",-1,-12,2,1,0,0,0,0,1,1,0.272727272727273,0.642857142857143,0,"southpaw"
"41529",22,25,174,175,180,180,134,134,10,12,1,1,7,6,"win_B",-3,-1,0,0,0,0,0,0,0.909090909090909,0.923076923076923,0.636363636363636,0.461538461538462,1,"Unknown"
"41537",22,39,175,170,180,178,138,141,3,11,0,47,2,5,"win_A",-17,5,2,-3,0,1,0,0,1,0.189655172413793,0.666666666666667,0.0862068965517241,0,"orthodox"
"41569",31,23,170,170,170,165,133,133,24,20,6,2,8,16,"win_A",8,0,5,0,0,0,0,0,0.8,0.909090909090909,0.266666666666667,0.727272727272727,0,"southpaw"
"41572",22,26,170,170,165,173,134,138,17,12,2,9,13,6,"win_A",-4,0,-8,-4,0,0,0,0,0.894736842105263,0.571428571428571,0.684210526315789,0.285714285714286,0,"southpaw"
"41573",22,33,170,168,165,183,134,131,16,35,2,10,12,24,"win_A",-11,2,-18,3,0,0,0,0,0.888888888888889,0.777777777777778,0.666666666666667,0.533333333333333,0,"southpaw"
"41575",22,23,170,170,165,185,134,134,15,20,1,3,12,6,"win_A",-1,0,-20,0,0,0,0,0,0.9375,0.869565217391304,0.75,0.260869565217391,0,"southpaw"
"41590",17,20,170,174,165,178,121,123,1,5,0,1,1,5,"win_A",-3,-4,-13,-2,0,0,0,0,1,0.833333333333333,1,0.833333333333333,0,"southpaw"
"41802",27,28,173,180,178,190,174,176,15,15,1,10,11,10,"win_A",-1,-7,-12,-2,0,0,0,0,0.9375,0.6,0.6875,0.4,0,"southpaw"
"41807",26,36,173,176,178,176,175,173,9,3,0,19,7,1,"win_A",-10,-3,2,2,0,1,0,0,1,0.136363636363636,0.777777777777778,0.0454545454545455,0,"southpaw"
"41856",30,26,173,173,183,178,140,140,10,8,1,5,4,3,"win_A",4,0,5,0,0,0,0,0,0.909090909090909,0.615384615384615,0.363636363636364,0.230769230769231,0,"orthodox"
"42606",28,31,187,183,198,191,198,198,17,22,0,5,14,12,"win_A",-3,4,7,0,0,0,0,0,1,0.814814814814815,0.823529411764706,0.444444444444444,0,"orthodox"
"42610",27,34,187,185,198,201,199,198,13,30,0,9,12,26,"win_A",-7,2,-3,1,0,0,0,0,1,0.769230769230769,0.923076923076923,0.666666666666667,0,"orthodox"
"42614",26,30,187,185,198,187,204,223,9,10,0,11,8,6,"win_A",-4,2,11,-19,0,0,0,1,1,0.476190476190476,0.888888888888889,0.285714285714286,0,"orthodox"
"42761",30,29,177,170,183,165,148,149,26,23,8,1,17,17,"win_A",1,7,18,-1,0,0,0,0,0.764705882352941,0.958333333333333,0.5,0.708333333333333,0,"orthodox"
"42762",29,29,170,177,175,183,147,147,31,26,3,7,28,17,"win_A",0,-7,-8,0,0,0,0,0,0.911764705882353,0.787878787878788,0.823529411764706,0.515151515151515,0,"orthodox"
"42770",25,29,177,175,183,178,147,147,20,22,3,4,14,13,"win_A",-4,2,5,0,0,0,0,0,0.869565217391304,0.846153846153846,0.608695652173913,0.5,0,"orthodox"
"42772",25,37,177,173,183,188,150,149,18,27,3,4,14,17,"win_A",-12,4,-5,1,0,1,0,0,0.857142857142857,0.870967741935484,0.666666666666667,0.548387096774194,0,"orthodox"
"42775",24,28,177,168,183,183,147,147,15,14,3,4,12,12,"win_A",-4,9,0,0,0,0,0,0,0.833333333333333,0.777777777777778,0.666666666666667,0.666666666666667,0,"orthodox"
"42777",42,23,171,177,178,183,147,147,48,13,10,3,34,10,"win_B",19,-6,-5,0,1,0,0,0,0.827586206896552,0.8125,0.586206896551724,0.625,1,"orthodox"
"42782",20,29,177,173,183,180,149,149,10,22,0,19,9,10,"win_A",-9,4,3,0,0,0,0,0,1,0.536585365853659,0.9,0.24390243902439,0,"orthodox"
"42855",29,28,189,184,191,191,169,170,36,21,2,0,32,16,"win_A",1,5,0,-1,0,0,0,0,0.947368421052632,1,0.842105263157895,0.761904761904762,0,"orthodox"
"42860",27,33,184,183,191,186,179,180,16,23,0,35,13,13,"win_A",-6,1,5,-1,0,0,0,0,1,0.396551724137931,0.8125,0.224137931034483,0,"orthodox"
"42866",26,32,184,183,191,186,175,175,10,23,0,31,8,13,"win_A",-6,1,5,0,0,0,0,0,1,0.425925925925926,0.8,0.240740740740741,0,"orthodox"
"43130",30,27,169,165,173,165,130,130,38,18,4,0,30,5,"win_A",3,4,8,0,0,0,0,0,0.904761904761905,1,0.714285714285714,0.277777777777778,0,"southpaw"
"43131",29,39,169,170,173,170,130,130,37,56,4,20,29,38,"win_A",-10,-1,3,0,0,1,0,0,0.902439024390244,0.736842105263158,0.707317073170732,0.5,0,"southpaw"
"43145",24,32,169,168,173,183,127,127,24,35,2,9,21,24,"win_A",-8,1,-10,0,0,0,0,0,0.923076923076923,0.795454545454545,0.807692307692308,0.545454545454545,0,"southpaw"
"43150",23,26,169,173,173,180,126,128,19,17,2,12,17,7,"win_A",-3,-4,-7,-2,0,0,0,0,0.904761904761905,0.586206896551724,0.80952380952381,0.241379310344828,0,"southpaw"
"43199",26,24,175,170,182,180,143,137,12,6,0,10,6,2,"win_A",2,5,2,6,0,0,0,0,1,0.375,0.5,0.125,0,"southpaw"
"43205",23,24,178,175,182,182,145,145,5,6,6,0,2,3,"win_B",-1,3,0,0,0,0,0,0,0.454545454545455,1,0.181818181818182,0.5,1,"orthodox"
"43208",23,26,175,178,182,188,140,142,3,0,0,2,1,0,"win_A",-3,-3,-6,-2,0,0,0,0,1,0,0.333333333333333,0,0,"southpaw"
"43210",22,27,175,173,182,165,136,136,1,1,0,0,0,0,"win_A",-5,2,17,0,0,0,0,0,1,1,0,0,0,"southpaw"
"43490",24,27,175,170,180,173,131,130,15,20,0,8,12,16,"win_A",-3,5,7,1,0,0,0,0,1,0.714285714285714,0.8,0.571428571428571,0,"orthodox"
"43493",22,23,175,170,180,175,129,130,12,4,0,9,9,2,"win_A",-1,5,5,-1,0,0,0,0,1,0.307692307692308,0.75,0.153846153846154,0,"orthodox"
"43510",27,29,170,168,168,175,122,121,27,14,2,6,9,9,"win_B",-2,2,-7,1,0,0,0,0,0.931034482758621,0.7,0.310344827586207,0.45,1,"orthodox"
"43514",25,21,170,173,168,180,122,120,23,20,2,1,6,15,"win_A",4,-3,-12,2,0,0,0,0,0.92,0.952380952380952,0.24,0.714285714285714,0,"orthodox"
"43516",35,25,163,170,168,168,124,124,33,23,21,0,26,6,"win_A",10,-7,0,0,1,0,0,0,0.611111111111111,1,0.481481481481481,0.260869565217391,0,"orthodox"
"43519",24,31,170,163,168,163,123,124,19,29,0,2,5,20,"win_A",-7,7,5,-1,0,0,0,0,1,0.935483870967742,0.263157894736842,0.645161290322581,0,"orthodox"
"43521",23,30,170,165,168,163,122,122,16,15,0,7,4,14,"win_A",-7,5,5,0,0,0,0,0,1,0.681818181818182,0.25,0.636363636363636,0,"orthodox"
"43522",23,21,170,168,168,183,122,122,15,15,0,0,3,12,"win_A",2,2,-15,0,0,0,0,0,1,1,0.2,0.8,0,"orthodox"
"43523",22,34,170,170,168,170,122,121,14,12,0,9,2,5,"win_A",-12,0,-2,1,0,0,0,0,1,0.571428571428571,0.142857142857143,0.238095238095238,0,"orthodox"
"43525",22,31,170,163,168,168,121,121,12,23,0,19,2,18,"win_A",-9,7,0,0,0,0,0,0,1,0.547619047619048,0.166666666666667,0.428571428571429,0,"orthodox"
"43530",21,18,170,165,168,163,123,121,7,4,0,1,2,3,"win_A",3,5,5,2,0,0,0,0,1,0.8,0.285714285714286,0.6,0,"orthodox"
"43545",32,33,183,183,183,190,230,225,13,25,5,4,9,20,"win_B",-1,0,-7,5,0,0,0,0,0.722222222222222,0.862068965517241,0.5,0.689655172413793,1,"orthodox"
"43549",31,36,183,188,190,196,237,247,21,12,3,12,16,6,"win_A",-5,-5,-6,-10,0,1,0,0,0.875,0.5,0.666666666666667,0.25,0,"orthodox"
"43574",19,30,173,163,178,173,131,125,9,7,0,26,5,0,"win_A",-11,10,5,6,0,0,0,0,1,0.212121212121212,0.555555555555556,0,0,"Unknown"
"43770",31,42,180,177,187,178,158,159,24,23,5,8,11,11,"win_A",-11,3,9,-1,0,1,0,0,0.827586206896552,0.741935483870968,0.379310344827586,0.354838709677419,0,"orthodox"
"43771",30,33,180,180,187,182,167,166,22,13,5,6,10,11,"win_A",-3,0,5,1,0,0,0,0,0.814814814814815,0.684210526315789,0.37037037037037,0.578947368421053,0,"orthodox"
"43776",28,29,180,180,187,185,160,161,18,20,3,10,8,13,"win_A",-1,0,2,-1,0,0,0,0,0.857142857142857,0.666666666666667,0.380952380952381,0.433333333333333,0,"orthodox"
"43780",25,23,180,178,187,178,163,163,16,12,0,1,7,2,"win_B",2,2,9,0,0,0,0,0,1,0.923076923076923,0.4375,0.153846153846154,1,"orthodox"
"43783",25,41,180,166,187,175,168,167,13,22,0,8,5,8,"win_A",-16,14,12,1,0,1,0,0,1,0.733333333333333,0.384615384615385,0.266666666666667,0,"orthodox"
"43789",23,28,180,175,187,180,160,163,7,11,0,3,1,5,"win_A",-5,5,7,-3,0,0,0,0,1,0.785714285714286,0.142857142857143,0.357142857142857,0,"orthodox"
"43792",23,34,180,175,187,180,161,159,4,4,0,6,1,2,"win_A",-11,5,7,2,0,0,0,0,1,0.4,0.25,0.2,0,"orthodox"
"43799",23,44,185,178,197,185,154,154,36,32,3,19,33,16,"win_A",-21,7,12,0,0,1,0,0,0.923076923076923,0.627450980392157,0.846153846153846,0.313725490196078,0,"orthodox"
"43801",22,35,185,174,197,178,155,152,34,27,2,11,32,17,"win_A",-13,11,19,3,0,1,0,0,0.944444444444444,0.710526315789474,0.888888888888889,0.447368421052632,0,"orthodox"
"43804",21,29,185,178,197,165,154,156,31,14,2,10,30,7,"win_A",-8,7,32,-2,0,0,0,0,0.939393939393939,0.583333333333333,0.909090909090909,0.291666666666667,0,"orthodox"
"43846",22,23,180,183,185,196,154,155,13,6,0,10,7,6,"win_A",-1,-3,-11,-1,0,0,0,0,1,0.375,0.538461538461538,0.375,0,"orthodox"
"43849",21,26,180,175,185,193,153,152,10,5,0,4,5,2,"win_A",-5,5,-8,1,0,0,0,0,1,0.555555555555556,0.5,0.222222222222222,0,"orthodox"
"43899",19,28,173,173,174,170,135,139,1,10,0,7,1,6,"win_A",-9,0,4,-4,0,0,0,0,1,0.588235294117647,1,0.352941176470588,0,"Unknown"
"44496",20,22,170,168,174,175,118,117,3,6,1,0,1,1,"win_B",-2,2,-1,1,0,0,0,0,0.75,1,0.25,0.166666666666667,1,"southpaw"
"44543",24,28,180,175,188,178,160,158,7,9,1,4,3,7,"win_A",-4,5,10,2,0,0,0,0,0.875,0.692307692307692,0.375,0.538461538461538,0,"orthodox"
"44544",24,21,180,185,188,193,160,160,6,5,1,1,3,3,"win_A",3,-5,-5,0,0,0,0,0,0.857142857142857,0.833333333333333,0.428571428571429,0.5,0,"orthodox"
"44545",23,42,180,180,188,185,160,159,5,5,1,8,3,3,"win_A",-19,0,3,1,0,1,0,0,0.833333333333333,0.384615384615385,0.5,0.230769230769231,0,"orthodox"
"44547",23,40,180,175,188,178,156,151,3,0,1,1,2,0,"win_A",-17,5,10,5,0,1,0,0,0.75,0,0.5,0,0,"orthodox"
"44622",22,30,183,178,185,180,167,165,7,0,3,1,2,0,"win_A",-8,5,5,2,0,0,0,0,0.7,0,0.2,0,0,"orthodox"
"44650",25,27,178,173,178,178,142,143,20,11,3,4,9,6,"win_A",-2,5,0,-1,0,0,0,0,0.869565217391304,0.733333333333333,0.391304347826087,0.4,0,"Unknown"
"44654",23,26,178,170,178,173,141,141,17,8,1,13,9,2,"win_B",-3,8,5,0,0,0,0,0,0.944444444444444,0.380952380952381,0.5,0.0952380952380952,1,"Unknown"
"44842",26,27,188,178,188,180,234,248,6,3,0,2,6,1,"win_A",-1,10,8,-14,0,0,0,0,1,0.6,1,0.2,0,"orthodox"
"44852",25,30,169,166,178,170,126,125,2,11,0,12,1,0,"win_A",-5,3,8,1,0,0,0,0,1,0.478260869565217,0.5,0,0,"orthodox"
"44855",29,24,166,165,170,171,126,126,10,0,10,1,0,0,"win_A",5,1,-1,0,0,0,0,0,0.5,0,0,0,0,"southpaw"
"44911",23,36,173,170,180,180,135,135,9,26,0,11,2,16,"win_A",-13,3,0,0,0,1,0,0,1,0.702702702702703,0.222222222222222,0.432432432432432,0,"Unknown"
"45236",25,20,168,170,172,170,123,121,0,0,1,1,0,0,"win_A",5,-2,2,2,0,0,0,0,0,0,0,0,0,"orthodox"
"45323",23,30,173,168,175,173,127,126,18,27,0,4,9,20,"win_A",-7,5,2,1,0,0,0,0,1,0.870967741935484,0.5,0.645161290322581,0,"orthodox"
"45325",23,26,173,173,175,173,127,128,16,15,0,2,7,9,"win_A",-3,0,2,-1,0,0,0,0,1,0.882352941176471,0.4375,0.529411764705882,0,"orthodox"
"45445",21,26,175,165,182,170,133,133,13,21,0,5,10,9,"win_A",-5,10,12,0,0,0,0,0,1,0.807692307692308,0.769230769230769,0.346153846153846,0,"orthodox"
"45527",29,32,178,185,192,188,174,174,7,8,0,16,6,4,"win_A",-3,-7,4,0,0,0,0,0,1,0.333333333333333,0.857142857142857,0.166666666666667,0,"orthodox"
"45858",35,40,168,168,170,183,130,131,28,46,8,20,15,30,"win_A",-5,0,-13,-1,1,1,0,0,0.777777777777778,0.696969696969697,0.416666666666667,0.454545454545455,0,"orthodox"
"45892",30,29,175,173,183,178,136,135,21,13,4,15,16,1,"win_A",1,2,5,1,0,0,0,0,0.84,0.464285714285714,0.64,0.0357142857142857,0,"orthodox"
"45936",24,25,170,168,166,175,121,122,23,15,2,5,18,6,"win_B",-1,2,-9,-1,0,0,0,0,0.92,0.75,0.72,0.3,1,"orthodox"
"45940",22,21,168,170,175,175,125,125,10,3,1,5,5,2,"win_A",1,-2,0,0,0,0,0,0,0.909090909090909,0.375,0.454545454545455,0.25,0,"Unknown"
"46320",29,33,183,185,187,187,194,195,14,19,0,13,11,13,"win_A",-4,-2,0,-1,0,0,0,0,1,0.59375,0.785714285714286,0.40625,0,"orthodox"
"46321",28,31,183,185,187,188,185,178,13,8,0,12,10,4,"win_A",-3,-2,-1,7,0,0,0,0,1,0.4,0.769230769230769,0.2,0,"orthodox"
"46596",30,28,170,173,168,169,140,140,27,35,4,8,22,28,"win_A",2,-3,-1,0,0,0,0,0,0.870967741935484,0.813953488372093,0.709677419354839,0.651162790697674,0,"orthodox"
"46597",28,30,175,170,180,168,134,134,28,27,1,3,18,22,"win_A",-2,5,12,0,0,0,0,0,0.96551724137931,0.9,0.620689655172414,0.733333333333333,0,"southpaw"
"46598",37,30,170,170,170,168,135,134,51,27,5,2,37,22,"win_A",7,0,2,1,1,0,0,0,0.910714285714286,0.931034482758621,0.660714285714286,0.758620689655172,0,"orthodox"
"46600",29,27,170,173,168,188,135,134,25,21,2,1,21,13,"win_A",2,-3,-20,1,0,0,0,0,0.925925925925926,0.954545454545455,0.777777777777778,0.590909090909091,0,"orthodox"
"46601",28,36,170,165,168,165,135,136,24,44,2,4,20,30,"win_A",-8,5,3,-1,0,1,0,0,0.923076923076923,0.916666666666667,0.769230769230769,0.625,0,"orthodox"
"46607",25,29,170,176,168,177,144,141,19,21,0,13,17,10,"win_A",-4,-6,-9,3,0,0,0,0,1,0.617647058823529,0.894736842105263,0.294117647058824,0,"orthodox"
"46634",23,30,183,192,185,198,229,238,2,1,0,0,1,0,"win_A",-7,-9,-13,-9,0,0,0,0,1,1,0.5,0,0,"orthodox"
"47201",21,20,173,163,173,173,145,144,9,3,0,1,6,1,"win_A",1,10,0,1,0,0,0,0,1,0.75,0.666666666666667,0.25,0,"orthodox"
"47205",20,28,173,160,173,170,144,144,5,5,0,7,4,0,"win_A",-8,13,3,0,0,0,0,0,1,0.416666666666667,0.8,0,0,"orthodox"
"47301",22,36,185,178,193,169,147,150,15,32,0,11,9,25,"win_A",-14,7,24,-3,0,1,0,0,1,0.744186046511628,0.6,0.581395348837209,0,"Unknown"
"47305",21,35,185,170,193,178,140,137,11,11,0,14,8,4,"win_A",-14,15,15,3,0,1,0,0,1,0.44,0.727272727272727,0.16,0,"Unknown"
"47610",22,29,182,174,193,179,160,159,12,18,0,6,8,6,"win_A",-7,8,14,1,0,0,0,0,1,0.75,0.666666666666667,0.25,0,"southpaw"
"47994",21,24,165,165,168,165,121,122,8,11,1,13,5,6,"win_A",-3,0,3,-1,0,0,0,0,0.888888888888889,0.458333333333333,0.555555555555556,0.25,0,"orthodox"
"48014",25,33,175,170,180,183,142,142,26,32,0,13,10,6,"win_A",-8,5,-3,0,0,0,0,0,1,0.711111111111111,0.384615384615385,0.133333333333333,0,"southpaw"
"48016",32,30,170,173,183,173,144,145,31,17,12,5,6,9,"win_A",2,-3,10,-1,0,0,0,0,0.720930232558139,0.772727272727273,0.13953488372093,0.409090909090909,0,"orthodox"
"48017",32,21,170,170,183,173,143,140,30,4,12,4,6,1,"win_A",11,0,10,3,0,0,0,0,0.714285714285714,0.5,0.142857142857143,0.125,0,"orthodox"
"48023",28,23,170,175,183,173,136,136,26,26,9,4,4,15,"win_A",5,-5,10,0,0,0,0,0,0.742857142857143,0.866666666666667,0.114285714285714,0.5,0,"orthodox"
"48028",27,27,170,165,183,168,135,134,21,16,9,4,4,10,"win_A",0,5,15,1,0,0,0,0,0.7,0.8,0.133333333333333,0.5,0,"orthodox"
"48031",29,27,171,170,173,183,141,142,42,20,6,7,23,4,"win_B",2,1,-10,-1,0,0,0,0,0.875,0.740740740740741,0.479166666666667,0.148148148148148,1,"orthodox"
"48041",25,26,170,170,183,169,140,140,12,5,5,6,1,4,"win_A",-1,0,14,0,0,0,0,0,0.705882352941177,0.454545454545455,0.0588235294117647,0.363636363636364,0,"orthodox"
"48044",25,29,170,175,183,180,139,142,10,12,3,15,1,5,"win_A",-4,-5,3,-3,0,0,0,0,0.769230769230769,0.444444444444444,0.0769230769230769,0.185185185185185,0,"orthodox"
"48050",23,24,170,170,183,183,140,140,10,6,0,1,5,0,"win_A",-1,0,0,0,0,0,0,0,1,0.857142857142857,0.5,0,0,"orthodox"
"48104",33,36,183,185,189,191,243,223,16,29,2,16,8,16,"win_A",-3,-2,-2,20,0,1,1,0,0.888888888888889,0.644444444444444,0.444444444444444,0.355555555555556,0,"orthodox"
"48126",17,19,175,172,178,173,130,130,1,3,1,1,1,1,"win_B",-2,3,5,0,0,0,0,0,0.5,0.75,0.5,0.25,1,"orthodox"
"48136",27,30,175,160,180,170,143,144,10,6,1,9,6,0,"win_A",-3,15,10,-1,0,0,0,0,0.909090909090909,0.4,0.545454545454545,0,0,"Unknown"
"48142",35,25,170,160,178,170,137,137,12,2,7,4,7,0,"win_B",10,10,8,0,1,0,0,0,0.631578947368421,0.333333333333333,0.368421052631579,0,1,"orthodox"
"48143",24,24,175,160,175,170,137,137,5,2,0,3,2,0,"win_A",0,15,5,0,0,0,0,0,1,0.4,0.4,0,0,"orthodox"
"48145",22,22,175,160,188,170,131,131,5,1,0,2,2,0,"win_A",0,15,18,0,0,0,0,0,1,0.333333333333333,0.4,0,0,"orthodox"
"48212",29,33,202,180,206,185,282,255,15,7,2,1,8,1,"win_A",-4,22,21,27,0,0,1,0,0.882352941176471,0.875,0.470588235294118,0.125,0,"orthodox"
"48222",26,30,202,183,206,203,281,306,6,6,1,13,3,0,"win_A",-4,19,3,-25,0,0,0,1,0.857142857142857,0.315789473684211,0.428571428571429,0,0,"orthodox"
"48227",24,23,202,188,206,192,260,231,1,1,1,0,0,1,"win_A",1,14,14,29,0,0,1,0,0.5,1,0,1,0,"orthodox"
"48504",30,24,170,164,178,166,130,132,20,14,2,3,7,2,"win_A",6,6,12,-2,0,0,0,0,0.909090909090909,0.823529411764706,0.318181818181818,0.117647058823529,0,"orthodox"
"48510",28,24,170,185,178,183,129,129,14,14,2,0,4,11,"win_A",4,-15,-5,0,0,0,0,0,0.875,1,0.25,0.785714285714286,0,"orthodox"
"48724",22,24,165,165,165,173,123,122,6,8,0,1,3,6,"win_A",-2,0,-8,1,0,0,0,0,1,0.888888888888889,0.5,0.666666666666667,0,"southpaw"
"48733",24,33,173,168,178,178,144,145,19,34,0,16,13,16,"win_A",-9,5,0,-1,0,0,0,0,1,0.68,0.684210526315789,0.32,0,"orthodox"
"48739",30,21,168,170,178,183,147,147,29,20,14,4,12,16,"win_A",9,-2,-5,0,0,0,0,0,0.674418604651163,0.833333333333333,0.27906976744186,0.666666666666667,0,"orthodox"
"48741",30,25,168,175,178,180,141,141,27,19,14,4,12,9,"win_A",5,-7,-2,0,0,0,0,0,0.658536585365854,0.826086956521739,0.292682926829268,0.391304347826087,0,"orthodox"
"48742",32,30,172,168,175,178,139,139,59,26,8,13,34,12,"win_A",2,4,-3,0,0,0,0,0,0.880597014925373,0.666666666666667,0.507462686567164,0.307692307692308,0,"orthodox"
"48755",29,23,168,168,175,178,138,135,29,16,1,8,16,7,"win_A",6,0,-3,3,0,0,0,0,0.966666666666667,0.666666666666667,0.533333333333333,0.291666666666667,0,"southpaw"
"48760",21,21,173,168,163,178,140,137,20,13,2,6,14,6,"win_A",0,5,-15,3,0,0,0,0,0.909090909090909,0.684210526315789,0.636363636363636,0.315789473684211,0,"orthodox"
"48761",24,21,170,168,173,178,138,137,22,13,4,5,9,6,"win_A",3,2,-5,1,0,0,0,0,0.846153846153846,0.722222222222222,0.346153846153846,0.333333333333333,0,"orthodox"
"48763",21,20,165,168,168,178,132,130,21,13,0,3,17,6,"win_A",1,-3,-10,2,0,0,0,0,1,0.8125,0.80952380952381,0.375,0,"orthodox"
"49219",23,20,170,168,173,175,118,118,9,10,0,0,1,3,"win_A",3,2,-2,0,0,0,0,0,1,1,0.111111111111111,0.3,0,"orthodox"
"49243",28,40,185,175,196,183,172,177,19,47,1,27,9,26,"win_A",-12,10,13,-5,0,1,0,0,0.95,0.635135135135135,0.45,0.351351351351351,0,"Unknown"
"49245",27,35,185,175,196,183,168,165,18,12,0,8,8,6,"win_A",-8,10,13,3,0,1,0,0,1,0.6,0.444444444444444,0.3,0,"Unknown"
"49249",25,27,185,168,196,175,168,172,14,8,0,24,6,3,"win_A",-2,17,21,-4,0,0,0,0,1,0.25,0.428571428571429,0.09375,0,"Unknown"
"49250",25,27,185,168,196,175,167,167,13,8,0,23,6,3,"win_A",-2,17,21,0,0,0,0,0,1,0.258064516129032,0.461538461538462,0.0967741935483871,0,"Unknown"
"49253",23,28,185,178,196,193,167,169,10,9,0,7,5,1,"win_A",-5,7,3,-2,0,0,0,0,1,0.5625,0.5,0.0625,0,"Unknown"
"49269",26,19,181,178,183,185,152,154,5,5,0,0,3,0,"win_B",7,3,-2,-2,0,0,0,0,1,1,0.6,0,1,"orthodox"
"49270",26,25,178,181,180,183,154,156,0,4,3,0,0,3,"win_B",1,-3,-3,-2,0,0,0,0,0,1,0,0.75,1,"orthodox"
"49271",25,30,181,179,183,180,152,153,3,1,0,2,3,1,"win_A",-5,2,3,-1,0,0,0,0,1,0.333333333333333,1,0.333333333333333,0,"orthodox"
"49272",25,28,181,174,183,180,154,152,2,0,0,1,2,0,"win_A",-3,7,3,2,0,0,0,0,1,0,1,0,0,"orthodox"
"49326",23,23,165,164,164,170,118,118,28,42,1,1,20,27,"win_B",0,1,-6,0,0,0,0,0,0.96551724137931,0.976744186046512,0.689655172413793,0.627906976744186,1,"southpaw"
"49328",23,23,165,163,164,173,118,118,26,13,1,5,19,9,"win_A",0,2,-9,0,0,0,0,0,0.962962962962963,0.722222222222222,0.703703703703704,0.5,0,"southpaw"
"49333",21,31,165,157,164,163,118,119,20,24,1,11,16,14,"win_A",-10,8,1,-1,0,0,0,0,0.952380952380952,0.685714285714286,0.761904761904762,0.4,0,"southpaw"
"49335",20,34,165,163,164,163,119,118,18,18,1,3,15,10,"win_A",-14,2,1,1,0,0,0,0,0.947368421052632,0.857142857142857,0.789473684210526,0.476190476190476,0,"southpaw"
"49336",20,25,165,159,164,173,119,119,17,17,1,7,14,8,"win_A",-5,6,-9,0,0,0,0,0,0.944444444444444,0.708333333333333,0.777777777777778,0.333333333333333,0,"southpaw"
"49566",22,24,165,165,165,173,123,122,6,8,0,1,3,6,"win_A",-2,0,-8,1,0,0,0,0,1,0.888888888888889,0.5,0.666666666666667,0,"southpaw"
"49575",24,33,173,168,178,178,144,145,19,34,0,16,13,16,"win_A",-9,5,0,-1,0,0,0,0,1,0.68,0.684210526315789,0.32,0,"orthodox"
"49581",30,21,168,170,178,183,147,147,29,20,14,4,12,16,"win_A",9,-2,-5,0,0,0,0,0,0.674418604651163,0.833333333333333,0.27906976744186,0.666666666666667,0,"orthodox"
"49583",30,25,168,175,178,180,141,141,27,19,14,4,12,9,"win_A",5,-7,-2,0,0,0,0,0,0.658536585365854,0.826086956521739,0.292682926829268,0.391304347826087,0,"orthodox"
"49584",32,30,172,168,175,178,139,139,59,26,8,13,34,12,"win_A",2,4,-3,0,0,0,0,0,0.880597014925373,0.666666666666667,0.507462686567164,0.307692307692308,0,"orthodox"
"49597",29,23,168,168,175,178,138,135,29,16,1,8,16,7,"win_A",6,0,-3,3,0,0,0,0,0.966666666666667,0.666666666666667,0.533333333333333,0.291666666666667,0,"southpaw"
"49602",21,21,173,168,163,178,140,137,20,13,2,6,14,6,"win_A",0,5,-15,3,0,0,0,0,0.909090909090909,0.684210526315789,0.636363636363636,0.315789473684211,0,"orthodox"
"49603",24,21,170,168,173,178,138,137,22,13,4,5,9,6,"win_A",3,2,-5,1,0,0,0,0,0.846153846153846,0.722222222222222,0.346153846153846,0.333333333333333,0,"orthodox"
"49605",21,20,165,168,168,178,132,130,21,13,0,3,17,6,"win_A",1,-3,-10,2,0,0,0,0,1,0.8125,0.80952380952381,0.375,0,"orthodox"
"50061",23,20,170,168,173,175,118,118,9,10,0,0,1,3,"win_A",3,2,-2,0,0,0,0,0,1,1,0.111111111111111,0.3,0,"orthodox"
"50085",28,40,185,175,196,183,172,177,19,47,1,27,9,26,"win_A",-12,10,13,-5,0,1,0,0,0.95,0.635135135135135,0.45,0.351351351351351,0,"Unknown"
"50087",27,35,185,175,196,183,168,165,18,12,0,8,8,6,"win_A",-8,10,13,3,0,1,0,0,1,0.6,0.444444444444444,0.3,0,"Unknown"
"50091",25,27,185,168,196,175,168,172,14,8,0,24,6,3,"win_A",-2,17,21,-4,0,0,0,0,1,0.25,0.428571428571429,0.09375,0,"Unknown"
"50092",25,27,185,168,196,175,167,167,13,8,0,23,6,3,"win_A",-2,17,21,0,0,0,0,0,1,0.258064516129032,0.461538461538462,0.0967741935483871,0,"Unknown"
"50095",23,28,185,178,196,193,167,169,10,9,0,7,5,1,"win_A",-5,7,3,-2,0,0,0,0,1,0.5625,0.5,0.0625,0,"Unknown"
"50111",26,19,181,178,183,185,152,154,5,5,0,0,3,0,"win_B",7,3,-2,-2,0,0,0,0,1,1,0.6,0,1,"orthodox"
"50112",26,25,178,181,180,183,154,156,0,4,3,0,0,3,"win_B",1,-3,-3,-2,0,0,0,0,0,1,0,0.75,1,"orthodox"
"50113",25,30,181,179,183,180,152,153,3,1,0,2,3,1,"win_A",-5,2,3,-1,0,0,0,0,1,0.333333333333333,1,0.333333333333333,0,"orthodox"
"50114",25,28,181,174,183,180,154,152,2,0,0,1,2,0,"win_A",-3,7,3,2,0,0,0,0,1,0,1,0,0,"orthodox"
"50168",23,23,165,164,164,170,118,118,28,42,1,1,20,27,"win_B",0,1,-6,0,0,0,0,0,0.96551724137931,0.976744186046512,0.689655172413793,0.627906976744186,1,"southpaw"
"50170",23,23,165,163,164,173,118,118,26,13,1,5,19,9,"win_A",0,2,-9,0,0,0,0,0,0.962962962962963,0.722222222222222,0.703703703703704,0.5,0,"southpaw"
"50175",21,31,165,157,164,163,118,119,20,24,1,11,16,14,"win_A",-10,8,1,-1,0,0,0,0,0.952380952380952,0.685714285714286,0.761904761904762,0.4,0,"southpaw"
"50177",20,34,165,163,164,163,119,118,18,18,1,3,15,10,"win_A",-14,2,1,1,0,0,0,0,0.947368421052632,0.857142857142857,0.789473684210526,0.476190476190476,0,"southpaw"
"50178",20,25,165,159,164,173,119,119,17,17,1,7,14,8,"win_A",-5,6,-9,0,0,0,0,0,0.944444444444444,0.708333333333333,0.777777777777778,0.333333333333333,0,"southpaw"
"50326",24,29,178,168,185,178,147,150,1,0,0,5,1,0,"win_A",-5,10,7,-3,0,0,0,0,1,0,1,0,0,"southpaw"
"50461",27,27,175,173,175,173,132,129,20,16,1,4,10,10,"win_A",0,2,2,3,0,0,0,0,0.952380952380952,0.8,0.476190476190476,0.5,0,"orthodox"
"50507",31,23,168,168,175,170,135,135,38,31,1,0,32,15,"win_B",8,0,5,0,0,0,0,0,0.974358974358974,1,0.82051282051282,0.483870967741935,1,"orthodox"
"50508",30,29,168,168,175,178,135,135,37,27,1,1,32,16,"win_A",1,0,-3,0,0,0,0,0,0.973684210526316,0.964285714285714,0.842105263157895,0.571428571428571,0,"orthodox"
"50511",28,36,168,171,175,175,135,134,34,36,0,0,31,22,"win_A",-8,-3,0,1,0,1,0,0,1,1,0.911764705882353,0.611111111111111,0,"orthodox"
"50513",27,25,168,168,175,177,130,130,32,29,0,4,29,12,"win_A",2,0,-2,0,0,0,0,0,1,0.878787878787879,0.90625,0.363636363636364,0,"orthodox"
"50514",26,23,168,170,175,170,130,130,31,20,0,0,29,8,"win_A",3,-2,5,0,0,0,0,0,1,1,0.935483870967742,0.4,0,"orthodox"
"50516",26,33,168,165,175,168,134,134,29,24,0,7,29,15,"win_A",-7,3,7,0,0,0,0,0,1,0.774193548387097,1,0.483870967741935,0,"orthodox"
"50520",24,24,168,165,175,170,130,130,25,19,0,2,25,10,"win_A",0,3,5,0,0,0,0,0,1,0.904761904761905,1,0.476190476190476,0,"orthodox"
"50521",24,26,168,170,175,180,130,130,24,41,0,8,24,30,"win_A",-2,-2,-5,0,0,0,0,0,1,0.836734693877551,1,0.612244897959184,0,"orthodox"
"50531",22,22,168,173,175,173,132,132,14,13,0,4,14,8,"win_A",0,-5,2,0,0,0,0,0,1,0.764705882352941,1,0.470588235294118,0,"orthodox"
"50534",21,25,168,173,175,185,134,134,11,16,0,4,11,5,"win_A",-4,-5,-10,0,0,0,0,0,1,0.8,1,0.25,0,"orthodox"
"50687",23,28,185,178,183,175,162,162,13,15,2,1,9,10,"win_A",-5,7,8,0,0,0,0,0,0.866666666666667,0.9375,0.6,0.625,0,"orthodox"
"50846",30,31,188,181,193,192,174,174,19,18,1,1,16,13,"win_A",-1,7,1,0,0,0,0,0,0.95,0.947368421052632,0.8,0.684210526315789,0,"orthodox"
"50848",33,29,180,181,183,192,174,172,19,15,1,1,4,10,"win_B",4,-1,-9,2,0,0,0,0,0.95,0.9375,0.2,0.625,1,"orthodox"
"50899",27,33,178,193,178,206,168,168,15,16,1,5,9,11,"win_A",-6,-15,-28,0,0,0,0,0,0.9375,0.761904761904762,0.5625,0.523809523809524,0,"orthodox"
"50903",31,37,193,183,206,188,168,170,12,12,2,14,9,6,"win_A",-6,10,18,-2,0,1,0,0,0.857142857142857,0.461538461538462,0.642857142857143,0.230769230769231,0,"orthodox"
"51006",25,35,170,170,168,180,124,125,13,16,0,10,6,12,"win_A",-10,0,-12,-1,0,1,0,0,1,0.615384615384615,0.461538461538462,0.461538461538462,0,"Unknown"
"51307",33,26,173,171,183,182,147,147,48,23,6,5,34,20,"win_A",7,2,1,0,0,0,0,0,0.888888888888889,0.821428571428571,0.62962962962963,0.714285714285714,0,"orthodox"
"51310",25,27,171,173,182,180,135,135,20,17,4,14,18,7,"win_A",-2,-2,2,0,0,0,0,0,0.833333333333333,0.548387096774194,0.75,0.225806451612903,0,"orthodox"
"51317",22,28,171,170,182,180,135,135,14,17,2,3,13,15,"win_B",-6,1,2,0,0,0,0,0,0.875,0.85,0.8125,0.75,1,"orthodox"
"51320",21,23,171,170,182,178,136,136,13,6,0,0,12,4,"win_B",-2,1,4,0,0,0,0,0,1,1,0.923076923076923,0.666666666666667,1,"orthodox"
"51378",25,32,170,185,175,208,149,148,11,9,3,4,4,6,"win_A",-7,-15,-33,1,0,0,0,0,0.785714285714286,0.692307692307692,0.285714285714286,0.461538461538462,0,"southpaw"
"51379",34,23,175,170,183,175,146,148,34,11,6,2,9,4,"win_A",11,5,8,-2,0,0,0,0,0.85,0.846153846153846,0.225,0.307692307692308,0,"southpaw"
"51380",23,23,185,170,193,175,146,145,18,10,0,2,8,3,"win_B",0,15,18,1,0,0,0,0,1,0.833333333333333,0.444444444444444,0.25,1,"orthodox"
"51526",34,23,159,155,161,155,108,111,35,12,21,6,22,8,"win_B",11,4,6,-3,0,0,0,0,0.625,0.666666666666667,0.392857142857143,0.444444444444444,1,"orthodox"
"51534",18,19,161,155,166,155,113,113,11,6,0,3,7,4,"win_A",-1,6,11,0,0,0,0,0,1,0.666666666666667,0.636363636363636,0.444444444444444,0,"orthodox"
"51589",20,23,170,165,170,168,135,135,4,0,1,2,2,0,"win_B",-3,5,2,0,0,0,0,0,0.8,0,0.4,0,1,"southpaw"
"51663",21,22,173,175,173,173,137,139,7,0,2,1,5,0,"win_A",-1,-2,0,-2,0,0,0,0,0.777777777777778,0,0.555555555555556,0,0,"orthodox"
"51665",20,25,173,165,173,171,129,130,6,3,1,3,4,3,"win_B",-5,8,2,-1,0,0,0,0,0.857142857142857,0.5,0.571428571428571,0.5,1,"orthodox"
"51666",22,20,170,173,172,173,129,126,2,5,0,1,1,3,"win_B",2,-3,-1,3,0,0,0,0,1,0.833333333333333,0.5,0.5,1,"southpaw"
"51784",21,25,183,183,188,196,149,148,9,7,0,12,9,7,"win_A",-4,0,-8,1,0,0,0,0,1,0.368421052631579,1,0.368421052631579,0,"orthodox"
"51860",21,24,168,168,157,170,130,130,18,15,0,3,10,6,"win_A",-3,0,-13,0,0,0,0,0,1,0.833333333333333,0.555555555555556,0.333333333333333,0,"orthodox"
"52039",28,33,175,176,185,178,140,140,16,36,2,2,9,22,"win_A",-5,-1,7,0,0,0,0,0,0.888888888888889,0.947368421052632,0.5,0.578947368421053,0,"orthodox"
"52041",32,27,176,163,178,163,139,139,35,26,1,0,21,14,"win_B",5,13,15,0,0,0,0,0,0.972222222222222,1,0.583333333333333,0.538461538461538,1,"orthodox"
"52218",24,26,160,155,163,161,105,105,25,4,4,1,15,1,"win_A",-2,5,2,0,0,0,0,0,0.862068965517241,0.8,0.517241379310345,0.2,0,"southpaw"
"52239",31,24,175,170,185,177,137,135,20,6,6,4,13,5,"win_A",7,5,8,2,0,0,0,0,0.769230769230769,0.6,0.5,0.5,0,"orthodox"
"52241",28,34,175,168,185,180,130,130,18,22,4,3,12,14,"win_A",-6,7,5,0,0,0,0,0,0.818181818181818,0.88,0.545454545454545,0.56,0,"orthodox"
"52242",26,28,166,175,173,185,135,135,16,18,0,3,7,12,"win_A",-2,-9,-12,0,0,0,0,0,1,0.857142857142857,0.4375,0.571428571428571,0,"orthodox"
"52243",24,26,168,175,175,185,129,130,17,18,0,2,5,12,"win_A",-2,-7,-10,-1,0,0,0,0,1,0.9,0.294117647058824,0.6,0,"southpaw"
"52477",29,34,168,170,175,170,137,137,28,17,2,2,12,9,"win_A",-5,-2,5,0,0,0,0,0,0.933333333333333,0.894736842105263,0.4,0.473684210526316,0,"southpaw"
"52479",31,34,170,170,170,170,137,136,15,28,1,15,8,11,"win_A",-3,0,0,1,0,0,0,0,0.9375,0.651162790697674,0.5,0.255813953488372,0,"orthodox"
"52480",26,31,168,170,183,170,130,130,16,15,3,0,11,8,"win_A",-5,-2,13,0,0,0,0,0,0.842105263157895,1,0.578947368421053,0.533333333333333,0,"orthodox"
"52481",34,30,170,170,180,170,132,134,29,14,5,0,23,8,"win_B",4,0,10,-2,0,0,0,0,0.852941176470588,1,0.676470588235294,0.571428571428571,1,"orthodox"
"52586",25,23,196,191,203,203,210,202,2,1,0,0,1,1,"win_B",2,5,0,8,0,0,0,0,1,1,0.5,1,1,"orthodox"
"53082",23,28,185,188,187,201,168,168,13,19,2,1,12,15,"win_A",-5,-3,-14,0,0,0,0,0,0.866666666666667,0.95,0.8,0.75,0,"orthodox"
"53308",20,34,161,166,162,175,119,120,13,31,3,26,6,18,"win_A",-14,-5,-13,-1,0,0,0,0,0.8125,0.543859649122807,0.375,0.315789473684211,0,"orthodox"
"53310",19,33,161,166,162,175,118,118,11,29,3,25,5,16,"win_A",-14,-5,-13,0,0,0,0,0,0.785714285714286,0.537037037037037,0.357142857142857,0.296296296296296,0,"orthodox"
"53316",29,16,170,161,180,162,117,118,18,7,3,0,11,3,"win_A",13,9,18,-1,0,0,0,0,0.857142857142857,1,0.523809523809524,0.428571428571429,0,"southpaw"
"53400",23,22,175,183,189,191,157,155,13,9,0,1,10,7,"win_B",1,-8,-2,2,0,0,0,0,1,0.9,0.769230769230769,0.7,1,"orthodox"
"53411",27,33,170,173,188,175,142,142,13,7,2,2,6,1,"win_A",-6,-3,13,0,0,0,0,0,0.866666666666667,0.777777777777778,0.4,0.111111111111111,0,"orthodox"
"53412",25,26,170,173,188,178,142,142,13,10,1,0,6,3,"win_B",-1,-3,10,0,0,0,0,0,0.928571428571429,1,0.428571428571429,0.3,1,"orthodox"
"53413",25,37,170,173,188,183,142,142,12,26,1,19,5,8,"win_A",-12,-3,5,0,0,1,0,0,0.923076923076923,0.577777777777778,0.384615384615385,0.177777777777778,0,"orthodox"
"53415",24,25,170,170,188,173,142,142,10,6,1,9,4,2,"win_A",-1,0,15,0,0,0,0,0,0.909090909090909,0.4,0.363636363636364,0.133333333333333,0,"orthodox"
"53417",24,33,170,178,188,183,142,144,8,9,1,17,4,4,"win_A",-9,-8,5,-2,0,0,0,0,0.888888888888889,0.346153846153846,0.444444444444444,0.153846153846154,0,"orthodox"
"53465",23,29,165,163,168,173,126,137,14,6,1,21,4,0,"win_A",-6,2,-5,-11,0,0,0,0,0.933333333333333,0.222222222222222,0.266666666666667,0,0,"Unknown"
"53468",21,27,165,164,168,169,125,126,10,2,0,3,3,1,"win_A",-6,1,-1,-1,0,0,0,0,1,0.4,0.3,0.2,0,"Unknown"
"53469",20,24,165,165,168,165,122,120,9,7,0,12,3,5,"win_A",-4,0,3,2,0,0,0,0,1,0.368421052631579,0.333333333333333,0.263157894736842,0,"Unknown"
"53567",25,38,175,168,178,165,160,160,7,12,0,2,7,9,"win_A",-13,7,13,0,0,1,0,0,1,0.857142857142857,1,0.642857142857143,0,"Unknown"
"53778",25,32,180,180,175,188,216,210,16,3,3,13,6,2,"win_A",-7,0,-13,6,0,0,0,0,0.842105263157895,0.1875,0.315789473684211,0.125,0,"orthodox"
"53808",30,34,193,193,189,203,238,268,23,47,1,4,14,41,"win_B",-4,0,-14,-30,0,0,0,1,0.958333333333333,0.92156862745098,0.583333333333333,0.803921568627451,1,"orthodox"
"53810",28,29,193,191,189,198,240,227,21,25,1,1,14,18,"win_A",-1,2,-9,13,0,0,0,0,0.954545454545455,0.961538461538462,0.636363636363636,0.692307692307692,0,"orthodox"
"53816",26,26,193,193,203,189,235,217,18,16,12,0,9,10,"win_A",0,0,14,18,0,0,1,0,0.6,1,0.3,0.625,0,"orthodox"
"53818",25,39,193,198,189,206,228,282,14,11,0,4,9,8,"win_A",-14,-5,-17,-54,0,1,0,1,1,0.733333333333333,0.642857142857143,0.533333333333333,0,"orthodox"
"53861",24,24,173,168,178,175,146,146,7,6,0,8,3,3,"win_A",0,5,3,0,0,0,0,0,1,0.428571428571429,0.428571428571429,0.214285714285714,0,"orthodox"
"53913",22,27,168,168,168,175,119,120,3,2,0,14,2,0,"win_A",-5,0,-7,-1,0,0,0,0,1,0.125,0.666666666666667,0,0,"Unknown"
"53978",23,25,173,173,179,175,140,140,9,9,0,1,3,5,"win_A",-2,0,4,0,0,0,0,0,1,0.9,0.333333333333333,0.5,0,"Unknown"
"53982",21,26,173,170,179,173,140,140,4,6,0,11,2,2,"win_A",-5,3,6,0,0,0,0,0,1,0.352941176470588,0.5,0.117647058823529,0,"Unknown"
"54326",28,35,196,173,200,184,245,210,13,18,0,13,13,9,"win_A",-7,23,16,35,0,1,1,0,1,0.580645161290323,1,0.290322580645161,0,"orthodox"
"54508",23,24,168,168,168,183,122,122,15,16,0,0,9,7,"win_B",-1,0,-15,0,0,0,0,0,1,1,0.6,0.4375,1,"orthodox"
"54509",23,31,168,163,168,170,126,126,14,24,0,5,9,14,"win_A",-8,5,-2,0,0,0,0,0,1,0.827586206896552,0.642857142857143,0.482758620689655,0,"orthodox"
"54518",20,22,168,163,168,173,119,119,4,5,0,1,4,2,"win_A",-2,5,-5,0,0,0,0,0,1,0.833333333333333,1,0.333333333333333,0,"orthodox"
"55345",34,26,173,183,184,189,197,212,17,7,12,9,9,0,"win_A",8,-10,-5,-15,0,0,0,1,0.586206896551724,0.4375,0.310344827586207,0,0,"orthodox"
"55479",25,28,170,165,173,175,133,132,15,33,0,12,8,27,"win_A",-3,5,-2,1,0,0,0,0,1,0.733333333333333,0.533333333333333,0.6,0,"orthodox"
"55723",23,22,170,178,173,178,125,126,8,4,0,1,6,2,"win_A",1,-8,-5,-1,0,0,0,0,1,0.8,0.75,0.4,0,"orthodox"
"55741",29,18,180,182,185,178,165,168,14,14,2,0,12,13,"win_A",11,-2,7,-3,0,0,0,0,0.875,1,0.75,0.928571428571429,0,"orthodox"
"55906",20,42,178,163,170,173,135,128,4,11,0,50,3,2,"win_A",-22,15,-3,7,0,1,0,0,1,0.180327868852459,0.75,0.0327868852459016,0,"southpaw"
"56017",29,27,173,180,185,173,131,134,19,14,0,7,14,11,"win_A",2,-7,12,-3,0,0,0,0,1,0.666666666666667,0.736842105263158,0.523809523809524,0,"orthodox"
"56061",25,27,175,170,179,188,137,137,19,28,2,4,17,16,"win_A",-2,5,-9,0,0,0,0,0,0.904761904761905,0.875,0.80952380952381,0.5,0,"Unknown"
"56064",19,27,175,170,175,188,130,130,23,27,1,2,19,15,"win_A",-8,5,-13,0,0,0,0,0,0.958333333333333,0.931034482758621,0.791666666666667,0.517241379310345,0,"southpaw"
"56066",19,26,175,170,175,188,135,135,22,25,0,2,18,15,"win_B",-7,5,-13,0,0,0,0,0,1,0.925925925925926,0.818181818181818,0.555555555555556,1,"southpaw"
"56067",36,26,166,170,178,188,131,131,29,25,4,1,14,15,"win_A",10,-4,-10,0,1,0,0,0,0.878787878787879,0.961538461538462,0.424242424242424,0.576923076923077,0,"orthodox"
"56068",26,32,170,168,188,170,130,130,24,24,1,9,15,9,"win_A",-6,2,18,0,0,0,0,0,0.96,0.727272727272727,0.6,0.272727272727273,0,"orthodox"
"56092",20,23,170,170,188,175,132,132,1,6,0,0,1,3,"win_A",-3,0,13,0,0,0,0,0,1,1,1,0.5,0,"orthodox"
"56149",26,28,191,198,193,203,230,235,19,23,0,2,17,12,"win_A",-2,-7,-10,-5,0,0,0,0,1,0.92,0.894736842105263,0.48,0,"orthodox"
"56158",26,34,198,191,203,201,231,217,15,18,1,3,8,15,"win_A",-8,7,2,14,0,0,0,0,0.9375,0.857142857142857,0.5,0.714285714285714,0,"orthodox"
"56161",26,27,198,188,203,193,230,223,12,6,1,0,6,4,"win_A",-1,10,10,7,0,0,0,0,0.923076923076923,1,0.461538461538462,0.666666666666667,0,"orthodox"
"56163",25,36,198,180,203,188,228,216,10,18,1,18,5,5,"win_A",-11,18,15,12,0,1,0,0,0.909090909090909,0.5,0.454545454545455,0.138888888888889,0,"orthodox"
"56166",35,25,180,198,188,203,227,222,17,8,18,0,5,4,"win_A",10,-18,-15,5,1,0,0,0,0.485714285714286,1,0.142857142857143,0.5,0,"orthodox"
"56167",24,32,198,180,203,185,224,228,7,24,0,8,4,12,"win_A",-8,18,18,-4,0,0,0,0,1,0.75,0.571428571428571,0.375,0,"orthodox"
"56168",24,29,198,188,203,180,226,209,6,12,0,2,3,8,"win_A",-5,10,23,17,0,0,1,0,1,0.857142857142857,0.5,0.571428571428571,0,"orthodox"
"56207",21,38,175,178,184,185,147,151,8,12,3,21,3,8,"win_A",-17,-3,-1,-4,0,1,0,0,0.727272727272727,0.363636363636364,0.272727272727273,0.242424242424242,0,"orthodox"
"56308",23,20,170,185,178,190,140,141,6,0,0,4,6,0,"win_A",3,-15,-12,-1,0,0,0,0,1,0,1,0,0,"orthodox"
"56503",23,22,170,178,173,178,125,126,8,4,0,1,6,2,"win_A",1,-8,-5,-1,0,0,0,0,1,0.8,0.75,0.4,0,"orthodox"
"56521",29,18,180,182,185,178,165,168,14,14,2,0,12,13,"win_A",11,-2,7,-3,0,0,0,0,0.875,1,0.75,0.928571428571429,0,"orthodox"
"56686",20,42,178,163,170,173,135,128,4,11,0,50,3,2,"win_A",-22,15,-3,7,0,1,0,0,1,0.180327868852459,0.75,0.0327868852459016,0,"southpaw"
"56797",29,27,173,180,185,173,131,134,19,14,0,7,14,11,"win_A",2,-7,12,-3,0,0,0,0,1,0.666666666666667,0.736842105263158,0.523809523809524,0,"orthodox"
"56841",25,27,175,170,179,188,137,137,19,28,2,4,17,16,"win_A",-2,5,-9,0,0,0,0,0,0.904761904761905,0.875,0.80952380952381,0.5,0,"Unknown"
"56844",19,27,175,170,175,188,130,130,23,27,1,2,19,15,"win_A",-8,5,-13,0,0,0,0,0,0.958333333333333,0.931034482758621,0.791666666666667,0.517241379310345,0,"southpaw"
"56846",19,26,175,170,175,188,135,135,22,25,0,2,18,15,"win_B",-7,5,-13,0,0,0,0,0,1,0.925925925925926,0.818181818181818,0.555555555555556,1,"southpaw"
"56847",36,26,166,170,178,188,131,131,29,25,4,1,14,15,"win_A",10,-4,-10,0,1,0,0,0,0.878787878787879,0.961538461538462,0.424242424242424,0.576923076923077,0,"orthodox"
"56848",26,32,170,168,188,170,130,130,24,24,1,9,15,9,"win_A",-6,2,18,0,0,0,0,0,0.96,0.727272727272727,0.6,0.272727272727273,0,"orthodox"
"56872",20,23,170,170,188,175,132,132,1,6,0,0,1,3,"win_A",-3,0,13,0,0,0,0,0,1,1,1,0.5,0,"orthodox"
"56929",26,28,191,198,193,203,230,235,19,23,0,2,17,12,"win_A",-2,-7,-10,-5,0,0,0,0,1,0.92,0.894736842105263,0.48,0,"orthodox"
"56938",26,34,198,191,203,201,231,217,15,18,1,3,8,15,"win_A",-8,7,2,14,0,0,0,0,0.9375,0.857142857142857,0.5,0.714285714285714,0,"orthodox"
"56941",26,27,198,188,203,193,230,223,12,6,1,0,6,4,"win_A",-1,10,10,7,0,0,0,0,0.923076923076923,1,0.461538461538462,0.666666666666667,0,"orthodox"
"56943",25,36,198,180,203,188,228,216,10,18,1,18,5,5,"win_A",-11,18,15,12,0,1,0,0,0.909090909090909,0.5,0.454545454545455,0.138888888888889,0,"orthodox"
"56946",35,25,180,198,188,203,227,222,17,8,18,0,5,4,"win_A",10,-18,-15,5,1,0,0,0,0.485714285714286,1,0.142857142857143,0.5,0,"orthodox"
"56947",24,32,198,180,203,185,224,228,7,24,0,8,4,12,"win_A",-8,18,18,-4,0,0,0,0,1,0.75,0.571428571428571,0.375,0,"orthodox"
"56948",24,29,198,188,203,180,226,209,6,12,0,2,3,8,"win_A",-5,10,23,17,0,0,1,0,1,0.857142857142857,0.5,0.571428571428571,0,"orthodox"
"56987",21,38,175,178,184,185,147,151,8,12,3,21,3,8,"win_A",-17,-3,-1,-4,0,1,0,0,0.727272727272727,0.363636363636364,0.272727272727273,0.242424242424242,0,"orthodox"
"57088",23,20,170,185,178,190,140,141,6,0,0,4,6,0,"win_A",3,-15,-12,-1,0,0,0,0,1,0,1,0,0,"orthodox"
"57501",22,18,179,170,178,167,150,150,7,5,0,2,4,4,"win_A",4,9,11,0,0,0,0,0,1,0.714285714285714,0.571428571428571,0.571428571428571,0,"orthodox"
"57550",23,31,160,165,163,165,119,119,6,9,0,12,5,3,"win_A",-8,-5,-2,0,0,0,0,0,1,0.428571428571429,0.833333333333333,0.142857142857143,0,"orthodox"
"57551",23,39,160,163,163,173,127,128,5,10,0,39,4,1,"win_A",-16,-3,-10,-1,0,1,0,0,1,0.204081632653061,0.8,0.0204081632653061,0,"orthodox"
"57975",23,22,170,178,173,178,125,126,8,4,0,1,6,2,"win_A",1,-8,-5,-1,0,0,0,0,1,0.8,0.75,0.4,0,"orthodox"
"57993",29,18,180,182,185,178,165,168,14,14,2,0,12,13,"win_A",11,-2,7,-3,0,0,0,0,0.875,1,0.75,0.928571428571429,0,"orthodox"
"58158",20,42,178,163,170,173,135,128,4,11,0,50,3,2,"win_A",-22,15,-3,7,0,1,0,0,1,0.180327868852459,0.75,0.0327868852459016,0,"southpaw"
"58269",29,27,173,180,185,173,131,134,19,14,0,7,14,11,"win_A",2,-7,12,-3,0,0,0,0,1,0.666666666666667,0.736842105263158,0.523809523809524,0,"orthodox"
"58313",25,27,175,170,179,188,137,137,19,28,2,4,17,16,"win_A",-2,5,-9,0,0,0,0,0,0.904761904761905,0.875,0.80952380952381,0.5,0,"Unknown"
"58316",19,27,175,170,175,188,130,130,23,27,1,2,19,15,"win_A",-8,5,-13,0,0,0,0,0,0.958333333333333,0.931034482758621,0.791666666666667,0.517241379310345,0,"southpaw"
"58318",19,26,175,170,175,188,135,135,22,25,0,2,18,15,"win_B",-7,5,-13,0,0,0,0,0,1,0.925925925925926,0.818181818181818,0.555555555555556,1,"southpaw"
"58319",36,26,166,170,178,188,131,131,29,25,4,1,14,15,"win_A",10,-4,-10,0,1,0,0,0,0.878787878787879,0.961538461538462,0.424242424242424,0.576923076923077,0,"orthodox"
"58320",26,32,170,168,188,170,130,130,24,24,1,9,15,9,"win_A",-6,2,18,0,0,0,0,0,0.96,0.727272727272727,0.6,0.272727272727273,0,"orthodox"
"58344",20,23,170,170,188,175,132,132,1,6,0,0,1,3,"win_A",-3,0,13,0,0,0,0,0,1,1,1,0.5,0,"orthodox"
"58401",26,28,191,198,193,203,230,235,19,23,0,2,17,12,"win_A",-2,-7,-10,-5,0,0,0,0,1,0.92,0.894736842105263,0.48,0,"orthodox"
"58410",26,34,198,191,203,201,231,217,15,18,1,3,8,15,"win_A",-8,7,2,14,0,0,0,0,0.9375,0.857142857142857,0.5,0.714285714285714,0,"orthodox"
"58413",26,27,198,188,203,193,230,223,12,6,1,0,6,4,"win_A",-1,10,10,7,0,0,0,0,0.923076923076923,1,0.461538461538462,0.666666666666667,0,"orthodox"
"58415",25,36,198,180,203,188,228,216,10,18,1,18,5,5,"win_A",-11,18,15,12,0,1,0,0,0.909090909090909,0.5,0.454545454545455,0.138888888888889,0,"orthodox"
"58418",35,25,180,198,188,203,227,222,17,8,18,0,5,4,"win_A",10,-18,-15,5,1,0,0,0,0.485714285714286,1,0.142857142857143,0.5,0,"orthodox"
"58419",24,32,198,180,203,185,224,228,7,24,0,8,4,12,"win_A",-8,18,18,-4,0,0,0,0,1,0.75,0.571428571428571,0.375,0,"orthodox"
"58420",24,29,198,188,203,180,226,209,6,12,0,2,3,8,"win_A",-5,10,23,17,0,0,1,0,1,0.857142857142857,0.5,0.571428571428571,0,"orthodox"
"58459",21,38,175,178,184,185,147,151,8,12,3,21,3,8,"win_A",-17,-3,-1,-4,0,1,0,0,0.727272727272727,0.363636363636364,0.272727272727273,0.242424242424242,0,"orthodox"
"58560",23,20,170,185,178,190,140,141,6,0,0,4,6,0,"win_A",3,-15,-12,-1,0,0,0,0,1,0,1,0,0,"orthodox"
"58973",22,18,179,170,178,167,150,150,7,5,0,2,4,4,"win_A",4,9,11,0,0,0,0,0,1,0.714285714285714,0.571428571428571,0.571428571428571,0,"orthodox"
"59022",23,31,160,165,163,165,119,119,6,9,0,12,5,3,"win_A",-8,-5,-2,0,0,0,0,0,1,0.428571428571429,0.833333333333333,0.142857142857143,0,"orthodox"
"59023",23,39,160,163,163,173,127,128,5,10,0,39,4,1,"win_A",-16,-3,-10,-1,0,1,0,0,1,0.204081632653061,0.8,0.0204081632653061,0,"orthodox"
"59576",28,24,166,178,169,182,149,150,9,5,0,8,7,2,"win_A",4,-12,-13,-1,0,0,0,0,1,0.384615384615385,0.777777777777778,0.153846153846154,0,"southpaw"
"59580",27,30,166,173,169,178,147,147,5,26,0,59,3,6,"win_A",-3,-7,-9,0,0,0,0,0,1,0.305882352941176,0.6,0.0705882352941176,0,"southpaw"
"59752",21,31,170,157,165,156,113,114,11,27,0,17,8,13,"win_A",-10,13,9,-1,0,0,0,0,1,0.613636363636364,0.727272727272727,0.295454545454545,0,"orthodox"
"59754",21,25,170,165,165,170,119,119,8,21,0,5,7,10,"win_A",-4,5,-5,0,0,0,0,0,1,0.807692307692308,0.875,0.384615384615385,0,"orthodox"
"59936",20,27,173,178,180,180,141,140,2,1,1,2,1,1,"win_A",-7,-5,0,1,0,0,0,0,0.666666666666667,0.333333333333333,0.333333333333333,0.333333333333333,0,"orthodox"
"60175",28,37,175,170,173,180,146,144,11,12,0,14,9,8,"win_A",-9,5,-7,2,0,1,0,0,1,0.461538461538462,0.818181818181818,0.307692307692308,0,"orthodox"
"60177",28,32,175,178,173,198,147,153,9,2,0,18,8,1,"win_A",-4,-3,-25,-6,0,0,0,0,1,0.1,0.888888888888889,0.05,0,"orthodox"
"60309",28,27,175,180,175,188,135,135,8,2,2,4,4,0,"win_A",1,-5,-13,0,0,0,0,0,0.8,0.333333333333333,0.4,0,0,"Unknown"
"60596",25,33,173,168,178,173,140,139,8,22,0,32,3,10,"win_A",-8,5,5,1,0,0,0,0,1,0.407407407407407,0.375,0.185185185185185,0,"southpaw"
"60703",26,23,165,164,168,165,118,118,30,16,1,2,17,3,"win_A",3,1,3,0,0,0,0,0,0.967741935483871,0.888888888888889,0.548387096774194,0.166666666666667,0,"southpaw"
"60915",28,37,175,170,173,180,146,144,11,12,0,14,9,8,"win_A",-9,5,-7,2,0,1,0,0,1,0.461538461538462,0.818181818181818,0.307692307692308,0,"orthodox"
"60917",28,32,175,178,173,198,147,153,9,2,0,18,8,1,"win_A",-4,-3,-25,-6,0,0,0,0,1,0.1,0.888888888888889,0.05,0,"orthodox"
"61049",28,27,175,180,175,188,135,135,8,2,2,4,4,0,"win_A",1,-5,-13,0,0,0,0,0,0.8,0.333333333333333,0.4,0,0,"Unknown"
"61336",25,33,173,168,178,173,140,139,8,22,0,32,3,10,"win_A",-8,5,5,1,0,0,0,0,1,0.407407407407407,0.375,0.185185185185185,0,"southpaw"
"61443",26,23,165,164,168,165,118,118,30,16,1,2,17,3,"win_A",3,1,3,0,0,0,0,0,0.967741935483871,0.888888888888889,0.548387096774194,0.166666666666667,0,"southpaw"
"61745",21,35,183,173,180,173,167,168,12,9,0,2,9,5,"win_A",-14,10,7,-1,0,1,0,0,1,0.818181818181818,0.75,0.454545454545455,0,"orthodox"
"62300",26,26,178,170,175,173,138,135,13,12,0,11,12,6,"win_A",0,8,2,3,0,0,0,0,1,0.521739130434783,0.923076923076923,0.260869565217391,0,"orthodox"
"62515",38,36,169,173,174,173,147,146,28,42,0,10,9,21,"win_A",2,-4,1,1,1,1,0,0,1,0.807692307692308,0.321428571428571,0.403846153846154,0,"orthodox"
"62545",26,27,170,173,170,173,144,142,16,12,2,6,9,7,"win_A",-1,-3,-3,2,0,0,0,0,0.888888888888889,0.666666666666667,0.5,0.388888888888889,0,"orthodox"
"62590",22,22,163,173,164,173,127,126,6,6,0,4,2,1,"win_A",0,-10,-9,1,0,0,0,0,1,0.6,0.333333333333333,0.1,0,"Unknown"
"62841",31,32,168,173,183,183,143,144,59,24,2,14,34,8,"win_A",-1,-5,0,-1,0,0,0,0,0.967213114754098,0.631578947368421,0.557377049180328,0.210526315789474,0,"orthodox"
"62842",35,30,175,168,174,183,139,140,21,58,2,2,14,33,"win_B",5,7,-9,-1,1,0,0,0,0.91304347826087,0.966666666666667,0.608695652173913,0.55,1,"orthodox"
"62843",30,25,168,178,183,180,140,140,57,16,2,12,33,7,"win_A",5,-10,3,0,0,0,0,0,0.966101694915254,0.571428571428571,0.559322033898305,0.25,0,"orthodox"
"62852",27,31,168,173,183,185,135,135,47,34,2,2,27,15,"win_A",-4,-5,-2,0,0,0,0,0,0.959183673469388,0.944444444444444,0.551020408163265,0.416666666666667,0,"orthodox"
"62857",30,26,165,168,165,183,130,130,39,43,2,1,28,25,"win_A",4,-3,-18,0,0,0,0,0,0.951219512195122,0.977272727272727,0.682926829268293,0.568181818181818,0,"orthodox"
"62859",25,30,168,173,183,178,130,130,41,29,1,3,24,19,"win_A",-5,-5,5,0,0,0,0,0,0.976190476190476,0.90625,0.571428571428571,0.59375,0,"orthodox"
"62877",22,22,168,176,183,177,135,135,23,13,1,2,8,6,"win_A",0,-8,6,0,0,0,0,0,0.958333333333333,0.866666666666667,0.333333333333333,0.4,0,"orthodox"
"62885",20,27,168,165,183,165,118,118,16,14,0,4,6,11,"win_B",-7,3,18,0,0,0,0,0,1,0.777777777777778,0.375,0.611111111111111,1,"orthodox"
"62888",19,24,168,169,183,173,118,118,13,24,0,5,5,19,"win_A",-5,-1,10,0,0,0,0,0,1,0.827586206896552,0.384615384615385,0.655172413793103,0,"orthodox"
"62961",36,31,183,180,173,185,160,160,37,21,1,6,24,12,"win_B",5,3,-12,0,1,0,0,0,0.973684210526316,0.777777777777778,0.631578947368421,0.444444444444444,1,"southpaw"
"62965",29,30,180,183,185,185,163,163,17,22,5,1,11,6,"win_A",-1,-3,0,0,0,0,0,0,0.772727272727273,0.956521739130435,0.5,0.260869565217391,0,"orthodox"
"62966",30,28,183,180,175,185,168,167,31,16,2,4,11,10,"win_B",2,3,-10,1,0,0,0,0,0.939393939393939,0.8,0.333333333333333,0.5,1,"orthodox"
"62969",24,26,175,180,178,185,157,156,23,16,0,1,20,10,"win_A",-2,-5,-7,1,0,0,0,0,1,0.941176470588235,0.869565217391304,0.588235294117647,0,"southpaw"
"62971",23,25,188,180,185,185,168,168,16,14,1,0,12,9,"win_A",-2,8,0,0,0,0,0,0,0.941176470588235,1,0.705882352941177,0.642857142857143,0,"orthodox"
"62972",25,27,180,188,185,201,165,164,12,17,0,1,9,14,"win_A",-2,-8,-16,1,0,0,0,0,1,0.944444444444444,0.75,0.777777777777778,0,"orthodox"
"63184",23,35,202,183,201,191,249,236,9,20,1,18,6,15,"win_A",-12,19,10,13,0,1,0,0,0.9,0.526315789473684,0.6,0.394736842105263,0,"orthodox"
"63186",22,37,202,185,201,191,258,222,7,29,1,17,6,16,"win_A",-15,17,10,36,0,1,1,0,0.875,0.630434782608696,0.75,0.347826086956522,0,"orthodox"
"63188",29,22,188,202,198,201,260,205,3,6,0,0,3,5,"win_B",7,-14,-3,55,0,0,1,0,1,1,1,0.833333333333333,1,"Unknown"
"63239",31,24,173,178,178,182,145,145,18,7,5,13,5,2,"win_A",7,-5,-4,0,0,0,0,0,0.782608695652174,0.35,0.217391304347826,0.1,0,"orthodox"
"63243",39,27,173,173,185,178,140,140,42,16,7,0,18,3,"win_A",12,0,7,0,1,0,0,0,0.857142857142857,1,0.36734693877551,0.1875,0,"orthodox"
"63386",29,31,188,173,192,184,204,222,15,13,0,6,11,7,"win_A",-2,15,8,-18,0,0,0,1,1,0.684210526315789,0.733333333333333,0.368421052631579,0,"orthodox"
"63391",34,28,183,173,178,184,184,185,30,9,10,5,21,4,"win_B",6,10,-6,-1,0,0,0,0,0.75,0.642857142857143,0.525,0.285714285714286,1,"orthodox"
"63563",27,27,165,163,170,173,125,124,4,5,0,10,3,0,"win_A",0,2,-3,1,0,0,0,0,1,0.333333333333333,0.75,0,0,"Unknown"
"63741",26,37,178,173,189,178,135,135,15,18,0,8,10,8,"win_A",-11,5,11,0,0,1,0,0,1,0.692307692307692,0.666666666666667,0.307692307692308,0,"Unknown"
"63744",25,40,178,168,189,175,136,138,12,23,0,44,7,18,"win_A",-15,10,14,-2,0,1,0,0,1,0.343283582089552,0.583333333333333,0.26865671641791,0,"Unknown"
"63748",24,35,178,173,189,178,135,135,8,18,0,5,5,8,"win_A",-11,5,11,0,0,1,0,0,1,0.782608695652174,0.625,0.347826086956522,0,"Unknown"
"64381",26,21,180,185,188,183,161,161,23,9,5,0,15,6,"win_A",5,-5,5,0,0,0,0,0,0.821428571428571,1,0.535714285714286,0.666666666666667,0,"orthodox"
"64565",37,28,168,173,178,178,151,153,27,26,8,53,16,6,"win_A",9,-5,0,-2,1,0,0,0,0.771428571428571,0.329113924050633,0.457142857142857,0.0759493670886076,0,"orthodox"
"64569",35,33,168,180,178,188,147,147,24,29,4,6,15,19,"win_A",2,-12,-10,0,1,0,0,0,0.857142857142857,0.828571428571429,0.535714285714286,0.542857142857143,0,"orthodox"
"64580",31,31,168,173,178,178,140,139,15,23,0,33,9,17,"win_A",0,-5,0,1,0,0,0,0,1,0.410714285714286,0.6,0.303571428571429,0,"orthodox"
"64586",30,25,168,170,178,178,134,136,9,8,0,6,6,4,"win_A",5,-2,0,-2,0,0,0,0,1,0.571428571428571,0.666666666666667,0.285714285714286,0,"orthodox"
"64587",29,22,168,170,178,178,139,135,8,5,0,5,5,5,"win_A",7,-2,0,4,0,0,0,0,1,0.5,0.625,0.5,0,"orthodox"
"64588",29,23,168,178,178,180,142,141,7,6,0,5,5,2,"win_A",6,-10,-2,1,0,0,0,0,1,0.545454545454545,0.714285714285714,0.181818181818182,0,"orthodox"
"64873",21,22,183,170,189,178,147,147,6,3,0,3,6,2,"win_A",-1,13,11,0,0,0,0,0,1,0.5,1,0.333333333333333,0,"Unknown"
"64902",27,29,180,175,183,174,140,138,23,15,2,1,19,10,"win_A",-2,5,9,2,0,0,0,0,0.92,0.9375,0.76,0.625,0,"orthodox"
"64903",27,32,180,170,183,176,141,142,22,19,2,12,19,14,"win_A",-5,10,7,-1,0,0,0,0,0.916666666666667,0.612903225806452,0.791666666666667,0.451612903225806,0,"orthodox"
"64905",25,26,173,180,173,183,135,134,29,21,0,1,22,18,"win_A",-1,-7,-10,1,0,0,0,0,1,0.954545454545455,0.758620689655172,0.818181818181818,0,"orthodox"
"65581",23,21,170,175,170,177,123,123,11,8,0,0,5,3,"win_A",2,-5,-7,0,0,0,0,0,1,1,0.454545454545455,0.375,0,"Unknown"
"65583",19,21,170,175,178,177,124,124,4,6,0,0,3,3,"win_B",-2,-5,1,0,0,0,0,0,1,1,0.75,0.5,1,"Unknown"
"65640",27,27,173,170,183,180,136,136,3,14,0,1,1,9,"win_A",0,3,3,0,0,0,0,0,1,0.933333333333333,0.333333333333333,0.6,0,"orthodox"
"65791",31,30,179,160,170,169,130,130,31,36,6,2,16,20,"win_A",1,19,1,0,0,0,0,0,0.837837837837838,0.947368421052632,0.432432432432432,0.526315789473684,0,"orthodox"
"65793",31,24,179,166,170,173,131,130,29,14,6,19,15,11,"win_A",7,13,-3,1,0,0,0,0,0.828571428571429,0.424242424242424,0.428571428571429,0.333333333333333,0,"orthodox"
"65797",28,32,179,169,170,168,130,129,24,25,4,5,12,14,"win_A",-4,10,2,1,0,0,0,0,0.857142857142857,0.833333333333333,0.428571428571429,0.466666666666667,0,"orthodox"
"65798",24,27,175,179,180,170,126,126,20,24,1,3,13,12,"win_A",-3,-4,10,0,0,0,0,0,0.952380952380952,0.888888888888889,0.619047619047619,0.444444444444444,0,"southpaw"
"65803",24,25,170,179,175,170,127,127,29,19,0,3,14,12,"win_B",-1,-9,5,0,0,0,0,0,1,0.863636363636364,0.482758620689655,0.545454545454545,1,"southpaw"
"65806",34,24,173,179,173,170,123,123,43,17,7,2,35,11,"win_B",10,-6,3,0,0,0,0,0,0.86,0.894736842105263,0.7,0.578947368421053,1,"orthodox"
"65810",23,28,179,173,170,178,127,126,13,11,2,2,9,4,"win_A",-5,6,-8,1,0,0,0,0,0.866666666666667,0.846153846153846,0.6,0.307692307692308,0,"orthodox"
"65813",22,25,179,165,170,173,126,126,10,22,2,2,6,13,"win_A",-3,14,-3,0,0,0,0,0,0.833333333333333,0.916666666666667,0.5,0.541666666666667,0,"orthodox"
"65821",20,19,179,174,170,174,126,126,3,3,1,4,1,0,"win_A",1,5,-4,0,0,0,0,0,0.75,0.428571428571429,0.25,0,0,"orthodox"
"65935",28,31,180,175,188,183,140,140,27,37,2,3,18,27,"win_A",-3,5,5,0,0,0,0,0,0.931034482758621,0.925,0.620689655172414,0.675,0,"orthodox"
"65937",27,21,180,173,188,178,143,143,25,22,2,19,17,5,"win_A",6,7,10,0,0,0,0,0,0.925925925925926,0.536585365853659,0.62962962962963,0.121951219512195,0,"orthodox"
"65938",33,27,179,180,185,188,139,139,19,25,2,1,17,17,"win_A",6,-1,-3,0,0,0,0,0,0.904761904761905,0.961538461538462,0.80952380952381,0.653846153846154,0,"orthodox"
"65944",23,28,180,173,188,175,139,137,18,22,1,3,15,19,"win_A",-5,7,13,2,0,0,0,0,0.947368421052632,0.88,0.789473684210526,0.76,0,"orthodox"
"65945",22,26,180,173,188,178,140,138,17,20,1,4,14,14,"win_A",-4,7,10,2,0,0,0,0,0.944444444444444,0.833333333333333,0.777777777777778,0.583333333333333,0,"orthodox"
"65947",31,21,180,180,185,188,140,141,37,16,7,0,16,13,"win_A",10,0,-3,-1,0,0,0,0,0.840909090909091,1,0.363636363636364,0.8125,0,"orthodox"
"66003",31,25,193,189,208,191,219,241,10,4,5,0,4,3,"win_A",6,4,17,-22,0,0,0,1,0.666666666666667,1,0.266666666666667,0.75,0,"orthodox"
"66083",25,41,192,196,195,211,243,247,16,14,6,9,11,13,"win_A",-16,-4,-16,-4,0,1,0,0,0.727272727272727,0.608695652173913,0.5,0.565217391304348,0,"orthodox"
"66084",30,24,191,192,193,195,238,234,30,16,2,5,26,11,"win_A",6,-1,-2,4,0,0,0,0,0.9375,0.761904761904762,0.8125,0.523809523809524,0,"orthodox"
"66085",41,24,188,192,191,195,232,221,27,16,6,4,19,11,"win_A",17,-4,-4,11,1,0,0,0,0.818181818181818,0.8,0.575757575757576,0.55,0,"southpaw"
"66087",24,37,192,198,195,208,231,247,15,14,3,6,10,8,"win_A",-13,-6,-13,-16,0,1,0,1,0.833333333333333,0.7,0.555555555555556,0.4,0,"orthodox"
"66089",40,23,191,192,201,195,229,243,36,14,6,2,27,9,"win_B",17,-1,6,-14,1,0,0,0,0.857142857142857,0.875,0.642857142857143,0.5625,1,"orthodox"
"66098",22,23,192,188,195,190,234,241,7,6,0,5,5,4,"win_A",-1,4,5,-7,0,0,0,0,1,0.545454545454545,0.714285714285714,0.363636363636364,0,"orthodox"
"66127",24,29,183,180,181,180,152,154,12,5,0,4,9,0,"win_A",-5,3,1,-2,0,0,0,0,1,0.555555555555556,0.75,0,0,"orthodox"
"66128",24,27,183,176,181,179,152,150,11,20,0,9,8,14,"win_A",-3,7,2,2,0,0,0,0,1,0.689655172413793,0.727272727272727,0.482758620689655,0,"orthodox"
"66134",22,30,183,171,181,170,153,152,5,6,0,5,4,5,"win_A",-8,12,11,1,0,0,0,0,1,0.545454545454545,0.8,0.454545454545455,0,"orthodox"
"66205",26,24,180,170,185,173,140,142,7,9,2,4,3,0,"win_A",2,10,12,-2,0,0,0,0,0.777777777777778,0.692307692307692,0.333333333333333,0,0,"orthodox"
"66263",35,41,178,178,178,189,168,166,26,22,8,26,24,16,"win_A",-6,0,-11,2,1,1,0,0,0.764705882352941,0.458333333333333,0.705882352941177,0.333333333333333,0,"orthodox"
"66267",33,40,178,178,178,189,160,161,23,22,6,20,21,16,"win_A",-7,0,-11,-1,0,1,0,0,0.793103448275862,0.523809523809524,0.724137931034483,0.380952380952381,0,"orthodox"
"66272",30,37,178,178,178,189,159,156,18,22,5,13,16,16,"win_A",-7,0,-11,3,0,1,0,0,0.782608695652174,0.628571428571429,0.695652173913043,0.457142857142857,0,"orthodox"
"66279",30,27,180,178,185,178,155,156,13,13,1,3,2,11,"win_A",3,2,7,-1,0,0,0,0,0.928571428571429,0.8125,0.142857142857143,0.6875,0,"southpaw"
"66283",26,38,178,180,178,183,154,155,11,4,1,5,10,3,"win_A",-12,-2,-5,-1,0,1,0,0,0.916666666666667,0.444444444444444,0.833333333333333,0.333333333333333,0,"orthodox"
"66286",25,24,178,175,178,178,152,149,9,9,0,5,9,9,"win_A",1,3,0,3,0,0,0,0,1,0.642857142857143,1,0.642857142857143,0,"orthodox"
"66303",33,24,180,177,189,173,159,161,28,22,4,2,17,8,"win_A",9,3,16,-2,0,0,0,0,0.875,0.916666666666667,0.53125,0.333333333333333,0,"orthodox"
"66362",32,32,180,175,183,180,155,154,30,14,2,9,8,6,"win_A",0,5,3,1,0,0,0,0,0.9375,0.608695652173913,0.25,0.260869565217391,0,"orthodox"
"66363",33,31,183,175,187,180,159,160,20,14,1,8,13,6,"win_A",2,8,7,-1,0,0,0,0,0.952380952380952,0.636363636363636,0.619047619047619,0.272727272727273,0,"orthodox"
"66366",25,29,178,175,183,180,153,152,35,12,4,6,31,6,"win_A",-4,3,3,1,0,0,0,0,0.897435897435897,0.666666666666667,0.794871794871795,0.333333333333333,0,"orthodox"
"66501",20,22,175,168,170,173,155,155,5,4,0,1,5,0,"win_A",-2,7,-3,0,0,0,0,0,1,0.8,1,0,0,"Unknown"
"66680",28,26,170,170,170,170,139,139,24,29,1,2,13,18,"win_A",2,0,0,0,0,0,0,0,0.96,0.935483870967742,0.52,0.580645161290323,0,"orthodox"
"66698",22,23,175,170,178,170,140,139,12,13,0,0,2,11,"win_A",-1,5,8,1,0,0,0,0,1,1,0.166666666666667,0.846153846153846,0,"orthodox"
"67002",40,35,178,188,183,203,230,219,70,29,6,4,43,18,"win_A",5,-10,-20,11,1,1,0,0,0.921052631578947,0.878787878787879,0.565789473684211,0.545454545454545,0,"orthodox"
"67003",38,30,178,185,183,191,229,222,69,25,6,4,43,12,"win_A",8,-7,-8,7,1,0,0,0,0.92,0.862068965517241,0.573333333333333,0.413793103448276,0,"orthodox"
"67004",26,38,188,178,196,183,234,249,27,69,1,5,22,43,"win_A",-12,10,13,-15,0,1,0,1,0.964285714285714,0.932432432432432,0.785714285714286,0.581081081081081,0,"orthodox"
"67005",25,38,188,178,196,183,233,257,26,69,1,4,22,43,"win_A",-13,10,13,-24,0,1,0,1,0.962962962962963,0.945205479452055,0.814814814814815,0.589041095890411,0,"orthodox"
"67006",37,30,178,191,183,198,235,221,68,25,4,2,43,18,"win_A",7,-13,-15,14,1,0,0,0,0.944444444444444,0.925925925925926,0.597222222222222,0.666666666666667,0,"orthodox"
"67007",36,23,178,191,183,206,227,220,67,22,4,0,43,12,"win_A",13,-13,-23,7,1,0,0,0,0.943661971830986,1,0.605633802816901,0.545454545454545,0,"orthodox"
"67008",35,40,178,189,183,198,217,219,66,38,4,6,42,25,"win_A",-5,-11,-15,-2,1,1,0,0,0.942857142857143,0.863636363636364,0.6,0.568181818181818,0,"orthodox"
"67009",34,29,178,188,183,188,190,188,65,31,4,0,42,27,"win_A",5,-10,-5,2,0,0,0,0,0.942028985507246,1,0.608695652173913,0.870967741935484,0,"orthodox"
"67014",32,30,178,180,183,183,203,198,60,34,4,9,38,30,"win_A",2,-2,0,5,0,0,0,0,0.9375,0.790697674418605,0.59375,0.697674418604651,0,"orthodox"
"67016",31,33,178,185,183,196,195,195,58,18,4,1,37,9,"win_A",-2,-7,-13,0,0,0,0,0,0.935483870967742,0.947368421052632,0.596774193548387,0.473684210526316,0,"orthodox"
"67017",31,28,178,188,183,198,195,197,57,14,4,1,37,11,"win_A",3,-10,-15,-2,0,0,0,0,0.934426229508197,0.933333333333333,0.60655737704918,0.733333333333333,0,"orthodox"
"67018",30,31,178,182,183,193,197,199,56,27,4,7,36,16,"win_A",-1,-4,-10,-2,0,0,0,0,0.933333333333333,0.794117647058823,0.6,0.470588235294118,0,"orthodox"
"67020",32,28,178,178,183,183,189,187,24,54,14,4,5,35,"win_B",4,0,0,2,0,0,0,0,0.631578947368421,0.931034482758621,0.131578947368421,0.603448275862069,1,"orthodox"
"67022",28,40,178,182,183,189,181,182,53,49,3,4,35,36,"win_A",-12,-4,-6,-1,0,1,0,0,0.946428571428571,0.924528301886792,0.625,0.679245283018868,0,"orthodox"
"67023",26,28,170,178,178,183,175,173,25,53,0,2,18,35,"win_A",-2,-8,-5,2,0,0,0,0,1,0.963636363636364,0.72,0.636363636363636,0,"orthodox"
"67030",26,31,178,180,183,196,175,175,46,21,2,3,31,20,"win_A",-5,-2,-13,0,0,0,0,0,0.958333333333333,0.875,0.645833333333333,0.833333333333333,0,"orthodox"
"67041",24,30,178,175,183,180,173,172,36,24,0,1,25,13,"win_A",-6,3,3,1,0,0,0,0,1,0.96,0.694444444444444,0.52,0,"orthodox"
"67044",32,24,185,178,188,183,167,168,30,33,7,0,18,22,"win_B",8,7,5,-1,0,0,0,0,0.810810810810811,1,0.486486486486487,0.666666666666667,1,"orthodox"
"67051",24,22,178,178,183,183,159,159,29,26,1,0,19,19,"win_B",2,0,0,0,0,0,0,0,0.966666666666667,1,0.633333333333333,0.730769230769231,1,"southpaw"
"67052",28,22,185,178,196,183,157,160,36,25,0,0,24,18,"win_B",6,7,13,-3,0,0,0,0,1,1,0.666666666666667,0.72,1,"southpaw"
"67234",21,32,172,160,173,165,122,122,10,3,0,3,4,0,"win_A",-11,12,8,0,0,0,0,0,1,0.5,0.4,0,0,"southpaw"
"67235",24,21,162,172,165,173,122,122,2,9,5,0,1,3,"win_B",3,-10,-8,0,0,0,0,0,0.285714285714286,1,0.142857142857143,0.333333333333333,1,"orthodox"
"67236",21,19,172,168,173,168,121,121,8,5,0,1,3,2,"win_A",2,4,5,0,0,0,0,0,1,0.833333333333333,0.375,0.333333333333333,0,"southpaw"
"67237",26,21,170,172,170,173,122,122,1,7,2,0,1,3,"win_B",5,-2,-3,0,0,0,0,0,0.333333333333333,1,0.333333333333333,0.428571428571429,1,"orthodox"
"67238",21,24,172,165,173,165,125,125,6,1,0,0,3,1,"win_A",-3,7,8,0,0,0,0,0,1,1,0.5,1,0,"southpaw"
"67241",20,20,172,168,173,168,122,122,3,0,0,3,2,0,"win_A",0,4,5,0,0,0,0,0,1,0,0.666666666666667,0,0,"southpaw"
"67304",42,25,163,163,173,160,138,132,11,10,49,5,2,4,"win_B",17,0,13,6,1,0,0,0,0.183333333333333,0.666666666666667,0.0333333333333333,0.266666666666667,1,"orthodox"
"67309",23,30,163,178,160,191,139,138,6,12,2,20,3,7,"win_A",-7,-15,-31,1,0,0,0,0,0.75,0.375,0.375,0.21875,0,"Unknown"
"67312",22,33,163,170,160,175,138,137,3,1,1,8,2,0,"win_A",-11,-7,-15,1,0,0,0,0,0.75,0.111111111111111,0.5,0,0,"Unknown"
"67650",27,30,175,178,178,180,140,140,17,17,6,6,3,5,"win_B",-3,-3,-2,0,0,0,0,0,0.739130434782609,0.739130434782609,0.130434782608696,0.217391304347826,1,"orthodox"
"67655",26,25,178,175,180,168,141,142,15,19,2,4,5,14,"win_A",1,3,12,-1,0,0,0,0,0.882352941176471,0.826086956521739,0.294117647058824,0.608695652173913,0,"orthodox"
"67666",24,23,173,178,183,180,139,140,13,6,4,0,4,3,"win_B",1,-5,3,-1,0,0,0,0,0.764705882352941,1,0.235294117647059,0.5,1,"orthodox"
"67705",36,19,173,167,173,169,154,150,45,10,5,16,25,6,"win_A",17,6,4,4,1,0,0,0,0.9,0.384615384615385,0.5,0.230769230769231,0,"southpaw"
"67707",28,35,170,173,180,173,146,146,13,44,5,4,7,24,"win_A",-7,-3,7,0,0,1,0,0,0.722222222222222,0.916666666666667,0.388888888888889,0.5,0,"southpaw"
"67710",34,25,173,175,173,180,144,147,41,20,4,4,21,12,"win_A",9,-2,-7,-3,0,0,0,0,0.911111111111111,0.833333333333333,0.466666666666667,0.5,0,"southpaw"
"67720",30,37,173,170,173,183,139,140,31,32,4,12,15,11,"win_A",-7,3,-10,-1,0,1,0,0,0.885714285714286,0.727272727272727,0.428571428571429,0.25,0,"southpaw"
"67722",30,29,173,170,173,157,135,134,29,19,4,8,13,9,"win_A",1,3,16,1,0,0,0,0,0.878787878787879,0.703703703703704,0.393939393939394,0.333333333333333,0,"southpaw"
"67724",29,25,173,178,173,185,134,132,27,3,4,3,12,2,"win_A",4,-5,-12,2,0,0,0,0,0.870967741935484,0.5,0.387096774193548,0.333333333333333,0,"southpaw"
"67732",25,22,173,174,173,168,135,135,20,2,2,1,11,2,"win_A",3,-1,5,0,0,0,0,0,0.909090909090909,0.666666666666667,0.5,0.666666666666667,0,"southpaw"
"67733",25,23,173,171,173,173,135,135,19,1,2,0,10,1,"win_A",2,2,0,0,0,0,0,0,0.904761904761905,1,0.476190476190476,1,0,"southpaw"
"67734",24,22,173,173,173,184,134,135,18,8,2,1,10,5,"win_A",2,0,-11,-1,0,0,0,0,0.9,0.888888888888889,0.5,0.555555555555556,0,"southpaw"
"67737",24,23,168,173,175,173,133,133,9,16,2,1,6,10,"win_A",1,-5,2,0,0,0,0,0,0.818181818181818,0.941176470588235,0.545454545454545,0.588235294117647,0,"southpaw"
"67738",21,23,173,173,184,173,132,132,2,16,0,0,1,10,"win_A",-2,0,11,0,0,0,0,0,1,1,0.5,0.625,0,"orthodox"
"68064",22,26,170,163,175,173,125,126,13,23,0,12,8,17,"win_A",-4,7,2,-1,0,0,0,0,1,0.657142857142857,0.615384615384615,0.485714285714286,0,"southpaw"
"68080",22,22,168,163,164,173,115,115,21,10,2,3,13,7,"win_A",0,5,-9,0,0,0,0,0,0.91304347826087,0.769230769230769,0.565217391304348,0.538461538461538,0,"orthodox"
"68117",27,23,161,165,166,170,115,116,31,8,4,3,19,5,"win_A",4,-4,-4,-1,0,0,0,0,0.885714285714286,0.727272727272727,0.542857142857143,0.454545454545455,0,"orthodox"
"68122",23,23,165,161,169,166,108,108,10,28,0,1,6,17,"win_A",0,4,3,0,0,0,0,0,1,0.96551724137931,0.6,0.586206896551724,0,"orthodox"
"68547",17,29,175,173,183,180,147,143,1,0,0,3,0,0,"win_A",-12,2,3,4,0,0,0,0,1,0,0,0,0,"Unknown"
"69052",30,25,163,178,160,171,136,132,17,24,2,4,10,17,"win_B",5,-15,-11,4,0,0,0,0,0.894736842105263,0.857142857142857,0.526315789473684,0.607142857142857,1,"orthodox"
"69053",38,30,166,163,173,160,126,126,41,16,8,2,37,9,"win_B",8,3,13,0,1,0,0,0,0.836734693877551,0.888888888888889,0.755102040816326,0.5,1,"orthodox"
"69054",29,25,163,175,160,174,122,122,16,21,1,0,9,12,"win_B",4,-12,-14,0,0,0,0,0,0.941176470588235,1,0.529411764705882,0.571428571428571,1,"orthodox"
"69055",28,32,163,168,160,173,123,124,15,21,0,23,9,10,"win_A",-4,-5,-13,-1,0,0,0,0,1,0.477272727272727,0.6,0.227272727272727,0,"orthodox"
"69293",22,39,163,160,168,168,118,118,12,27,0,17,7,18,"win_A",-17,3,0,0,0,1,0,0,1,0.613636363636364,0.583333333333333,0.409090909090909,0,"southpaw"
"69311",27,33,170,175,175,175,148,146,7,13,1,15,2,5,"win_A",-6,-5,0,2,0,0,0,0,0.875,0.464285714285714,0.25,0.178571428571429,0,"southpaw"
"69913",36,33,185,177,196,175,156,155,35,15,12,15,23,6,"win_A",3,8,21,1,1,0,0,0,0.74468085106383,0.5,0.48936170212766,0.2,0,"orthodox"
"69918",34,38,185,179,196,188,156,156,30,27,12,8,18,16,"win_A",-4,6,8,0,0,1,0,0,0.714285714285714,0.771428571428571,0.428571428571429,0.457142857142857,0,"orthodox"
"69922",32,22,185,175,196,173,154,154,26,13,12,2,16,2,"win_A",10,10,23,0,0,0,0,0,0.684210526315789,0.866666666666667,0.421052631578947,0.133333333333333,0,"orthodox"
"69925",28,30,183,185,189,196,159,159,17,24,1,11,5,15,"win_A",-2,-2,-7,0,0,0,0,0,0.944444444444444,0.685714285714286,0.277777777777778,0.428571428571429,0,"orthodox"
"69940",24,25,173,185,173,196,155,154,14,15,1,5,10,11,"win_A",-1,-12,-23,1,0,0,0,0,0.933333333333333,0.75,0.666666666666667,0.55,0,"orthodox"
"70051",23,34,183,173,185,175,155,155,24,15,2,6,23,5,"win_A",-11,10,10,0,0,0,0,0,0.923076923076923,0.714285714285714,0.884615384615385,0.238095238095238,0,"orthodox"
"70220",26,33,185,173,193,183,161,163,19,28,1,7,9,16,"win_B",-7,12,10,-2,0,0,0,0,0.95,0.8,0.45,0.457142857142857,1,"southpaw"
"70601",25,40,171,168,175,173,152,153,13,38,3,7,2,22,"win_B",-15,3,2,-1,0,1,0,0,0.8125,0.844444444444444,0.125,0.488888888888889,1,"orthodox"
"70786",25,25,180,175,193,185,163,162,7,7,0,5,6,4,"win_A",0,5,8,1,0,0,0,0,1,0.583333333333333,0.857142857142857,0.333333333333333,0,"orthodox"
"70792",20,28,180,173,193,178,170,171,1,3,0,4,1,3,"win_A",-8,7,15,-1,0,0,0,0,1,0.428571428571429,1,0.428571428571429,0,"orthodox"
"70954",19,30,170,160,170,160,107,107,3,3,2,0,0,1,"win_B",-11,10,10,0,0,0,0,0,0.6,1,0,0.333333333333333,1,"orthodox"
"70955",30,22,160,161,160,163,107,108,2,0,0,2,1,0,"win_A",8,-1,-3,-1,0,0,0,0,1,0,0.5,0,0,"orthodox"
"70956",30,19,160,160,160,164,108,107,1,0,0,2,1,0,"win_A",11,0,-4,1,0,0,0,0,1,0,1,0,0,"orthodox"
"71154",35,26,162,165,183,171,125,126,28,4,14,4,14,3,"win_B",9,-3,12,-1,1,0,0,0,0.666666666666667,0.5,0.333333333333333,0.375,1,"orthodox"
"71155",18,25,179,165,183,171,129,130,6,4,0,3,4,3,"win_A",-7,14,12,-1,0,0,0,0,1,0.571428571428571,0.666666666666667,0.428571428571429,0,"orthodox"
"71157",17,24,175,165,178,171,130,129,1,1,2,3,1,1,"win_B",-7,10,7,1,0,0,0,0,0.333333333333333,0.25,0.333333333333333,0.25,1,"orthodox"
"71374",25,35,183,174,185,178,154,153,27,27,3,12,26,17,"win_A",-10,9,7,1,0,1,0,0,0.9,0.692307692307692,0.866666666666667,0.435897435897436,0,"orthodox"
"71377",23,42,183,173,185,188,154,153,22,27,2,10,21,17,"win_A",-19,10,-3,1,0,1,0,0,0.916666666666667,0.72972972972973,0.875,0.459459459459459,0,"orthodox"
"71383",22,38,183,183,185,188,155,152,15,24,2,21,15,18,"win_A",-16,0,-3,3,0,1,0,0,0.882352941176471,0.533333333333333,0.882352941176471,0.4,0,"orthodox"
"71388",21,38,183,173,185,185,161,159,11,22,1,15,11,8,"win_A",-17,10,0,2,0,1,0,0,0.916666666666667,0.594594594594595,0.916666666666667,0.216216216216216,0,"orthodox"
"71394",20,26,183,178,185,180,150,150,6,10,0,23,6,4,"win_A",-6,5,5,0,0,0,0,0,1,0.303030303030303,1,0.121212121212121,0,"orthodox"
"71904",35,30,187,183,192,191,236,280,18,6,4,10,7,2,"win_A",5,4,1,-44,1,0,0,1,0.818181818181818,0.375,0.318181818181818,0.125,0,"orthodox"
"71905",29,32,188,187,190,192,230,258,22,18,10,2,15,7,"win_A",-3,1,-2,-28,0,0,0,1,0.6875,0.9,0.46875,0.35,0,"southpaw"
"72172",30,29,170,178,178,178,147,147,22,29,4,9,16,21,"win_B",1,-8,0,0,0,0,0,0,0.846153846153846,0.763157894736842,0.615384615384615,0.552631578947368,1,"orthodox"
"72173",25,29,173,178,180,178,147,147,18,28,2,9,11,20,"win_B",-4,-5,2,0,0,0,0,0,0.9,0.756756756756757,0.55,0.540540540540541,1,"orthodox"
"72176",28,29,178,177,178,183,147,147,26,22,7,1,18,11,"win_A",-1,1,-5,0,0,0,0,0,0.787878787878788,0.956521739130435,0.545454545454545,0.478260869565217,0,"orthodox"
"72179",26,27,178,173,178,178,139,140,23,22,7,5,16,16,"win_A",-1,5,0,-1,0,0,0,0,0.766666666666667,0.814814814814815,0.533333333333333,0.592592592592593,0,"orthodox"
"72184",27,23,182,178,185,178,139,139,30,20,2,5,20,15,"win_A",4,4,7,0,0,0,0,0,0.9375,0.8,0.625,0.6,0,"orthodox"
"72185",23,31,178,173,178,178,140,140,19,18,5,1,15,8,"win_A",-8,5,0,0,0,0,0,0,0.791666666666667,0.947368421052632,0.625,0.421052631578947,0,"orthodox"
"72187",29,23,175,178,180,178,139,140,28,18,4,4,8,14,"win_A",6,-3,2,-1,0,0,0,0,0.875,0.818181818181818,0.25,0.636363636363636,0,"southpaw"
"72262",23,27,173,168,173,163,132,130,15,20,1,5,13,14,"win_A",-4,5,10,2,0,0,0,0,0.9375,0.8,0.8125,0.56,0,"orthodox"
"72274",33,20,175,168,188,163,126,126,33,11,4,0,24,9,"win_A",13,7,25,0,0,0,0,0,0.891891891891892,1,0.648648648648649,0.818181818181818,0,"southpaw"
"72379",21,22,178,167,178,167,129,129,5,9,4,3,1,3,"win_B",-1,11,11,0,0,0,0,0,0.555555555555556,0.75,0.111111111111111,0.25,1,"orthodox"
"72574",23,18,170,179,172,183,130,129,2,5,1,0,1,3,"win_B",5,-9,-11,1,0,0,0,0,0.666666666666667,1,0.333333333333333,0.6,1,"southpaw"
"72576",26,17,168,179,162,183,129,128,1,3,2,0,1,1,"win_B",9,-11,-21,1,0,0,0,0,0.333333333333333,1,0.333333333333333,0.333333333333333,1,"orthodox"
"72630",21,21,165,164,165,163,119,119,6,3,0,0,2,2,"win_A",0,1,2,0,0,0,0,0,1,1,0.333333333333333,0.666666666666667,0,"orthodox"
"73021",25,31,163,163,165,165,115,115,27,28,2,6,20,21,"win_B",-6,0,0,0,0,0,0,0,0.931034482758621,0.823529411764706,0.689655172413793,0.617647058823529,1,"southpaw"
"73031",21,30,163,163,165,173,108,108,18,30,1,3,15,24,"win_A",-9,0,-8,0,0,0,0,0,0.947368421052632,0.909090909090909,0.789473684210526,0.727272727272727,0,"southpaw"
"73035",20,33,163,160,165,168,108,108,14,25,1,5,12,17,"win_A",-13,3,-3,0,0,0,0,0,0.933333333333333,0.833333333333333,0.8,0.566666666666667,0,"southpaw"
"73037",20,27,163,161,165,168,108,108,12,18,1,6,10,13,"win_A",-7,2,-3,0,0,0,0,0,0.923076923076923,0.75,0.769230769230769,0.541666666666667,0,"southpaw"
"73144",30,31,164,157,168,163,119,119,53,24,6,13,40,14,"win_A",-1,7,5,0,0,0,0,0,0.898305084745763,0.648648648648649,0.677966101694915,0.378378378378378,0,"orthodox"
"73149",23,30,168,157,177,163,117,118,22,22,1,8,8,12,"win_A",-7,11,14,-1,0,0,0,0,0.956521739130435,0.733333333333333,0.347826086956522,0.4,0,"southpaw"
"73150",28,28,163,157,169,163,113,115,34,22,2,7,25,12,"win_A",0,6,6,-2,0,0,0,0,0.944444444444444,0.758620689655172,0.694444444444444,0.413793103448276,0,"orthodox"
"73153",22,27,174,157,178,163,118,118,14,19,2,6,12,12,"win_A",-5,17,15,0,0,0,0,0,0.875,0.76,0.75,0.48,0,"southpaw"
"73154",23,27,169,157,168,163,119,119,13,19,0,5,4,12,"win_A",-4,12,5,0,0,0,0,0,1,0.791666666666667,0.307692307692308,0.5,0,"orthodox"
"73155",26,27,160,157,163,163,115,115,23,18,4,5,16,11,"win_B",-1,3,0,0,0,0,0,0,0.851851851851852,0.782608695652174,0.592592592592593,0.478260869565217,1,"orthodox"
"73156",28,26,165,157,175,163,115,115,28,18,6,4,21,11,"win_A",2,8,12,0,0,0,0,0,0.823529411764706,0.818181818181818,0.617647058823529,0.5,0,"orthodox"
"73157",26,22,157,168,163,170,115,116,17,12,4,4,11,8,"win_A",4,-11,-7,-1,0,0,0,0,0.80952380952381,0.75,0.523809523809524,0.5,0,"orthodox"
"73208",33,30,185,182,178,184,167,164,5,8,0,5,4,3,"win_A",3,3,-6,3,0,0,0,0,1,0.615384615384615,0.8,0.230769230769231,0,"orthodox"
"73215",22,19,177,174,186,178,154,152,7,0,0,1,4,0,"win_A",3,3,8,2,0,0,0,0,1,0,0.571428571428571,0,0,"orthodox"
"73217",22,18,177,178,186,179,146,146,5,1,0,3,2,0,"win_A",4,-1,7,0,0,0,0,0,1,0.25,0.4,0,0,"orthodox"
"73218",22,17,177,175,186,175,153,151,4,1,0,0,1,1,"win_A",5,2,11,2,0,0,0,0,1,1,0.25,1,0,"orthodox"
"73220",21,21,177,183,186,183,146,145,2,3,0,0,0,1,"win_A",0,-6,3,1,0,0,0,0,1,1,0,0.333333333333333,0,"orthodox"
"73467",26,38,173,173,178,175,138,138,14,28,1,15,10,18,"win_A",-12,0,3,0,0,1,0,0,0.933333333333333,0.651162790697674,0.666666666666667,0.418604651162791,0,"Unknown"
"73483",31,27,173,173,185,175,130,130,25,19,10,3,17,13,"win_A",4,0,10,0,0,0,0,0,0.714285714285714,0.863636363636364,0.485714285714286,0.590909090909091,0,"orthodox"
"73488",25,32,173,165,175,173,135,135,16,20,0,8,10,15,"win_B",-7,8,2,0,0,0,0,0,1,0.714285714285714,0.625,0.535714285714286,1,"orthodox"
"73490",24,21,173,173,175,191,136,137,14,8,0,0,9,5,"win_A",3,0,-16,-1,0,0,0,0,1,1,0.642857142857143,0.625,0,"orthodox"
"73614",23,31,182,173,178,180,150,153,26,26,0,6,17,16,"win_A",-8,9,-2,-3,0,0,0,0,1,0.8125,0.653846153846154,0.5,0,"orthodox"
"73618",27,27,173,178,180,188,153,155,24,20,2,0,15,12,"win_A",0,-5,-8,-2,0,0,0,0,0.923076923076923,1,0.576923076923077,0.6,0,"southpaw"
"73619",27,25,173,178,180,178,153,153,23,34,2,2,15,30,"win_A",2,-5,2,0,0,0,0,0,0.92,0.944444444444444,0.6,0.833333333333333,0,"southpaw"
"73629",23,28,173,182,180,183,154,153,14,24,1,6,10,18,"win_A",-5,-9,-3,1,0,0,0,0,0.933333333333333,0.8,0.666666666666667,0.6,0,"southpaw"
"73631",22,31,173,171,180,175,153,154,12,31,1,7,9,16,"win_A",-9,2,5,-1,0,0,0,0,0.923076923076923,0.815789473684211,0.692307692307692,0.421052631578947,0,"southpaw"
"73632",22,30,173,183,180,191,150,153,11,34,1,9,9,12,"win_A",-8,-10,-11,-3,0,0,0,0,0.916666666666667,0.790697674418605,0.75,0.27906976744186,0,"southpaw"
"73633",21,24,173,178,180,178,155,155,10,12,1,0,9,8,"win_A",-3,-5,2,0,0,0,0,0,0.909090909090909,1,0.818181818181818,0.666666666666667,0,"southpaw"
"73634",21,24,173,175,180,191,148,152,9,17,1,1,8,11,"win_A",-3,-2,-11,-4,0,0,0,0,0.9,0.944444444444444,0.8,0.611111111111111,0,"southpaw"
"73660",23,28,170,167,170,178,120,120,7,5,0,0,2,1,"win_A",-5,3,-8,0,0,0,0,0,1,1,0.285714285714286,0.2,0,"orthodox"
"73663",20,23,168,170,168,170,122,121,0,4,2,0,0,0,"win_B",-3,-2,-2,1,0,0,0,0,0,1,0,0,1,"southpaw"
"73664",19,23,173,170,175,170,121,120,1,3,0,0,0,0,"win_B",-4,3,5,1,0,0,0,0,1,1,0,0,1,"orthodox"
"73678",30,19,185,187,187,187,194,186,5,1,0,0,3,1,"win_A",11,-2,0,8,0,0,0,0,1,1,0.6,1,0,"orthodox"
"73679",30,30,185,177,187,177,190,200,4,9,0,10,2,4,"win_A",0,8,10,-10,0,0,0,0,1,0.473684210526316,0.5,0.210526315789474,0,"orthodox"
"73756",28,26,183,185,191,196,159,159,26,19,1,3,18,17,"win_A",2,-2,-5,0,0,0,0,0,0.962962962962963,0.863636363636364,0.666666666666667,0.772727272727273,0,"orthodox"
"73757",27,36,183,179,191,188,160,160,26,40,0,3,18,29,"win_B",-9,4,3,0,0,1,0,0,1,0.930232558139535,0.692307692307692,0.674418604651163,1,"orthodox"
"73764",25,27,183,188,191,185,156,154,19,15,0,2,11,12,"win_A",-2,-5,6,2,0,0,0,0,1,0.882352941176471,0.578947368421053,0.705882352941177,0,"orthodox"
"73768",24,29,183,178,191,185,159,155,15,17,0,0,8,4,"win_A",-5,5,6,4,0,0,0,0,1,1,0.533333333333333,0.235294117647059,0,"orthodox"
"73773",23,30,183,173,191,178,162,162,10,2,0,5,4,2,"win_A",-7,10,13,0,0,0,0,0,1,0.285714285714286,0.4,0.285714285714286,0,"orthodox"
"73775",22,32,183,173,191,185,159,159,8,3,0,9,4,2,"win_A",-10,10,6,0,0,0,0,0,1,0.25,0.5,0.166666666666667,0,"orthodox"
"73860",21,23,170,170,172,172,146,146,6,8,4,2,3,7,"win_A",-2,0,0,0,0,0,0,0,0.6,0.8,0.3,0.7,0,"orthodox"
"74031",26,37,170,170,173,169,154,155,13,15,16,17,2,10,"win_A",-11,0,4,-1,0,1,0,0,0.448275862068966,0.46875,0.0689655172413793,0.3125,0,"orthodox"
"74741",32,28,168,170,175,170,140,140,34,3,3,0,20,1,"win_A",4,-2,5,0,0,0,0,0,0.918918918918919,1,0.540540540540541,0.333333333333333,0,"southpaw"
"75315",28,32,173,170,178,193,139,142,9,12,0,4,5,7,"win_A",-4,3,-15,-3,0,0,0,0,1,0.75,0.555555555555556,0.4375,0,"southpaw"
"75454",37,41,174,178,178,189,160,160,28,22,17,23,17,16,"win_A",-4,-4,-11,0,1,1,0,0,0.622222222222222,0.488888888888889,0.377777777777778,0.355555555555556,0,"orthodox"
"75460",29,32,180,174,184,178,156,153,9,26,0,5,6,16,"win_A",-3,6,6,3,0,0,0,0,1,0.838709677419355,0.666666666666667,0.516129032258065,0,"southpaw"
"75464",26,31,178,174,183,178,147,147,28,24,0,3,23,14,"win_A",-5,4,5,0,0,0,0,0,1,0.888888888888889,0.821428571428571,0.518518518518518,0,"orthodox"
"75466",25,29,177,174,175,178,152,154,12,24,0,1,9,14,"win_A",-4,3,-3,-2,0,0,0,0,1,0.96,0.75,0.56,0,"orthodox"
"75472",26,24,174,175,178,185,147,152,18,18,0,6,11,11,"win_A",2,-1,-7,-5,0,0,0,0,1,0.75,0.611111111111111,0.458333333333333,0,"orthodox"
"75934",23,31,184,193,191,188,174,172,13,25,0,16,8,12,"win_A",-8,-9,3,2,0,0,0,0,1,0.609756097560976,0.615384615384615,0.292682926829268,0,"Unknown"
"75939",22,28,184,185,191,188,174,173,8,6,0,1,5,4,"win_A",-6,-1,3,1,0,0,0,0,1,0.857142857142857,0.625,0.571428571428571,0,"Unknown"
"76466",23,41,191,180,206,191,230,220,20,19,0,16,11,15,"win_A",-18,11,15,10,0,1,0,0,1,0.542857142857143,0.55,0.428571428571429,0,"orthodox"
"76467",22,38,191,188,206,203,195,195,19,37,0,8,11,26,"win_A",-16,3,3,0,0,1,0,0,1,0.822222222222222,0.578947368421053,0.577777777777778,0,"orthodox"
"76469",21,41,191,187,206,192,190,190,17,30,0,17,10,28,"win_A",-20,4,14,0,0,1,0,0,1,0.638297872340426,0.588235294117647,0.595744680851064,0,"orthodox"
"76519",24,21,191,175,196,183,265,264,34,5,6,2,27,2,"win_B",3,16,13,1,0,0,0,0,0.85,0.714285714285714,0.675,0.285714285714286,1,"orthodox"
"76634",22,21,173,173,180,178,136,133,6,3,0,2,4,0,"win_A",1,0,2,3,0,0,0,0,1,0.6,0.666666666666667,0,0,"orthodox"
"76688",34,22,163,168,165,177,122,122,37,17,7,2,26,3,"win_A",12,-5,-12,0,0,0,0,0,0.840909090909091,0.894736842105263,0.590909090909091,0.157894736842105,0,"southpaw"
"76794",30,26,188,182,190,180,256,256,23,15,10,0,16,12,"win_B",4,6,10,0,0,0,0,0,0.696969696969697,1,0.484848484848485,0.8,1,"southpaw"
"76797",24,31,182,183,180,198,241,235,12,6,0,7,11,1,"win_A",-7,-1,-18,6,0,0,0,0,1,0.461538461538462,0.916666666666667,0.0769230769230769,0,"orthodox"
"77236",22,27,179,183,180,180,152,154,1,15,0,16,1,11,"win_A",-5,-4,0,-2,0,0,0,0,1,0.483870967741935,1,0.354838709677419,0,"southpaw"
"77507",23,24,170,178,170,171,122,122,28,22,5,3,21,15,"win_A",-1,-8,-1,0,0,0,0,0,0.848484848484849,0.88,0.636363636363636,0.6,0,"orthodox"
"77569",29,43,183,179,178,188,171,172,24,28,4,13,21,17,"win_A",-14,4,-10,-1,0,1,0,0,0.857142857142857,0.682926829268293,0.75,0.414634146341463,0,"orthodox"
"77571",27,30,183,185,178,196,170,168,22,21,2,7,19,18,"win_A",-3,-2,-18,2,0,0,0,0,0.916666666666667,0.75,0.791666666666667,0.642857142857143,0,"orthodox"
"77576",25,32,183,180,178,191,167,169,18,11,0,2,16,10,"win_A",-7,3,-13,-2,0,0,0,0,1,0.846153846153846,0.888888888888889,0.769230769230769,0,"orthodox"
"77577",25,31,183,180,178,180,168,168,17,18,0,10,15,11,"win_A",-6,3,-2,0,0,0,0,0,1,0.642857142857143,0.882352941176471,0.392857142857143,0,"orthodox"
"77580",22,30,183,175,178,183,168,170,14,16,0,8,12,7,"win_A",-8,8,-5,-2,0,0,0,0,1,0.666666666666667,0.857142857142857,0.291666666666667,0,"orthodox"
"77589",20,27,183,185,178,198,164,157,5,3,0,6,4,1,"win_A",-7,-2,-20,7,0,0,0,0,1,0.333333333333333,0.8,0.111111111111111,0,"orthodox"
"77905",21,22,163,163,173,157,111,112,7,2,0,4,2,1,"win_A",-1,0,16,-1,0,0,0,0,1,0.333333333333333,0.285714285714286,0.166666666666667,0,"Unknown"
"78701",27,23,175,168,183,171,131,131,17,19,5,9,12,8,"win_A",4,7,12,0,0,0,0,0,0.772727272727273,0.678571428571429,0.545454545454545,0.285714285714286,0,"orthodox"
"78705",26,27,175,173,183,178,130,129,14,11,4,13,10,7,"win_B",-1,2,5,1,0,0,0,0,0.777777777777778,0.458333333333333,0.555555555555556,0.291666666666667,1,"orthodox"
"78842",19,38,170,180,183,183,147,147,15,60,1,57,14,49,"win_A",-19,-10,0,0,0,1,0,0,0.9375,0.512820512820513,0.875,0.418803418803419,0,"orthodox"
"79443",30,24,175,170,175,170,135,134,19,32,1,5,10,21,"win_A",6,5,5,1,0,0,0,0,0.95,0.864864864864865,0.5,0.567567567567568,0,"orthodox"
"79477",21,23,174,165,180,170,118,119,9,1,1,4,6,1,"win_A",-2,9,10,-1,0,0,0,0,0.9,0.2,0.6,0.2,0,"orthodox"
"79736",38,36,201,203,218,208,252,278,46,45,4,2,34,41,"win_A",2,-2,10,-26,1,1,0,1,0.92,0.957446808510638,0.68,0.872340425531915,0,"orthodox"
"79739",35,23,201,180,218,188,256,275,43,14,3,15,33,12,"win_A",12,21,30,-19,1,0,0,1,0.934782608695652,0.482758620689655,0.717391304347826,0.413793103448276,0,"orthodox"
"79740",35,32,201,196,218,196,262,241,42,17,3,3,32,13,"win_A",3,5,22,21,1,0,1,0,0.933333333333333,0.85,0.711111111111111,0.65,0,"orthodox"
"79741",34,34,201,183,218,180,255,226,41,21,3,8,31,11,"win_A",0,18,38,29,0,0,1,0,0.931818181818182,0.724137931034483,0.704545454545455,0.379310344827586,0,"orthodox"
"79742",32,33,201,191,218,201,256,228,40,13,3,6,31,7,"win_A",-1,10,17,28,0,0,1,0,0.930232558139535,0.684210526315789,0.720930232558139,0.368421052631579,0,"orthodox"
"79745",28,30,191,201,198,218,254,218,21,38,0,2,16,29,"win_A",-2,-10,-20,36,0,0,1,0,1,0.95,0.761904761904762,0.725,0,"orthodox"
"79746",30,36,201,180,218,198,262,223,37,15,2,4,28,7,"win_A",-6,21,20,39,0,1,1,0,0.948717948717949,0.789473684210526,0.717948717948718,0.368421052631579,0,"orthodox"
"79750",29,33,201,185,218,191,258,243,33,19,2,10,24,13,"win_A",-4,16,27,15,0,0,1,0,0.942857142857143,0.655172413793103,0.685714285714286,0.448275862068966,0,"orthodox"
"79753",31,28,198,201,208,218,254,260,25,31,2,1,15,22,"win_A",3,-3,-10,-6,0,0,0,0,0.925925925925926,0.96875,0.555555555555556,0.6875,0,"orthodox"
"79754",34,27,196,201,213,218,250,247,35,31,1,0,27,22,"win_A",7,-5,-5,3,0,0,0,0,0.972222222222222,1,0.75,0.709677419354839,0,"orthodox"
"79757",26,26,201,191,218,185,250,243,28,25,0,1,20,12,"win_A",0,10,33,7,0,0,0,0,1,0.961538461538462,0.714285714285714,0.461538461538462,0,"orthodox"
"79762",24,29,201,180,218,183,246,265,23,26,0,12,16,21,"win_A",-5,21,35,-19,0,0,0,1,1,0.684210526315789,0.695652173913043,0.552631578947368,0,"orthodox"
"79765",24,28,201,180,218,203,247,214,20,4,0,4,15,2,"win_A",-4,21,15,33,0,0,1,0,1,0.5,0.75,0.25,0,"orthodox"
"79766",23,29,201,191,218,203,249,248,19,18,0,9,15,16,"win_A",-6,10,15,1,0,0,0,0,1,0.666666666666667,0.789473684210526,0.592592592592593,0,"orthodox"
"79769",23,21,201,198,218,206,245,273,16,10,0,2,12,7,"win_A",2,3,12,-28,0,0,0,1,1,0.833333333333333,0.75,0.583333333333333,0,"orthodox"
"80246",24,32,185,179,193,185,165,165,4,8,0,1,2,5,"win_A",-8,6,8,0,0,0,0,0,1,0.888888888888889,0.5,0.555555555555556,0,"Unknown"
"80333",18,26,165,163,165,159,119,117,1,2,0,11,1,2,"win_A",-8,2,6,2,0,0,0,0,1,0.153846153846154,1,0.153846153846154,0,"southpaw"
"81060",28,32,169,174,178,174,130,130,24,38,2,9,18,18,"win_A",-4,-5,4,0,0,0,0,0,0.923076923076923,0.808510638297872,0.692307692307692,0.382978723404255,0,"southpaw"
"81061",31,28,174,169,174,174,130,130,37,23,9,2,18,10,"win_A",3,5,0,0,0,0,0,0,0.804347826086957,0.92,0.391304347826087,0.4,0,"orthodox"
"81075",28,27,172,174,175,174,130,130,43,24,7,7,28,11,"win_A",1,-2,1,0,0,0,0,0,0.86,0.774193548387097,0.56,0.354838709677419,0,"orthodox"
"81078",26,24,174,170,174,178,126,126,21,19,6,0,9,13,"win_A",2,4,-4,0,0,0,0,0,0.777777777777778,1,0.333333333333333,0.684210526315789,0,"orthodox"
"81098",20,19,179,174,170,174,126,126,3,3,1,4,1,0,"win_A",1,5,-4,0,0,0,0,0,0.75,0.428571428571429,0.25,0,0,"orthodox"
"81553",24,32,165,182,165,178,121,122,20,24,0,16,10,19,"win_A",-8,-17,-13,-1,0,0,0,0,1,0.6,0.5,0.475,0,"orthodox"
"81556",29,27,182,165,178,170,123,123,23,24,11,8,18,11,"win_A",2,17,8,0,0,0,0,0,0.676470588235294,0.75,0.529411764705882,0.34375,0,"orthodox"
"81575",22,24,168,182,178,178,119,119,13,8,0,4,8,6,"win_A",-2,-14,0,0,0,0,0,0,1,0.666666666666667,0.615384615384615,0.5,0,"orthodox"
"81578",23,23,165,182,173,178,125,125,8,6,0,3,3,4,"win_A",0,-17,-5,0,0,0,0,0,1,0.666666666666667,0.375,0.444444444444444,0,"orthodox"
"81636",24,31,175,168,178,175,162,164,2,8,0,29,2,3,"win_A",-7,7,3,-2,0,0,0,0,1,0.216216216216216,1,0.0810810810810811,0,"Unknown"
"81944",28,38,188,193,208,208,249,264,10,10,0,9,7,5,"win_A",-10,-5,0,-15,0,1,0,1,1,0.526315789473684,0.7,0.263157894736842,0,"southpaw"
"81947",27,39,188,191,208,202,256,267,7,15,0,30,5,10,"win_A",-12,-3,6,-11,0,1,0,0,1,0.333333333333333,0.714285714285714,0.222222222222222,0,"southpaw"
"81965",29,34,171,171,170,170,127,127,19,19,1,8,9,12,"win_A",-5,0,0,0,0,0,0,0,0.95,0.703703703703704,0.45,0.444444444444444,0,"orthodox"
"81973",29,31,166,171,175,170,127,128,31,15,2,3,28,8,"win_A",-2,-5,5,-1,0,0,0,0,0.939393939393939,0.833333333333333,0.848484848484849,0.444444444444444,0,"southpaw"
"82134",24,20,165,163,170,173,114,114,8,6,4,0,5,4,"win_A",4,2,-3,0,0,0,0,0,0.666666666666667,1,0.416666666666667,0.666666666666667,0,"orthodox"
"82136",21,28,165,157,170,168,117,117,6,3,0,16,4,0,"win_A",-7,8,2,0,0,0,0,0,1,0.157894736842105,0.666666666666667,0,0,"orthodox"
"82138",20,28,165,157,170,168,117,116,4,3,0,14,4,0,"win_A",-8,8,2,1,0,0,0,0,1,0.176470588235294,1,0,0,"orthodox"
"82153",29,28,165,170,173,175,128,130,33,18,9,3,22,7,"win_A",1,-5,-2,-2,0,0,0,0,0.785714285714286,0.857142857142857,0.523809523809524,0.333333333333333,0,"orthodox"
"82154",35,29,166,165,178,173,130,130,26,33,3,8,14,22,"win_A",6,1,5,0,1,0,0,0,0.896551724137931,0.804878048780488,0.482758620689655,0.536585365853659,0,"orthodox"
"82156",25,29,170,165,175,173,126,126,30,32,1,7,14,21,"win_A",-4,5,2,0,0,0,0,0,0.967741935483871,0.82051282051282,0.451612903225806,0.538461538461538,0,"southpaw"
"82162",22,27,165,165,173,173,123,125,23,27,0,6,12,17,"win_A",-5,0,0,-2,0,0,0,0,1,0.818181818181818,0.521739130434783,0.515151515151515,0,"orthodox"
"82165",24,26,173,165,175,173,124,127,24,26,0,4,19,16,"win_A",-2,8,2,-3,0,0,0,0,1,0.866666666666667,0.791666666666667,0.533333333333333,0,"orthodox"
"82170",25,23,165,168,173,175,123,123,22,16,3,1,13,14,"win_A",2,-3,-2,0,0,0,0,0,0.88,0.941176470588235,0.52,0.823529411764706,0,"orthodox"
"82171",22,25,179,165,170,173,126,126,10,22,2,2,6,13,"win_A",-3,14,-3,0,0,0,0,0,0.833333333333333,0.916666666666667,0.5,0.541666666666667,0,"orthodox"
"82835",27,33,155,158,160,157,112,112,31,11,5,4,18,5,"win_A",-6,-3,3,0,0,0,0,0,0.861111111111111,0.733333333333333,0.5,0.333333333333333,0,"orthodox"
"82836",21,32,168,158,164,157,112,112,18,11,2,3,11,5,"win_A",-11,10,7,0,0,0,0,0,0.9,0.785714285714286,0.55,0.357142857142857,0,"orthodox"
"83494",27,33,155,158,160,157,112,112,31,11,5,4,18,5,"win_A",-6,-3,3,0,0,0,0,0,0.861111111111111,0.733333333333333,0.5,0.333333333333333,0,"orthodox"
"83495",21,32,168,158,164,157,112,112,18,11,2,3,11,5,"win_A",-11,10,7,0,0,0,0,0,0.9,0.785714285714286,0.55,0.357142857142857,0,"orthodox"
"84345",21,22,173,170,173,170,123,127,12,4,1,3,2,1,"win_A",-1,3,3,-4,0,0,0,0,0.923076923076923,0.571428571428571,0.153846153846154,0.142857142857143,0,"orthodox"
"84350",20,25,173,168,173,175,122,122,8,1,0,8,1,0,"win_A",-5,5,-2,0,0,0,0,0,1,0.111111111111111,0.125,0,0,"orthodox"
"84631",26,22,166,170,168,170,118,118,24,28,3,4,18,21,"win_A",4,-4,-2,0,0,0,0,0,0.888888888888889,0.875,0.666666666666667,0.65625,0,"orthodox"
"84761",20,37,178,168,185,185,154,152,7,16,1,8,0,14,"win_A",-17,10,0,2,0,1,0,0,0.875,0.666666666666667,0,0.583333333333333,0,"orthodox"
"84763",20,30,178,177,185,180,153,153,6,6,0,0,0,4,"win_A",-10,1,5,0,0,0,0,0,1,1,0,0.666666666666667,0,"orthodox"
"85160",29,19,175,170,177,170,134,134,5,2,2,1,4,1,"win_A",10,5,7,0,0,0,0,0,0.714285714285714,0.666666666666667,0.571428571428571,0.333333333333333,0,"orthodox"
"85201",24,21,170,178,170,180,133,134,1,1,0,0,0,1,"win_A",3,-8,-10,-1,0,0,0,0,1,1,0,1,0,"orthodox"
"85456",34,24,183,183,188,188,174,175,24,22,2,3,13,15,"win_A",10,0,0,-1,0,0,0,0,0.923076923076923,0.88,0.5,0.6,0,"orthodox"
"85462",36,32,177,183,180,188,171,171,32,19,2,1,17,11,"win_A",4,-6,-8,0,1,0,0,0,0.941176470588235,0.95,0.5,0.55,0,"southpaw"
"85467",28,31,191,183,193,188,175,175,12,15,0,0,10,7,"win_A",-3,8,5,0,0,0,0,0,1,1,0.833333333333333,0.466666666666667,0,"orthodox"
"85904",38,24,175,181,175,176,159,156,38,17,19,9,31,13,"win_A",14,-6,-1,3,1,0,0,0,0.666666666666667,0.653846153846154,0.543859649122807,0.5,0,"orthodox"
"85905",38,24,175,181,175,176,158,159,37,17,18,8,30,13,"win_A",14,-6,-1,-1,1,0,0,0,0.672727272727273,0.68,0.545454545454545,0.52,0,"orthodox"
"85906",24,26,181,174,176,174,155,153,16,8,8,17,12,5,"win_A",-2,7,2,2,0,0,0,0,0.666666666666667,0.32,0.5,0.2,0,"southpaw"
"85911",24,23,183,181,183,176,154,155,23,14,2,4,18,10,"win_A",1,2,7,-1,0,0,0,0,0.92,0.777777777777778,0.72,0.555555555555556,0,"orthodox"
"85915",33,23,180,181,168,176,151,154,39,11,6,3,32,8,"win_A",10,-1,-8,-3,0,0,0,0,0.866666666666667,0.785714285714286,0.711111111111111,0.571428571428571,0,"orthodox"
"86035",21,22,172,170,178,182,121,120,11,0,1,25,5,0,"win_A",-1,2,-4,1,0,0,0,0,0.916666666666667,0,0.416666666666667,0,0,"southpaw"
"86324",26,28,171,170,175,180,135,135,25,23,0,4,18,15,"win_A",-2,1,-5,0,0,0,0,0,1,0.851851851851852,0.72,0.555555555555556,0,"orthodox"
"86328",26,24,170,160,180,175,133,134,19,10,3,5,13,4,"win_A",2,10,5,-1,0,0,0,0,0.863636363636364,0.666666666666667,0.590909090909091,0.266666666666667,0,"southpaw"
"86329",26,23,170,170,180,173,135,134,18,4,3,10,13,2,"win_A",3,0,7,1,0,0,0,0,0.857142857142857,0.285714285714286,0.619047619047619,0.142857142857143,0,"southpaw"
"86334",33,25,170,170,173,180,131,131,18,15,1,1,7,13,"win_A",8,0,-7,0,0,0,0,0,0.947368421052632,0.9375,0.368421052631579,0.8125,0,"southpaw"
"86335",25,30,170,173,180,178,131,132,14,21,1,20,12,16,"win_A",-5,-3,2,-1,0,0,0,0,0.933333333333333,0.51219512195122,0.8,0.390243902439024,0,"southpaw"
"86338",24,32,170,168,180,173,130,130,12,24,0,11,10,14,"win_A",-8,2,7,0,0,0,0,0,1,0.685714285714286,0.833333333333333,0.4,0,"southpaw"
"86345",23,24,170,170,180,178,134,133,5,5,0,2,5,4,"win_A",-1,0,2,1,0,0,0,0,1,0.714285714285714,1,0.571428571428571,0,"southpaw"
"86415",28,27,196,188,210,203,261,262,12,9,0,0,7,5,"win_A",1,8,7,-1,0,0,0,0,1,1,0.583333333333333,0.555555555555556,0,"orthodox"
"86642",26,25,178,176,184,172,154,152,10,2,0,12,10,0,"win_A",1,2,12,2,0,0,0,0,1,0.142857142857143,1,0,0,"orthodox"
"86646",26,34,178,173,184,180,155,156,6,1,0,0,6,0,"win_A",-8,5,4,-1,0,0,0,0,1,1,1,0,0,"orthodox"
"86974",35,27,168,168,178,173,134,135,11,14,3,0,4,4,"win_A",8,0,5,-1,1,0,0,0,0.785714285714286,1,0.285714285714286,0.285714285714286,0,"Unknown"
"87543",30,44,188,183,190,189,241,245,23,23,11,22,16,7,"win_A",-14,5,1,-4,0,1,0,0,0.676470588235294,0.511111111111111,0.470588235294118,0.155555555555556,0,"southpaw"
"87544",29,37,188,185,190,191,251,223,21,29,10,21,14,16,"win_A",-8,3,-1,28,0,1,1,0,0.67741935483871,0.58,0.451612903225806,0.32,0,"southpaw"
"87546",28,37,188,193,190,203,254,252,20,25,9,17,13,11,"win_B",-9,-5,-13,2,0,1,0,0,0.689655172413793,0.595238095238095,0.448275862068966,0.261904761904762,1,"southpaw"
"87548",28,35,188,216,190,229,260,314,18,15,9,16,12,13,"win_A",-7,-28,-39,-54,0,1,0,1,0.666666666666667,0.483870967741935,0.444444444444444,0.419354838709677,0,"southpaw"
"87549",27,33,188,193,190,208,255,234,17,11,9,8,11,5,"win_A",-6,-5,-18,21,0,0,1,0,0.653846153846154,0.578947368421053,0.423076923076923,0.263157894736842,0,"southpaw"
"87551",27,41,188,183,190,189,242,237,15,23,9,17,11,7,"win_A",-14,5,1,5,0,1,0,0,0.625,0.575,0.458333333333333,0.175,0,"southpaw"
"87564",34,23,198,188,211,190,267,237,13,5,0,5,7,4,"win_B",11,10,21,30,0,0,1,0,1,0.5,0.538461538461538,0.4,1,"orthodox"
"87691",20,21,163,178,173,183,130,131,3,3,0,2,3,2,"win_A",-1,-15,-10,-1,0,0,0,0,1,0.6,1,0.4,0,"Unknown"
"88222",26,44,165,165,164,170,117,115,17,38,7,15,10,34,"win_A",-18,0,-6,2,0,1,0,0,0.708333333333333,0.716981132075472,0.416666666666667,0.641509433962264,0,"Unknown"
"88237",23,29,165,170,164,173,122,126,0,15,6,4,0,9,"win_A",-6,-5,-9,-4,0,0,0,0,0,0.789473684210526,0,0.473684210526316,0,"Unknown"
"88265",28,29,165,171,175,175,133,133,33,25,13,3,27,17,"win_A",-1,-6,0,0,0,0,0,0,0.717391304347826,0.892857142857143,0.58695652173913,0.607142857142857,0,"orthodox"
"88278",20,25,162,165,163,175,127,129,7,20,1,9,7,17,"win_B",-5,-3,-12,-2,0,0,0,0,0.875,0.689655172413793,0.875,0.586206896551724,1,"orthodox"
"88289",30,20,168,165,170,175,118,118,32,13,2,2,17,10,"win_A",10,3,-5,0,0,0,0,0,0.941176470588235,0.866666666666667,0.5,0.666666666666667,0,"orthodox"
"88291",30,20,157,165,173,175,115,115,26,12,6,1,16,9,"win_A",10,-8,-2,0,0,0,0,0,0.8125,0.923076923076923,0.5,0.692307692307692,0,"orthodox"
"88983",30,28,180,175,188,175,160,161,26,22,1,3,17,14,"win_A",2,5,13,-1,0,0,0,0,0.962962962962963,0.88,0.62962962962963,0.56,0,"orthodox"
"88986",21,26,182,175,178,175,156,155,18,20,0,1,12,12,"win_A",-5,7,3,1,0,0,0,0,1,0.952380952380952,0.666666666666667,0.571428571428571,0,"orthodox"
"88988",26,36,175,168,175,173,163,168,18,7,1,47,11,2,"win_A",-10,7,2,-5,0,1,0,0,0.947368421052632,0.12962962962963,0.578947368421053,0.037037037037037,0,"orthodox"
"88989",25,37,175,175,175,180,162,156,17,6,1,20,11,3,"win_A",-12,0,-5,6,0,1,0,0,0.944444444444444,0.230769230769231,0.611111111111111,0.115384615384615,0,"orthodox"
"88998",24,33,175,177,175,183,160,167,9,78,0,22,8,40,"win_A",-9,-2,-8,-7,0,0,0,0,1,0.78,0.888888888888889,0.4,0,"orthodox"
"89199",28,34,165,160,183,170,124,126,8,4,1,8,1,1,"win_A",-6,5,13,-2,0,0,0,0,0.888888888888889,0.333333333333333,0.111111111111111,0.0833333333333333,0,"orthodox"
"89200",27,34,165,160,183,170,125,125,7,4,1,7,1,1,"win_A",-7,5,13,0,0,0,0,0,0.875,0.363636363636364,0.125,0.0909090909090909,0,"orthodox"
"89238",24,29,175,168,183,167,126,126,12,52,0,37,7,30,"win_A",-5,7,16,0,0,0,0,0,1,0.584269662921348,0.583333333333333,0.337078651685393,0,"orthodox"
"89276",23,23,176,168,179,167,115,115,23,25,1,15,23,9,"win_A",0,8,12,0,0,0,0,0,0.958333333333333,0.625,0.958333333333333,0.225,0,"orthodox"
"89278",23,35,168,165,167,165,122,122,24,29,14,17,9,25,"win_A",-12,3,2,0,0,1,0,0,0.631578947368421,0.630434782608696,0.236842105263158,0.543478260869565,0,"orthodox"
"89283",37,22,163,168,165,167,120,120,53,20,6,12,36,8,"win_A",15,-5,-2,0,1,0,0,0,0.898305084745763,0.625,0.610169491525424,0.25,0,"southpaw"
"89373",24,28,165,178,177,191,134,140,9,7,0,13,5,5,"win_A",-4,-13,-14,-6,0,0,0,0,1,0.35,0.555555555555556,0.25,0,"orthodox"
"89426",29,39,188,183,188,188,159,161,12,20,3,28,7,13,"win_A",-10,5,0,-2,0,1,0,0,0.8,0.416666666666667,0.466666666666667,0.270833333333333,0,"orthodox"
"89429",27,28,178,188,180,188,151,150,11,10,0,2,7,6,"win_A",-1,-10,-8,1,0,0,0,0,1,0.833333333333333,0.636363636363636,0.5,0,"southpaw"
"89577",32,31,175,169,178,175,164,163,21,26,2,28,11,15,"win_A",1,6,3,1,0,0,0,0,0.91304347826087,0.481481481481481,0.478260869565217,0.277777777777778,0,"orthodox"
"89582",22,34,175,180,178,183,151,148,16,43,0,37,11,36,"win_A",-12,-5,-5,3,0,0,0,0,1,0.5375,0.6875,0.45,0,"orthodox"
"89585",22,36,175,173,178,178,140,143,13,21,0,6,9,11,"win_A",-14,2,0,-3,0,1,0,0,1,0.777777777777778,0.692307692307692,0.407407407407407,0,"orthodox"
"89591",21,22,175,180,178,188,142,140,7,7,0,0,5,6,"win_A",-1,-5,-10,2,0,0,0,0,1,1,0.714285714285714,0.857142857142857,0,"orthodox"
"90189",31,33,180,168,184,183,156,154,13,39,1,9,8,24,"win_A",-2,12,1,2,0,0,0,0,0.928571428571429,0.8125,0.571428571428571,0.5,0,"southpaw"
"90190",36,33,175,168,175,183,141,141,45,39,0,7,19,24,"win_A",3,7,-8,0,1,0,0,0,1,0.847826086956522,0.422222222222222,0.521739130434783,0,"southpaw"
"90192",25,32,171,168,179,183,145,145,19,37,2,6,14,23,"win_A",-7,3,-4,0,0,0,0,0,0.904761904761905,0.86046511627907,0.666666666666667,0.534883720930233,0,"southpaw"
"90194",30,38,168,168,183,175,135,135,35,23,6,38,21,18,"win_A",-8,0,8,0,0,1,0,0,0.853658536585366,0.377049180327869,0.51219512195122,0.295081967213115,0,"orthodox"
"90200",34,27,164,168,174,183,135,135,40,30,4,3,18,18,"win_A",7,-4,-9,0,0,0,0,0,0.909090909090909,0.909090909090909,0.409090909090909,0.545454545454545,0,"southpaw"
"90702",29,34,174,170,178,180,135,135,26,52,8,14,18,36,"win_B",-5,4,-2,0,0,0,0,0,0.764705882352941,0.787878787878788,0.529411764705882,0.545454545454545,1,"southpaw"
"90703",29,35,174,173,178,178,136,136,25,30,8,6,17,22,"win_A",-6,1,0,0,0,1,0,0,0.757575757575758,0.833333333333333,0.515151515151515,0.611111111111111,0,"southpaw"
"90704",28,35,174,175,178,175,135,135,24,29,8,3,17,17,"win_A",-7,-1,3,0,0,1,0,0,0.75,0.90625,0.53125,0.53125,0,"southpaw"
"90706",28,34,174,165,178,173,136,137,23,24,7,12,16,17,"win_A",-6,9,5,-1,0,0,0,0,0.766666666666667,0.666666666666667,0.533333333333333,0.472222222222222,0,"southpaw"
"90709",25,25,174,178,178,183,135,133,20,21,6,2,14,13,"win_A",0,-4,-5,2,0,0,0,0,0.769230769230769,0.91304347826087,0.538461538461538,0.565217391304348,0,"southpaw"
"90722",25,22,168,174,178,178,135,135,20,11,6,2,17,8,"win_A",3,-6,0,0,0,0,0,0,0.769230769230769,0.846153846153846,0.653846153846154,0.615384615384615,0,"orthodox"
"90916",29,38,189,193,196,201,223,241,43,23,1,14,26,0,"win_B",-9,-4,-5,-18,0,1,0,1,0.977272727272727,0.621621621621622,0.590909090909091,0,1,"orthodox"
"90921",26,39,189,177,196,178,233,213,36,57,1,8,23,30,"win_A",-13,12,18,20,0,1,1,0,0.972972972972973,0.876923076923077,0.621621621621622,0.461538461538462,0,"orthodox"
"90930",24,35,189,193,196,206,219,222,27,10,1,7,17,6,"win_A",-11,-4,-10,-3,0,1,0,0,0.964285714285714,0.588235294117647,0.607142857142857,0.352941176470588,0,"orthodox"
"90951",20,42,189,190,196,193,218,275,7,10,0,11,4,10,"win_A",-22,-1,3,-57,0,1,0,1,1,0.476190476190476,0.571428571428571,0.476190476190476,0,"orthodox"
"91676",31,24,179,180,185,189,163,162,5,2,0,1,3,2,"win_A",7,-1,-4,1,0,0,0,0,1,0.666666666666667,0.6,0.666666666666667,0,"Unknown"
"91725",35,34,173,173,177,175,161,167,21,57,11,5,14,31,"win_A",1,0,2,-6,1,0,0,0,0.65625,0.919354838709677,0.4375,0.5,0,"orthodox"
"91730",27,33,175,173,178,177,146,146,14,19,0,5,12,12,"win_A",-6,2,1,0,0,0,0,0,1,0.791666666666667,0.857142857142857,0.5,0,"orthodox"
"91733",26,31,183,173,183,177,146,146,20,18,0,2,16,11,"win_A",-5,10,6,0,0,0,0,0,1,0.9,0.8,0.55,0,"orthodox"
"91736",28,26,173,170,177,169,149,150,15,7,1,8,9,6,"win_A",2,3,8,-1,0,0,0,0,0.9375,0.466666666666667,0.5625,0.4,0,"orthodox"
"91741",27,26,173,165,177,170,141,139,10,7,1,10,6,3,"win_A",1,8,7,2,0,0,0,0,0.909090909090909,0.411764705882353,0.545454545454545,0.176470588235294,0,"orthodox"
"91743",26,44,173,173,177,175,147,149,8,29,1,32,5,12,"win_A",-18,0,2,-2,0,1,0,0,0.888888888888889,0.475409836065574,0.555555555555556,0.19672131147541,0,"orthodox"
"93009",40,30,175,173,175,174,154,154,5,3,2,0,4,0,"win_B",10,2,1,0,1,0,0,0,0.714285714285714,1,0.571428571428571,0,1,"orthodox"
"93265",42,48,179,182,183,193,251,238,25,31,17,9,21,17,"win_A",-6,-3,-10,13,1,1,0,0,0.595238095238095,0.775,0.5,0.425,0,"orthodox"
"93274",35,32,198,179,203,183,229,255,23,21,3,10,15,18,"win_A",3,19,20,-26,1,0,0,1,0.884615384615385,0.67741935483871,0.576923076923077,0.580645161290323,0,"orthodox"
"93281",29,30,180,179,183,183,226,210,13,17,0,7,6,17,"win_A",-1,1,0,16,0,0,1,0,1,0.708333333333333,0.461538461538462,0.708333333333333,0,"orthodox"
"93285",30,28,188,179,206,183,228,243,32,15,1,5,23,15,"win_A",2,9,23,-15,0,0,0,1,0.96969696969697,0.75,0.696969696969697,0.75,0,"orthodox"
"93290",29,28,185,179,196,183,226,248,15,13,14,2,12,13,"win_A",1,6,13,-22,0,0,0,1,0.517241379310345,0.866666666666667,0.413793103448276,0.866666666666667,0,"orthodox"
"93292",27,35,179,185,183,185,223,205,12,12,1,13,12,4,"win_A",-8,-6,-2,18,0,1,1,0,0.923076923076923,0.48,0.923076923076923,0.16,0,"orthodox"
"93479",23,29,170,185,178,192,136,136,17,14,1,6,15,5,"win_A",-6,-15,-14,0,0,0,0,0,0.944444444444444,0.7,0.833333333333333,0.25,0,"orthodox"
"93481",28,25,185,170,192,180,137,135,13,9,5,1,4,8,"win_A",3,15,12,2,0,0,0,0,0.722222222222222,0.9,0.222222222222222,0.8,0,"orthodox"
"93482",18,28,178,185,183,192,142,147,11,13,0,4,11,4,"win_A",-10,-7,-9,-5,0,0,0,0,1,0.764705882352941,1,0.235294117647059,0,"orthodox"
"93483",21,27,168,185,174,192,140,138,5,13,3,3,2,4,"win_A",-6,-17,-18,2,0,0,0,0,0.625,0.8125,0.25,0.25,0,"orthodox"
"93591",36,38,178,178,178,189,168,166,25,22,8,17,22,16,"win_A",-2,0,-11,2,1,1,0,0,0.757575757575758,0.564102564102564,0.666666666666667,0.41025641025641,0,"orthodox"
"93594",28,33,178,178,188,178,174,175,21,24,0,4,18,21,"win_A",-5,0,10,-1,0,0,0,0,1,0.857142857142857,0.857142857142857,0.75,0,"orthodox"
"93600",30,31,178,175,178,175,167,167,19,26,2,0,16,26,"win_A",-1,3,3,0,0,0,0,0,0.904761904761905,1,0.761904761904762,1,0,"orthodox"
"93603",23,28,189,178,191,178,160,159,26,17,0,1,23,16,"win_A",-5,11,13,1,0,0,0,0,1,0.944444444444444,0.884615384615385,0.888888888888889,0,"orthodox"
"93604",27,27,178,188,178,198,159,159,16,24,1,11,15,15,"win_A",0,-10,-20,0,0,0,0,0,0.941176470588235,0.685714285714286,0.882352941176471,0.428571428571429,0,"orthodox"
"93605",27,30,178,171,178,184,162,162,15,16,1,2,15,11,"win_A",-3,7,-6,0,0,0,0,0,0.9375,0.888888888888889,0.9375,0.611111111111111,0,"orthodox"
"93606",27,25,182,178,188,178,153,154,26,15,2,0,20,15,"win_A",2,4,10,-1,0,0,0,0,0.928571428571429,1,0.714285714285714,1,0,"southpaw"
"93765",20,23,170,178,170,178,134,135,13,6,0,4,3,2,"win_A",-3,-8,-8,-1,0,0,0,0,1,0.6,0.230769230769231,0.2,0,"Unknown"
"93767",19,23,170,173,170,183,137,137,11,14,0,11,3,7,"win_A",-4,-3,-13,0,0,0,0,0,1,0.56,0.272727272727273,0.28,0,"Unknown"
"93769",18,24,170,175,170,191,137,135,9,4,0,3,3,0,"win_A",-6,-5,-21,2,0,0,0,0,1,0.571428571428571,0.333333333333333,0,0,"Unknown"
"93772",18,31,170,168,170,180,133,131,6,10,0,16,1,7,"win_A",-13,2,-10,2,0,0,0,0,1,0.384615384615385,0.166666666666667,0.269230769230769,0,"Unknown"
"94100",29,20,175,170,178,182,135,133,30,0,3,14,22,0,"win_A",9,5,-4,2,0,0,0,0,0.909090909090909,0,0.666666666666667,0,0,"orthodox"
"94101",28,19,175,170,178,182,127,127,29,0,2,6,21,0,"win_A",9,5,-4,0,0,0,0,0,0.935483870967742,0,0.67741935483871,0,0,"orthodox"
"94150",22,22,173,173,178,183,141,143,2,2,0,13,2,0,"win_A",0,0,-5,-2,0,0,0,0,1,0.133333333333333,1,0,0,"Unknown"
"94385",22,27,183,176,188,183,175,176,18,5,0,1,14,2,"win_A",-5,7,5,-1,0,0,0,0,1,0.833333333333333,0.777777777777778,0.333333333333333,0,"orthodox"
"94482",37,35,180,173,191,179,196,194,13,6,6,2,12,5,"win_A",2,7,12,2,1,1,0,0,0.684210526315789,0.75,0.631578947368421,0.625,0,"southpaw"
"94901",32,36,183,180,182,191,169,167,21,20,2,19,12,20,"win_A",-4,3,-9,2,0,1,0,0,0.91304347826087,0.512820512820513,0.521739130434783,0.512820512820513,0,"orthodox"
"94908",26,34,188,180,185,191,174,174,20,17,2,9,9,17,"win_A",-8,8,-6,0,0,0,0,0,0.909090909090909,0.653846153846154,0.409090909090909,0.653846153846154,0,"orthodox"
"94931",30,21,189,176,190,176,175,175,4,7,0,1,3,7,"win_B",9,13,14,0,0,0,0,0,1,0.875,0.75,0.875,1,"orthodox"
"94932",21,24,176,186,176,186,174,174,6,3,1,2,6,0,"win_A",-3,-10,-10,0,0,0,0,0,0.857142857142857,0.6,0.857142857142857,0,0,"orthodox"
"94933",20,19,176,188,176,190,175,175,5,6,1,5,5,4,"win_A",1,-12,-14,0,0,0,0,0,0.833333333333333,0.545454545454545,0.833333333333333,0.363636363636364,0,"orthodox"
"95108",26,30,169,170,170,172,139,140,8,4,1,2,5,1,"win_A",-4,-1,-2,-1,0,0,0,0,0.888888888888889,0.666666666666667,0.555555555555556,0.166666666666667,0,"orthodox"
"95465",31,38,157,154,165,161,109,108,24,15,8,10,14,7,"win_A",-7,3,4,1,0,1,0,0,0.75,0.6,0.4375,0.28,0,"orthodox"
"95730",25,24,158,165,158,167,114,115,5,5,1,1,1,4,"win_A",1,-7,-9,-1,0,0,0,0,0.833333333333333,0.833333333333333,0.166666666666667,0.666666666666667,0,"orthodox"
"95731",24,24,165,165,167,163,120,120,4,0,1,2,3,0,"win_A",0,0,4,0,0,0,0,0,0.8,0,0.6,0,0,"orthodox"
"95732",23,24,165,158,167,160,115,115,3,5,1,0,3,0,"win_A",-1,7,7,0,0,0,0,0,0.75,1,0.75,0,0,"orthodox"
"95925",31,21,185,173,182,170,159,160,7,4,1,2,5,2,"win_A",10,12,12,-1,0,0,0,0,0.875,0.666666666666667,0.625,0.333333333333333,0,"orthodox"
"96318",38,36,180,175,188,178,160,158,22,33,7,8,11,24,"win_A",2,5,10,2,1,1,0,0,0.758620689655172,0.804878048780488,0.379310344827586,0.585365853658537,0,"orthodox"
"96475",25,27,165,165,173,168,133,128,8,6,2,3,6,2,"win_A",-2,0,5,5,0,0,0,0,0.8,0.666666666666667,0.6,0.222222222222222,0,"Unknown"
"96523",22,38,172,176,177,183,133,135,11,1,2,9,10,1,"win_A",-16,-4,-6,-2,0,1,0,0,0.846153846153846,0.1,0.769230769230769,0.1,0,"Unknown"
"96767",24,19,168,163,175,165,128,128,1,2,0,5,1,1,"win_A",5,5,10,0,0,0,0,0,1,0.285714285714286,1,0.142857142857143,0,"Unknown"
"96965",43,35,178,180,185,198,156,154,30,18,19,7,16,9,"win_A",8,-2,-13,2,1,1,0,0,0.612244897959184,0.72,0.326530612244898,0.36,0,"orthodox"
"96970",32,38,180,175,198,188,158,159,15,17,5,16,7,7,"win_A",-6,5,10,-1,0,1,0,0,0.75,0.515151515151515,0.35,0.212121212121212,0,"orthodox"
"96971",32,27,180,173,198,178,156,152,14,26,5,47,6,6,"win_A",5,7,20,4,0,0,0,0,0.736842105263158,0.356164383561644,0.315789473684211,0.0821917808219178,0,"orthodox"
"96973",40,32,178,180,185,198,156,158,26,13,12,4,15,5,"win_A",8,-2,-13,-2,1,0,0,0,0.684210526315789,0.764705882352941,0.394736842105263,0.294117647058824,0,"orthodox"
"96977",30,26,180,179,198,178,149,148,10,13,3,2,3,6,"win_A",4,1,20,1,0,0,0,0,0.769230769230769,0.866666666666667,0.230769230769231,0.4,0,"orthodox"
"96979",26,30,173,180,191,198,149,147,19,9,5,2,9,3,"win_A",-4,-7,-7,2,0,0,0,0,0.791666666666667,0.818181818181818,0.375,0.272727272727273,0,"southpaw"
"97088",17,25,173,166,173,166,126,124,1,2,0,2,0,0,"win_A",-8,7,7,2,0,0,0,0,1,0.5,0,0,0,"orthodox"
"97352",31,31,196,193,216,203,245,256,11,8,0,1,7,0,"win_A",0,3,13,-11,0,0,0,0,1,0.888888888888889,0.636363636363636,0,0,"orthodox"
"97354",30,43,193,191,203,198,248,232,6,25,1,9,0,18,"win_A",-13,2,5,16,0,1,1,0,0.857142857142857,0.735294117647059,0,0.529411764705882,0,"southpaw"
"97415",27,27,165,173,165,180,117,118,14,36,1,2,7,22,"win_A",0,-8,-15,-1,0,0,0,0,0.933333333333333,0.947368421052632,0.466666666666667,0.578947368421053,0,"orthodox"
"97423",25,23,170,165,175,165,114,115,12,7,3,0,5,4,"win_A",2,5,10,-1,0,0,0,0,0.8,1,0.333333333333333,0.571428571428571,0,"southpaw"
"97937",35,33,193,188,203,191,221,221,19,26,2,3,17,14,"win_A",2,5,12,0,1,0,0,0,0.904761904761905,0.896551724137931,0.80952380952381,0.482758620689655,0,"orthodox"
"97938",33,42,188,187,191,192,215,197,25,30,3,20,13,28,"win_A",-9,1,-1,18,0,1,1,0,0.892857142857143,0.6,0.464285714285714,0.56,0,"southpaw"
"97939",33,28,188,198,191,206,224,310,24,23,3,7,13,15,"win_A",5,-10,-15,-86,0,0,0,1,0.888888888888889,0.766666666666667,0.481481481481481,0.5,0,"southpaw"
"97941",29,31,191,188,203,191,227,244,18,23,2,2,9,12,"win_A",-2,3,12,-17,0,0,0,1,0.9,0.92,0.45,0.48,0,"orthodox"
"97942",31,29,188,193,191,208,210,242,22,10,2,2,12,5,"win_A",2,-5,-17,-32,0,0,0,1,0.916666666666667,0.833333333333333,0.5,0.416666666666667,0,"southpaw"
"97944",30,26,188,185,191,189,221,217,20,14,2,12,10,11,"win_A",4,3,2,4,0,0,0,0,0.909090909090909,0.538461538461538,0.454545454545455,0.423076923076923,0,"southpaw"
"97945",43,30,192,188,198,191,220,242,49,20,10,1,34,10,"win_A",13,4,7,-22,1,0,0,1,0.830508474576271,0.952380952380952,0.576271186440678,0.476190476190476,0,"orthodox"
"97946",29,30,188,194,191,202,218,300,19,19,1,2,10,14,"win_A",-1,-6,-11,-82,0,0,0,1,0.95,0.904761904761905,0.5,0.666666666666667,0,"southpaw"
"97947",29,33,188,191,191,203,215,252,18,27,1,13,10,24,"win_A",-4,-3,-12,-37,0,0,0,1,0.947368421052632,0.675,0.526315789473684,0.6,0,"southpaw"
"97948",29,36,188,178,191,185,224,252,17,37,1,18,10,28,"win_A",-7,10,6,-28,0,1,0,1,0.944444444444444,0.672727272727273,0.555555555555556,0.509090909090909,0,"southpaw"
"97950",28,30,188,180,191,203,210,223,15,7,1,16,10,4,"win_A",-2,8,-12,-13,0,0,0,0,0.9375,0.304347826086957,0.625,0.173913043478261,0,"southpaw"
"97952",27,27,187,188,188,191,223,216,24,14,0,0,14,10,"win_A",0,-1,-3,7,0,0,0,0,1,1,0.583333333333333,0.714285714285714,0,"southpaw"
"97957",26,26,188,180,191,193,188,188,9,9,0,7,7,9,"win_A",0,8,-2,0,0,0,0,0,1,0.5625,0.777777777777778,0.5625,0,"southpaw"
"98143",19,25,173,163,174,173,127,127,5,5,0,9,2,2,"win_A",-6,10,1,0,0,0,0,0,1,0.357142857142857,0.4,0.142857142857143,0,"Unknown"
"98150",39,22,180,180,183,174,135,135,2,4,4,2,1,4,"win_B",17,0,9,0,1,0,0,0,0.333333333333333,0.666666666666667,0.166666666666667,0.666666666666667,1,"orthodox"
"98911",25,25,163,158,168,160,114,115,2,7,1,1,1,0,"win_B",0,5,8,-1,0,0,0,0,0.666666666666667,0.875,0.333333333333333,0,1,"southpaw"
"98916",24,17,158,165,160,165,114,116,2,0,0,1,0,0,"win_A",7,-7,-5,-2,0,0,0,0,1,0,0,0,0,"orthodox"
"98919",18,19,167,155,168,157,109,109,4,2,1,0,0,0,"win_B",-1,12,11,0,0,0,0,0,0.8,1,0,0,1,"orthodox"
"98920",26,19,164,155,163,157,110,112,5,1,2,0,1,0,"win_B",7,9,6,-2,0,0,0,0,0.714285714285714,1,0.142857142857143,0,1,"orthodox"
"99077",39,36,168,178,165,199,168,163,12,5,5,1,9,4,"win_A",3,-10,-34,5,1,1,0,0,0.705882352941177,0.833333333333333,0.529411764705882,0.666666666666667,0,"orthodox"
"99215",24,22,168,171,170,168,112,112,21,13,3,5,12,7,"win_A",2,-3,2,0,0,0,0,0,0.875,0.722222222222222,0.5,0.388888888888889,0,"orthodox"
"99389",22,29,170,173,178,170,140,139,4,11,0,9,3,7,"win_A",-7,-3,8,1,0,0,0,0,1,0.55,0.75,0.35,0,"orthodox"
"99583",30,33,188,176,191,178,227,225,2,3,0,4,2,2,"win_A",-3,12,13,2,0,0,0,0,1,0.428571428571429,1,0.285714285714286,0,"orthodox"
"100145",29,22,165,168,169,168,117,117,2,8,0,2,0,0,"win_A",7,-3,1,0,0,0,0,0,1,0.8,0,0,0,"southpaw"
"100169",26,28,175,178,179,185,135,135,22,14,2,2,18,7,"win_A",-2,-3,-6,0,0,0,0,0,0.916666666666667,0.875,0.75,0.4375,0,"Unknown"
"100176",24,24,175,170,179,178,140,141,15,8,1,15,13,6,"win_A",0,5,1,-1,0,0,0,0,0.9375,0.347826086956522,0.8125,0.260869565217391,0,"Unknown"
"100188",21,33,175,168,179,171,136,134,4,54,0,15,4,40,"win_A",-12,7,8,2,0,0,0,0,1,0.782608695652174,1,0.579710144927536,0,"Unknown"
"100211",37,37,180,188,183,191,227,213,36,20,5,13,23,9,"win_A",0,-8,-8,14,1,1,0,0,0.878048780487805,0.606060606060606,0.560975609756098,0.272727272727273,0,"orthodox"
"100230",25,31,180,188,183,191,218,229,24,8,1,5,17,5,"win_A",-6,-8,-8,-11,0,0,0,0,0.96,0.615384615384615,0.68,0.384615384615385,0,"orthodox"
"100432",28,26,183,185,175,196,159,159,25,18,1,3,9,17,"win_B",2,-2,-21,0,0,0,0,0,0.961538461538462,0.857142857142857,0.346153846153846,0.80952380952381,1,"orthodox"
"100614",29,22,165,168,169,168,117,117,2,8,0,2,0,0,"win_A",7,-3,1,0,0,0,0,0,1,0.8,0,0,0,"southpaw"
"100638",26,28,175,178,179,185,135,135,22,14,2,2,18,7,"win_A",-2,-3,-6,0,0,0,0,0,0.916666666666667,0.875,0.75,0.4375,0,"Unknown"
"100645",24,24,175,170,179,178,140,141,15,8,1,15,13,6,"win_A",0,5,1,-1,0,0,0,0,0.9375,0.347826086956522,0.8125,0.260869565217391,0,"Unknown"
"100657",21,33,175,168,179,171,136,134,4,54,0,15,4,40,"win_A",-12,7,8,2,0,0,0,0,1,0.782608695652174,1,0.579710144927536,0,"Unknown"
"100680",37,37,180,188,183,191,227,213,36,20,5,13,23,9,"win_A",0,-8,-8,14,1,1,0,0,0.878048780487805,0.606060606060606,0.560975609756098,0.272727272727273,0,"orthodox"
"100699",25,31,180,188,183,191,218,229,24,8,1,5,17,5,"win_A",-6,-8,-8,-11,0,0,0,0,0.96,0.615384615384615,0.68,0.384615384615385,0,"orthodox"
"100901",28,26,183,185,175,196,159,159,25,18,1,3,9,17,"win_B",2,-2,-21,0,0,0,0,0,0.961538461538462,0.857142857142857,0.346153846153846,0.80952380952381,1,"orthodox"
"102080",22,22,173,170,168,170,115,115,13,10,2,2,7,5,"win_A",0,3,-2,0,0,0,0,0,0.866666666666667,0.833333333333333,0.466666666666667,0.416666666666667,0,"orthodox"
"102170",30,30,173,183,165,188,159,159,25,18,4,10,11,12,"win_B",0,-10,-23,0,0,0,0,0,0.862068965517241,0.642857142857143,0.379310344827586,0.428571428571429,1,"orthodox"
"102175",28,31,173,178,165,173,154,154,23,13,1,6,9,7,"win_A",-3,-5,-8,0,0,0,0,0,0.958333333333333,0.684210526315789,0.375,0.368421052631579,0,"orthodox"
"102186",34,24,168,173,165,165,158,157,21,13,22,0,4,5,"win_B",10,-5,0,1,0,0,0,0,0.488372093023256,1,0.0930232558139535,0.384615384615385,1,"orthodox"
"102191",22,22,173,173,165,173,160,162,8,7,0,15,4,5,"win_A",0,0,-8,-2,0,0,0,0,1,0.318181818181818,0.5,0.227272727272727,0,"orthodox"
"102255",21,32,182,188,193,201,160,160,6,24,0,5,4,21,"win_A",-11,-6,-8,0,0,0,0,0,1,0.827586206896552,0.666666666666667,0.724137931034483,0,"southpaw"
"102268",26,28,188,180,201,180,162,161,14,15,0,5,12,10,"win_A",-2,8,21,1,0,0,0,0,1,0.75,0.857142857142857,0.5,0,"orthodox"
"102367",30,26,177,180,180,183,152,154,5,7,0,0,4,5,"win_A",4,-3,-3,-2,0,0,0,0,1,1,0.8,0.714285714285714,0,"orthodox"
"102369",26,26,178,180,180,183,152,154,0,5,2,0,0,4,"win_B",0,-2,-3,-2,0,0,0,0,0,1,0,0.8,1,"orthodox"
"102818",23,37,188,196,192,208,230,226,3,7,1,5,1,4,"win_A",-14,-8,-16,4,0,1,0,0,0.75,0.583333333333333,0.25,0.333333333333333,0,"Unknown"
"103061",20,21,168,168,170,168,125,126,2,1,0,1,0,0,"win_A",-1,0,2,-1,0,0,0,0,1,0.5,0,0,0,"orthodox"
"103062",24,20,170,168,175,170,125,126,1,1,0,0,0,0,"win_B",4,2,5,-1,0,0,0,0,1,1,0,0,1,"orthodox"
"103197",19,31,191,193,193,206,210,225,9,16,0,6,8,12,"win_A",-12,-2,-13,-15,0,0,0,1,1,0.727272727272727,0.888888888888889,0.545454545454545,0,"orthodox"
"104226",22,22,168,178,175,175,125,125,9,10,1,1,4,6,"win_A",0,-10,0,0,0,0,0,0,0.9,0.909090909090909,0.4,0.545454545454545,0,"orthodox"
"104227",20,22,168,178,169,175,134,135,17,10,0,0,10,6,"win_A",-2,-10,-6,-1,0,0,0,0,1,1,0.588235294117647,0.6,0,"orthodox"
"104672",31,39,170,168,183,183,140,139,11,46,6,19,8,30,"win_A",-8,2,0,1,0,1,0,0,0.647058823529412,0.707692307692308,0.470588235294118,0.461538461538462,0,"orthodox"
"104674",22,28,177,170,175,183,147,147,3,10,0,4,2,7,"win_A",-6,7,-8,0,0,0,0,0,1,0.714285714285714,0.666666666666667,0.5,0,"orthodox"
"104682",27,24,178,170,185,183,134,132,13,4,1,0,7,2,"win_A",3,8,2,2,0,0,0,0,0.928571428571429,1,0.5,0.5,0,"orthodox"
"104836",29,30,168,165,168,170,115,114,7,12,4,1,3,5,"win_A",-1,3,-2,1,0,0,0,0,0.636363636363636,0.923076923076923,0.272727272727273,0.384615384615385,0,"orthodox"
"104837",30,22,165,160,170,168,114,115,11,7,1,5,5,3,"win_A",8,5,2,-1,0,0,0,0,0.916666666666667,0.583333333333333,0.416666666666667,0.25,0,"Unknown"
"104843",28,25,165,157,170,168,121,123,5,2,1,8,4,0,"win_A",3,8,2,-2,0,0,0,0,0.833333333333333,0.2,0.666666666666667,0,0,"Unknown"
"104844",28,23,165,163,170,173,114,116,4,6,1,1,4,4,"win_A",5,2,-3,-2,0,0,0,0,0.8,0.857142857142857,0.8,0.571428571428571,0,"Unknown"
"104845",27,25,165,175,170,193,120,120,3,2,1,5,3,0,"win_A",2,-10,-23,0,0,0,0,0,0.75,0.285714285714286,0.75,0,0,"Unknown"
"104982",25,26,165,165,168,170,118,118,26,23,1,7,16,11,"win_A",-1,0,-2,0,0,0,0,0,0.962962962962963,0.766666666666667,0.592592592592593,0.366666666666667,0,"southpaw"
"104992",23,21,165,175,170,175,127,127,12,17,4,7,6,12,"win_A",2,-10,-5,0,0,0,0,0,0.75,0.708333333333333,0.375,0.5,0,"orthodox"
"105141",38,25,175,168,183,173,144,146,41,14,7,6,24,11,"win_A",13,7,10,-2,1,0,0,0,0.854166666666667,0.7,0.5,0.55,0,"southpaw"
"105144",31,25,170,168,170,173,143,145,21,14,6,3,11,11,"win_A",6,2,-3,-2,0,0,0,0,0.777777777777778,0.823529411764706,0.407407407407407,0.647058823529412,0,"orthodox"
"105897",35,32,173,165,175,178,175,168,57,29,6,31,31,25,"win_A",3,8,-3,7,1,0,0,0,0.904761904761905,0.483333333333333,0.492063492063492,0.416666666666667,0,"southpaw"
"105910",29,29,173,178,175,178,162,160,45,14,3,3,26,6,"win_A",0,-5,-3,2,0,0,0,0,0.9375,0.823529411764706,0.541666666666667,0.352941176470588,0,"southpaw"
"105924",23,29,173,175,175,183,144,144,33,19,1,3,19,15,"win_A",-6,-2,-8,0,0,0,0,0,0.970588235294118,0.863636363636364,0.558823529411765,0.681818181818182,0,"southpaw"
"105925",29,23,170,173,183,175,147,141,33,33,3,0,16,19,"win_A",6,-3,8,6,0,0,0,0,0.916666666666667,1,0.444444444444444,0.575757575757576,0,"orthodox"
"105930",21,30,173,168,175,173,140,138,28,36,0,3,17,21,"win_A",-9,5,2,2,0,0,0,0,1,0.923076923076923,0.607142857142857,0.538461538461538,0,"southpaw"
"105932",21,39,173,161,175,170,138,139,26,43,0,11,15,21,"win_A",-18,12,5,-1,0,1,0,0,1,0.796296296296296,0.576923076923077,0.388888888888889,0,"southpaw"
"105933",21,26,173,175,175,173,143,142,25,36,0,12,14,23,"win_A",-5,-2,2,1,0,0,0,0,1,0.75,0.56,0.479166666666667,0,"southpaw"
"105935",20,33,173,168,175,173,143,142,23,25,0,8,13,17,"win_A",-13,5,2,1,0,0,0,0,1,0.757575757575758,0.565217391304348,0.515151515151515,0,"southpaw"
"105966",18,24,170,158,175,158,115,115,1,1,0,0,0,0,"win_A",-6,12,17,0,0,0,0,0,1,1,0,0,0,"orthodox"
"106037",26,25,173,170,180,173,140,139,7,4,0,8,4,2,"win_B",1,3,7,1,0,0,0,0,1,0.333333333333333,0.571428571428571,0.166666666666667,1,"Unknown"
"106544",22,32,173,166,178,165,135,134,8,5,0,7,5,3,"win_A",-10,7,13,1,0,0,0,0,1,0.416666666666667,0.625,0.25,0,"southpaw"
"106547",21,27,173,169,178,174,136,136,5,5,0,1,4,3,"win_A",-6,4,4,0,0,0,0,0,1,0.833333333333333,0.8,0.5,0,"southpaw"
"107004",34,25,168,173,178,175,135,135,9,9,3,1,3,5,"win_A",9,-5,3,0,0,0,0,0,0.75,0.9,0.25,0.5,0,"Unknown"
"107525",31,39,175,180,177,180,154,155,13,17,3,10,4,14,"win_A",-8,-5,-3,-1,0,1,0,0,0.8125,0.62962962962963,0.25,0.518518518518518,0,"orthodox"
"107561",34,29,168,169,180,174,135,135,21,5,3,2,14,3,"win_A",5,-1,6,0,0,0,0,0,0.875,0.714285714285714,0.583333333333333,0.428571428571429,0,"southpaw"
"107562",27,27,173,169,185,174,135,135,11,5,0,0,7,3,"win_A",0,4,11,0,0,0,0,0,1,1,0.636363636363636,0.6,0,"orthodox"
"107563",24,29,169,165,174,168,132,132,4,5,0,5,3,0,"win_A",-5,4,6,0,0,0,0,0,1,0.5,0.75,0,0,"orthodox"
"107883",18,34,170,165,175,170,118,119,3,0,0,3,2,0,"win_A",-16,5,5,-1,0,0,0,0,1,0,0.666666666666667,0,0,"southpaw"
"108366",29,38,180,170,185,169,164,171,5,16,3,19,3,10,"win_A",-9,10,16,-7,0,1,0,0,0.625,0.457142857142857,0.375,0.285714285714286,0,"orthodox"
"108378",30,28,173,170,173,169,145,142,14,8,6,11,8,6,"win_A",2,3,4,3,0,0,0,0,0.7,0.421052631578947,0.4,0.315789473684211,0,"orthodox"
"108379",38,27,173,170,179,169,147,146,9,7,6,10,6,6,"win_A",11,3,10,1,1,0,0,0,0.6,0.411764705882353,0.4,0.352941176470588,0,"orthodox"
"108384",27,25,170,170,173,169,148,149,4,5,0,5,1,4,"win_A",2,0,4,-1,0,0,0,0,1,0.5,0.25,0.4,0,"orthodox"
"108817",32,33,165,159,166,173,122,122,30,32,6,22,18,18,"win_A",-1,6,-7,0,0,0,0,0,0.833333333333333,0.592592592592593,0.5,0.333333333333333,0,"southpaw"
"108932",26,34,188,193,188,191,247,248,25,37,0,11,17,29,"win_A",-8,-5,-3,-1,0,0,0,0,1,0.770833333333333,0.68,0.604166666666667,0,"orthodox"
"108935",42,33,193,193,203,191,238,238,54,34,6,7,48,26,"win_A",9,0,12,0,1,0,0,0,0.9,0.829268292682927,0.8,0.634146341463415,0,"orthodox"
"110271",34,38,168,170,183,178,136,138,37,33,13,6,25,25,"win_A",-4,-2,5,-2,0,1,0,0,0.74,0.846153846153846,0.5,0.641025641025641,0,"southpaw"
"110272",32,34,170,168,175,183,134,138,23,36,7,13,8,25,"win_B",-2,2,-8,-4,0,0,0,0,0.766666666666667,0.73469387755102,0.266666666666667,0.510204081632653,1,"orthodox"
"110278",23,32,173,168,173,183,129,130,26,34,0,5,19,23,"win_A",-9,5,-10,-1,0,0,0,0,1,0.871794871794872,0.730769230769231,0.58974358974359,0,"orthodox"
"110297",25,26,168,173,183,178,126,126,19,15,0,6,13,10,"win_A",-1,-5,5,0,0,0,0,0,1,0.714285714285714,0.684210526315789,0.476190476190476,0,"southpaw"
"110636",23,26,183,181,186,185,158,162,7,5,2,4,4,0,"win_A",-3,2,1,-4,0,0,0,0,0.777777777777778,0.555555555555556,0.444444444444444,0,0,"orthodox"
"110637",18,23,178,183,179,186,157,157,1,6,3,2,0,3,"win_B",-5,-5,-7,0,0,0,0,0,0.25,0.75,0,0.375,1,"orthodox"
"110638",23,31,183,179,186,180,158,159,6,5,1,4,3,4,"win_B",-8,4,6,-1,0,0,0,0,0.857142857142857,0.555555555555556,0.428571428571429,0.444444444444444,1,"orthodox"
"110640",22,23,183,172,186,182,156,157,4,0,1,1,2,0,"win_A",-1,11,4,-1,0,0,0,0,0.8,0,0.4,0,0,"orthodox"
"110642",19,22,180,183,180,186,158,155,0,2,1,1,0,1,"win_B",-3,-3,-6,3,0,0,0,0,0,0.666666666666667,0,0.333333333333333,1,"orthodox"
"110644",22,30,183,177,186,180,153,154,1,4,0,0,1,3,"win_B",-8,6,6,-1,0,0,0,0,1,1,1,0.75,1,"orthodox"
"110683",21,20,170,172,174,173,122,122,3,2,2,0,1,0,"win_A",1,-2,1,0,0,0,0,0,0.6,1,0.2,0,0,"southpaw"
"111205",23,19,167,171,175,172,115,115,2,2,1,1,0,0,"win_A",4,-4,3,0,0,0,0,0,0.666666666666667,0.666666666666667,0,0,0,"orthodox"
"111245",21,26,175,178,172,178,138,140,3,1,1,0,3,0,"win_B",-5,-3,-6,-2,0,0,0,0,0.75,1,0.75,0,1,"orthodox"
"111391",23,31,163,160,164,163,121,123,11,7,17,23,9,7,"win_A",-8,3,1,-2,0,0,0,0,0.392857142857143,0.233333333333333,0.321428571428571,0.233333333333333,0,"orthodox"
"111398",27,22,163,163,159,164,115,114,6,6,13,13,5,5,"win_A",5,0,-5,1,0,0,0,0,0.315789473684211,0.315789473684211,0.263157894736842,0.263157894736842,0,"orthodox"
"111406",18,20,157,163,160,164,108,109,7,1,1,8,5,1,"win_A",-2,-6,-4,-1,0,0,0,0,0.875,0.111111111111111,0.625,0.111111111111111,0,"orthodox"
"111407",25,20,165,163,173,164,115,115,7,1,9,7,5,1,"win_A",5,2,9,0,0,0,0,0,0.4375,0.125,0.3125,0.125,0,"orthodox"
"111409",25,18,165,163,165,164,112,113,20,1,5,4,15,1,"win_A",7,2,1,-1,0,0,0,0,0.8,0.2,0.6,0.2,0,"orthodox"
"111598",25,26,173,170,182,170,132,131,5,5,0,10,1,1,"win_B",-1,3,12,1,0,0,0,0,1,0.333333333333333,0.2,0.0666666666666667,1,"Unknown"
"111602",21,24,175,170,183,170,137,130,5,3,0,6,3,1,"win_A",-3,5,13,7,0,0,0,0,1,0.333333333333333,0.6,0.111111111111111,0,"orthodox"
"111632",34,27,168,175,178,180,132,140,10,15,3,17,3,6,"win_A",7,-7,-2,-8,0,0,0,0,0.769230769230769,0.46875,0.230769230769231,0.1875,0,"Unknown"
"111635",33,26,173,175,173,180,140,140,21,13,3,13,11,5,"win_A",7,-2,-7,0,0,0,0,0,0.875,0.5,0.458333333333333,0.192307692307692,0,"southpaw"
"111640",24,23,165,175,165,180,128,133,15,13,0,3,5,5,"win_A",1,-10,-15,-5,0,0,0,0,1,0.8125,0.333333333333333,0.3125,0,"orthodox"
"111647",20,24,175,175,180,188,130,131,7,6,0,0,2,3,"win_A",-4,0,-8,-1,0,0,0,0,1,1,0.285714285714286,0.5,0,"southpaw"
"111667",42,31,183,165,183,178,165,164,55,29,10,29,33,25,"win_A",11,18,5,1,1,0,0,0,0.846153846153846,0.5,0.507692307692308,0.431034482758621,0,"southpaw"
"111669",30,36,165,168,178,170,147,148,27,13,26,26,23,10,"win_A",-6,-3,8,-1,0,1,0,0,0.509433962264151,0.333333333333333,0.433962264150943,0.256410256410256,0,"orthodox"
"111681",28,22,165,180,178,182,139,140,18,1,19,7,15,0,"win_A",6,-15,-4,-1,0,0,0,0,0.486486486486487,0.125,0.405405405405405,0,0,"orthodox"
"111682",27,28,173,165,185,178,131,139,14,18,0,18,10,15,"win_A",-1,8,7,-8,0,0,0,0,1,0.5,0.714285714285714,0.416666666666667,0,"orthodox"
"111687",22,27,170,165,166,178,136,136,17,16,0,15,12,13,"win_A",-5,5,-12,0,0,0,0,0,1,0.516129032258065,0.705882352941177,0.419354838709677,0,"orthodox"
"111691",22,25,170,165,185,178,135,135,17,16,3,11,5,13,"win_A",-3,5,7,0,0,0,0,0,0.85,0.592592592592593,0.25,0.481481481481481,0,"orthodox"
"111692",22,25,173,165,178,178,133,135,22,16,0,9,12,13,"win_A",-3,8,0,-2,0,0,0,0,1,0.64,0.545454545454545,0.52,0,"orthodox"
"111694",25,25,173,165,188,178,130,132,14,15,1,8,11,13,"win_A",0,8,10,-2,0,0,0,0,0.933333333333333,0.652173913043478,0.733333333333333,0.565217391304348,0,"orthodox"
"112267",31,25,177,180,180,183,157,158,6,1,1,0,4,1,"win_A",6,-3,-3,-1,0,0,0,0,0.857142857142857,1,0.571428571428571,1,0,"orthodox"
"112270",26,30,178,177,180,180,154,154,0,1,1,0,0,1,"win_B",-4,1,0,0,0,0,0,0,0,1,0,1,1,"orthodox"
"112568",29,29,196,188,213,188,259,237,14,15,0,5,11,10,"win_A",0,8,25,22,0,0,1,0,1,0.75,0.785714285714286,0.5,0,"orthodox"
"112708",28,28,163,163,173,159,108,109,11,8,11,16,6,6,"win_A",0,0,14,-1,0,0,0,0,0.5,0.333333333333333,0.272727272727273,0.25,0,"orthodox"
"112711",36,27,152,163,160,173,104,104,34,9,2,10,6,4,"win_A",9,-11,-13,0,1,0,0,0,0.944444444444444,0.473684210526316,0.166666666666667,0.210526315789474,0,"southpaw"
"112744",29,35,179,183,184,183,183,182,35,15,5,12,22,7,"win_A",-6,-4,1,1,0,1,0,0,0.875,0.555555555555556,0.55,0.259259259259259,0,"orthodox"
"112763",27,22,183,169,183,173,168,159,3,10,5,5,0,7,"win_A",5,14,10,9,0,0,0,0,0.375,0.666666666666667,0,0.466666666666667,0,"Unknown"
"112908",24,36,170,163,166,170,123,123,22,16,2,18,17,6,"win_A",-12,7,-4,0,0,1,0,0,0.916666666666667,0.470588235294118,0.708333333333333,0.176470588235294,0,"orthodox"
"112913",26,35,170,163,168,170,120,120,16,15,2,10,6,6,"win_A",-9,7,-2,0,0,1,0,0,0.888888888888889,0.6,0.333333333333333,0.24,0,"orthodox"
"113076",28,20,167,170,168,170,112,111,2,3,1,3,0,0,"win_A",8,-3,-2,1,0,0,0,0,0.666666666666667,0.5,0,0,0,"orthodox"
"113077",25,28,163,167,168,168,112,111,1,1,0,1,1,0,"win_B",-3,-4,0,1,0,0,0,0,1,0.5,1,0,1,"southpaw"
"113078",28,18,167,167,168,168,111,108,1,3,0,1,0,0,"win_B",10,0,0,3,0,0,0,0,1,0.75,0,0,1,"orthodox"
"113144",22,24,183,185,188,191,210,240,2,2,0,0,0,1,"win_A",-2,-2,-3,-30,0,0,0,1,1,1,0,0.5,0,"Unknown"
"113231",29,21,179,175,182,175,139,139,5,2,0,0,1,2,"win_A",8,4,7,0,0,0,0,0,1,1,0.2,1,0,"southpaw"
"113233",29,22,179,173,182,173,139,139,3,1,0,2,1,0,"win_A",7,6,9,0,0,0,0,0,1,0.333333333333333,0.333333333333333,0,0,"southpaw"
"113235",18,29,181,179,181,182,139,142,0,1,1,0,0,0,"win_B",-11,2,-1,-3,0,0,0,0,0,1,0,0,1,"orthodox"
"113374",23,26,180,175,183,183,156,155,3,5,2,9,1,3,"win_A",-3,5,0,1,0,0,0,0,0.6,0.357142857142857,0.2,0.214285714285714,0,"orthodox"
"113427",22,19,173,175,173,185,135,135,4,4,2,2,0,2,"win_B",3,-2,-12,0,0,0,0,0,0.666666666666667,0.666666666666667,0,0.333333333333333,1,"orthodox"
"113429",19,27,175,173,185,173,133,134,2,1,1,1,1,1,"win_A",-8,2,12,-1,0,0,0,0,0.666666666666667,0.5,0.333333333333333,0.5,0,"southpaw"
"113431",23,18,169,175,171,185,132,132,0,1,2,0,0,0,"win_A",5,-6,-14,0,0,0,0,0,0,1,0,0,0,"orthodox"
"113455",22,21,173,170,173,171,135,135,3,6,2,3,0,1,"win_A",1,3,2,0,0,0,0,0,0.6,0.666666666666667,0,0.111111111111111,0,"orthodox"
"113457",21,22,170,173,171,173,135,134,5,2,2,0,1,0,"win_A",-1,-3,-2,1,0,0,0,0,0.714285714285714,1,0.142857142857143,0,0,"Unknown"
"113460",26,19,168,170,162,171,137,126,1,1,1,2,1,0,"win_B",7,-2,-9,11,0,0,0,0,0.5,0.333333333333333,0.5,0,1,"orthodox"
"113461",17,19,175,170,178,171,130,128,0,1,1,1,0,0,"win_A",-2,5,7,2,0,0,0,0,0,0.5,0,0,0,"orthodox"
"113596",36,37,193,192,201,206,237,250,36,24,1,17,34,19,"win_B",-1,1,-5,-13,1,1,0,0,0.972972972972973,0.585365853658537,0.918918918918919,0.463414634146341,1,"orthodox"
"113789",30,28,164,162,168,183,115,115,52,26,6,5,40,14,"win_A",2,2,-15,0,0,0,0,0,0.896551724137931,0.838709677419355,0.689655172413793,0.451612903225806,0,"orthodox"
"113852",23,32,180,179,183,180,158,159,5,6,0,4,3,5,"win_A",-9,1,3,-1,0,0,0,0,1,0.6,0.6,0.5,0,"southpaw"
"113853",22,22,180,184,183,182,159,159,4,3,0,3,2,3,"win_A",0,-4,1,0,0,0,0,0,1,0.5,0.5,0.5,0,"southpaw"
"113855",22,23,180,177,183,182,160,158,2,1,0,0,2,0,"win_A",-1,3,1,2,0,0,0,0,1,1,1,0,0,"southpaw"
"114404",27,32,196,180,210,175,231,272,9,17,0,10,6,7,"win_A",-5,16,35,-41,0,0,0,1,1,0.62962962962963,0.666666666666667,0.259259259259259,0,"orthodox"
"114677",21,16,160,167,164,166,121,122,5,0,6,2,2,0,"win_A",5,-7,-2,-1,0,0,0,0,0.454545454545455,0,0.181818181818182,0,0,"orthodox"
"114678",21,23,160,168,164,166,114,114,4,0,6,1,2,0,"win_A",-2,-8,-2,0,0,0,0,0,0.4,0,0.2,0,0,"orthodox"
"114727",30,28,163,167,159,165,115,116,15,5,28,7,10,2,"win_A",2,-4,-6,-1,0,0,0,0,0.348837209302326,0.416666666666667,0.232558139534884,0.166666666666667,0,"orthodox"
"114732",29,31,163,160,159,163,116,120,11,7,23,24,7,7,"win_A",-2,3,-4,-4,0,0,0,0,0.323529411764706,0.225806451612903,0.205882352941176,0.225806451612903,0,"orthodox"
"114755",19,25,157,163,160,159,108,109,8,0,1,5,6,0,"win_A",-6,-6,1,-1,0,0,0,0,0.888888888888889,0,0.666666666666667,0,0,"orthodox"
"114850",26,40,195,191,201,201,279,236,27,45,1,20,13,34,"win_A",-14,4,0,43,0,1,1,0,0.964285714285714,0.692307692307692,0.464285714285714,0.523076923076923,0,"orthodox"
"114863",29,34,185,191,185,201,267,222,9,38,0,6,8,30,"win_B",-5,-6,-16,45,0,0,1,0,1,0.863636363636364,0.888888888888889,0.681818181818182,1,"orthodox"
"114865",30,33,191,191,198,201,228,239,17,36,0,6,9,29,"win_B",-3,0,-3,-11,0,0,0,0,1,0.857142857142857,0.529411764705882,0.69047619047619,1,"orthodox"
"114870",32,34,191,197,201,218,272,253,33,19,4,0,28,14,"win_A",-2,-6,-17,19,0,0,1,0,0.891891891891892,1,0.756756756756757,0.736842105263158,0,"orthodox"
"114871",33,31,201,191,201,201,270,250,34,32,2,3,33,27,"win_A",2,10,0,20,0,0,1,0,0.944444444444444,0.914285714285714,0.916666666666667,0.771428571428571,0,"orthodox"
"114872",31,38,191,178,201,180,265,233,31,50,3,4,26,44,"win_A",-7,13,21,32,0,1,1,0,0.911764705882353,0.925925925925926,0.764705882352941,0.814814814814815,0,"orthodox"
"114875",29,37,191,196,201,203,245,264,27,18,2,10,22,10,"win_A",-8,-5,-2,-19,0,1,0,1,0.931034482758621,0.642857142857143,0.758620689655172,0.357142857142857,0,"orthodox"
"114882",27,32,191,188,201,196,257,248,20,25,1,9,16,18,"win_A",-5,3,5,9,0,0,0,0,0.952380952380952,0.735294117647059,0.761904761904762,0.529411764705882,0,"orthodox"
"114888",25,34,191,188,201,201,248,240,15,19,0,7,12,11,"win_B",-9,3,0,8,0,0,0,0,1,0.730769230769231,0.8,0.423076923076923,1,"orthodox"
"115452",21,35,180,175,165,173,152,153,3,4,0,6,2,1,"win_A",-14,5,-8,-1,0,1,0,0,1,0.4,0.666666666666667,0.1,0,"orthodox"
"116056",18,24,168,170,168,175,127,128,3,1,1,1,1,0,"win_A",-6,-2,-7,-1,0,0,0,0,0.75,0.5,0.25,0,0,"orthodox"
"116071",20,18,180,182,180,185,160,160,0,5,5,1,0,3,"win_B",2,-2,-5,0,0,0,0,0,0,0.833333333333333,0,0.5,1,"orthodox"
"116679",18,22,168,170,170,172,125,125,2,0,0,1,0,0,"win_A",-4,-2,-2,0,0,0,0,0,1,0,0,0,0,"southpaw"
"116775",23,20,170,175,171,175,125,125,1,0,1,1,1,0,"win_A",3,-5,-4,0,0,0,0,0,0.5,0,0.5,0,0,"southpaw"
"117060",26,34,185,188,187,201,186,189,12,41,4,6,10,25,"win_A",-8,-3,-14,-3,0,0,0,0,0.75,0.872340425531915,0.625,0.531914893617021,0,"orthodox"
"117381",23,31,168,169,175,173,130,130,13,10,0,3,3,7,"win_A",-8,-1,2,0,0,0,0,0,1,0.769230769230769,0.230769230769231,0.538461538461538,0,"southpaw"
"117383",29,30,175,169,183,173,134,136,7,9,1,2,2,7,"win_A",-1,6,10,-2,0,0,0,0,0.875,0.818181818181818,0.25,0.636363636363636,0,"Unknown"
"117486",21,19,172,175,175,175,161,160,1,4,1,1,0,4,"win_B",2,-3,0,1,0,0,0,0,0.5,0.8,0,0.8,1,"orthodox"
"117490",18,17,188,175,190,175,175,171,4,1,3,0,2,1,"win_B",1,13,15,4,0,0,0,0,0.571428571428571,1,0.285714285714286,1,1,"orthodox"
"118152",28,38,170,170,161,180,148,144,18,12,2,20,11,8,"win_A",-10,0,-19,4,0,1,0,0,0.9,0.375,0.55,0.25,0,"southpaw"
"118156",27,36,178,170,180,180,145,147,10,12,0,10,6,8,"win_A",-9,8,0,-2,0,1,0,0,1,0.545454545454545,0.6,0.363636363636364,0,"southpaw"
"118158",32,35,175,170,173,180,148,145,15,11,2,7,11,7,"win_A",-3,5,-7,3,0,1,0,0,0.882352941176471,0.611111111111111,0.647058823529412,0.388888888888889,0,"orthodox"
"118161",25,31,183,170,183,180,146,147,13,10,0,5,12,7,"win_A",-6,13,3,-1,0,0,0,0,1,0.666666666666667,0.923076923076923,0.466666666666667,0,"orthodox"
"118163",21,30,178,170,188,180,149,150,11,9,1,4,7,6,"win_B",-9,8,8,-1,0,0,0,0,0.916666666666667,0.692307692307692,0.583333333333333,0.461538461538462,1,"orthodox"
"118166",28,24,170,178,180,190,147,148,8,8,1,3,5,7,"win_A",4,-8,-10,-1,0,0,0,0,0.888888888888889,0.727272727272727,0.555555555555556,0.636363636363636,0,"orthodox"
"118185",44,34,193,197,203,198,229,250,59,20,6,16,52,11,"win_A",10,-4,5,-21,1,0,0,1,0.907692307692308,0.555555555555556,0.8,0.305555555555556,0,"orthodox"
"119911",21,18,173,170,173,173,137,138,1,2,0,0,0,1,"win_A",3,3,0,-1,0,0,0,0,1,1,0,0.5,0,"orthodox"
"120184",30,27,171,175,175,175,138,140,17,11,0,4,3,4,"win_A",3,-4,0,-2,0,0,0,0,1,0.733333333333333,0.176470588235294,0.266666666666667,0,"orthodox"
"120264",27,30,183,178,186,178,160,160,4,3,3,2,1,1,"win_A",-3,5,8,0,0,0,0,0,0.571428571428571,0.6,0.142857142857143,0.2,0,"orthodox"
"120743",23,29,188,175,188,180,149,151,17,23,1,10,7,15,"win_A",-6,13,8,-2,0,0,0,0,0.944444444444444,0.696969696969697,0.388888888888889,0.454545454545455,0,"orthodox"
"120748",24,28,175,178,180,180,153,157,18,11,3,29,12,5,"win_A",-4,-3,0,-4,0,0,0,0,0.857142857142857,0.275,0.571428571428571,0.125,0,"orthodox"
"120751",37,24,168,175,178,180,147,149,14,15,15,3,12,11,"win_B",13,-7,-2,-2,1,0,0,0,0.482758620689655,0.833333333333333,0.413793103448276,0.611111111111111,1,"orthodox"
"120939",26,33,165,168,165,168,130,131,17,10,0,10,5,2,"win_A",-7,-3,-3,-1,0,0,0,0,1,0.5,0.294117647058824,0.1,0,"orthodox"
"120944",19,28,168,168,173,168,130,130,8,7,0,6,8,1,"win_B",-9,0,5,0,0,0,0,0,1,0.538461538461538,1,0.0769230769230769,1,"orthodox"
"120953",24,26,168,168,183,168,136,136,3,2,1,1,1,0,"win_B",-2,0,15,0,0,0,0,0,0.75,0.666666666666667,0.25,0,1,"orthodox"
"121159",24,27,185,179,193,183,160,160,13,20,2,4,5,9,"win_A",-3,6,10,0,0,0,0,0,0.866666666666667,0.833333333333333,0.333333333333333,0.375,0,"orthodox"
"121479",33,25,165,165,165,163,124,126,2,0,0,3,0,0,"win_A",8,0,2,-2,0,0,0,0,1,0,0,0,0,"orthodox"
"122354",20,25,187,175,188,176,169,170,10,10,0,1,3,3,"win_A",-5,12,12,-1,0,0,0,0,1,0.909090909090909,0.3,0.272727272727273,0,"orthodox"
"122460",31,19,179,180,180,180,159,159,4,0,4,3,4,0,"win_A",12,-1,0,0,0,0,0,0,0.5,0,0.5,0,0,"southpaw"
"122463",22,30,173,179,175,180,160,158,1,2,0,3,1,2,"win_B",-8,-6,-5,2,0,0,0,0,1,0.4,1,0.4,1,"Unknown"
"123023",21,20,171,168,171,168,128,128,1,1,0,0,0,0,"win_A",1,3,3,0,0,0,0,0,1,1,0,0,0,"orthodox"
"123508",21,27,168,168,175,180,129,129,3,2,0,1,2,2,"win_A",-6,0,-5,0,0,0,0,0,1,0.666666666666667,0.666666666666667,0.666666666666667,0,"southpaw"
"123612",22,19,168,171,173,177,118,119,5,0,2,1,3,0,"win_A",3,-3,-4,-1,0,0,0,0,0.714285714285714,0,0.428571428571429,0,0,"orthodox"
"124422",19,19,165,153,168,156,107,108,1,1,0,0,0,0,"win_A",0,12,12,-1,0,0,0,0,1,1,0,0,0,"southpaw"
"124710",20,41,183,173,188,185,149,146,23,44,0,11,12,18,"win_A",-21,10,3,3,0,1,0,0,1,0.8,0.521739130434783,0.327272727272727,0,"orthodox"
"124711",24,40,173,173,178,185,135,135,16,44,1,10,7,18,"win_A",-16,0,-7,0,0,1,0,0,0.941176470588235,0.814814814814815,0.411764705882353,0.333333333333333,0,"orthodox"
"124712",34,40,175,173,174,185,139,140,28,44,4,8,19,18,"win_A",-6,2,-11,-1,0,1,0,0,0.875,0.846153846153846,0.59375,0.346153846153846,0,"orthodox"
"124713",38,24,173,170,185,161,139,140,42,8,6,0,18,5,"win_B",14,3,24,-1,1,0,0,0,0.875,1,0.375,0.625,1,"orthodox"
"124722",30,31,173,165,185,173,134,135,31,20,2,6,15,15,"win_A",-1,8,12,-1,0,0,0,0,0.939393939393939,0.769230769230769,0.454545454545455,0.576923076923077,0,"orthodox"
"124723",29,32,173,170,185,183,135,135,30,31,2,6,15,11,"win_A",-3,3,2,0,0,0,0,0,0.9375,0.837837837837838,0.46875,0.297297297297297,0,"orthodox"
"124729",27,31,173,175,185,178,134,135,25,30,1,2,13,25,"win_A",-4,-2,7,-1,0,0,0,0,0.961538461538462,0.9375,0.5,0.78125,0,"orthodox"
"124737",23,24,173,178,185,180,134,135,18,24,0,1,10,16,"win_A",-1,-5,5,-1,0,0,0,0,1,0.96,0.555555555555556,0.64,0,"orthodox"
"124741",22,23,173,168,185,175,135,135,14,20,0,7,9,17,"win_A",-1,5,10,0,0,0,0,0,1,0.740740740740741,0.642857142857143,0.62962962962963,0,"orthodox"
"125096",26,28,213,183,213,191,281,286,1,3,0,6,1,2,"win_A",-2,30,22,-5,0,0,0,0,1,0.333333333333333,1,0.222222222222222,0,"Unknown"
"125289",29,32,168,170,180,170,125,126,18,47,0,11,13,33,"win_B",-3,-2,10,-1,0,0,0,0,1,0.810344827586207,0.722222222222222,0.568965517241379,1,"southpaw"
"125291",31,26,170,168,170,173,129,133,45,29,11,11,32,14,"win_A",5,2,-3,-4,0,0,0,0,0.803571428571429,0.725,0.571428571428571,0.35,0,"orthodox"
"125297",29,30,170,168,170,170,126,126,39,23,10,4,29,8,"win_A",-1,2,0,0,0,0,0,0,0.795918367346939,0.851851851851852,0.591836734693878,0.296296296296296,0,"orthodox"
"125304",27,27,170,175,170,170,126,132,33,35,9,4,26,22,"win_A",0,-5,0,-6,0,0,0,0,0.785714285714286,0.897435897435897,0.619047619047619,0.564102564102564,0,"orthodox"
"125309",27,26,173,170,175,170,126,125,18,30,1,7,10,24,"win_A",1,3,5,1,0,0,0,0,0.947368421052632,0.810810810810811,0.526315789473684,0.648648648648649,0,"orthodox"
"125313",22,24,164,170,169,170,124,124,23,27,2,6,16,22,"win_A",-2,-6,-1,0,0,0,0,0,0.92,0.818181818181818,0.64,0.666666666666667,0,"orthodox"
"125328",21,27,170,165,170,175,130,130,16,29,2,8,11,17,"win_B",-6,5,-5,0,0,0,0,0,0.888888888888889,0.783783783783784,0.611111111111111,0.459459459459459,1,"orthodox"
"125409",21,21,168,168,168,168,122,122,4,2,6,4,1,0,"win_A",0,0,0,0,0,0,0,0,0.4,0.333333333333333,0.1,0,0,"southpaw"
"125412",22,20,164,168,166,168,115,115,4,0,1,3,1,0,"win_A",2,-4,-2,0,0,0,0,0,0.8,0,0.2,0,0,"orthodox"
"125413",18,20,170,168,175,168,114,114,2,0,0,2,0,0,"win_A",-2,2,7,0,0,0,0,0,1,0,0,0,0,"orthodox"
"125414",21,20,170,168,170,168,115,115,1,0,4,1,0,0,"win_A",1,2,2,0,0,0,0,0,0.2,0,0,0,0,"orthodox"
"125463",20,23,180,169,182,171,134,133,3,1,0,2,0,0,"win_A",-3,11,11,1,0,0,0,0,1,0.333333333333333,0,0,0,"southpaw"
"125559",27,22,175,162,174,163,125,125,24,14,1,6,13,12,"win_A",5,13,11,0,0,0,0,0,0.96,0.7,0.52,0.6,0,"orthodox"
"125567",26,20,170,162,185,163,125,128,20,10,0,2,16,9,"win_A",6,8,22,-3,0,0,0,0,1,0.833333333333333,0.8,0.75,0,"orthodox"
"125754",29,29,171,168,175,180,140,141,12,16,0,12,1,5,"win_A",0,3,-5,-1,0,0,0,0,1,0.571428571428571,0.0833333333333333,0.178571428571429,0,"orthodox"
"125762",30,26,180,168,191,180,142,142,21,15,2,3,13,5,"win_A",4,12,11,0,0,0,0,0,0.91304347826087,0.833333333333333,0.565217391304348,0.277777777777778,0,"Unknown"
"125765",27,25,170,168,175,180,138,137,14,14,2,1,5,5,"win_A",2,2,-5,1,0,0,0,0,0.875,0.933333333333333,0.3125,0.333333333333333,0,"orthodox"
"125769",24,25,168,170,180,178,138,135,11,7,0,1,5,2,"win_A",-1,-2,2,3,0,0,0,0,1,0.875,0.454545454545455,0.25,0,"orthodox"
"126123",25,25,168,168,175,163,127,127,4,3,3,3,1,1,"win_B",0,0,12,0,0,0,0,0,0.571428571428571,0.5,0.142857142857143,0.166666666666667,1,"orthodox"
"126124",23,23,168,165,163,173,125,125,2,3,3,2,1,0,"win_A",0,3,-10,0,0,0,0,0,0.4,0.6,0.2,0,0,"Unknown"
"126538",36,40,185,177,191,188,190,208,13,28,17,12,9,14,"win_A",-4,8,3,-18,1,1,0,1,0.433333333333333,0.7,0.3,0.35,0,"southpaw"
"126541",21,35,189,185,193,191,198,253,15,13,0,14,14,9,"win_A",-14,4,2,-55,0,1,0,1,1,0.481481481481481,0.933333333333333,0.333333333333333,0,"orthodox"
"126543",29,34,188,185,206,191,205,222,11,13,0,12,3,9,"win_A",-5,3,15,-17,0,0,0,1,1,0.52,0.272727272727273,0.36,0,"orthodox"
"126545",34,34,188,185,198,191,206,235,41,13,2,10,33,9,"win_A",0,3,7,-29,0,0,0,1,0.953488372093023,0.565217391304348,0.767441860465116,0.391304347826087,0,"southpaw"
"126546",34,34,185,185,188,191,203,198,27,13,2,9,22,9,"win_A",0,0,-3,5,0,0,0,0,0.931034482758621,0.590909090909091,0.758620689655172,0.409090909090909,0,"southpaw"
"126548",28,33,196,185,193,191,201,236,22,13,2,7,12,9,"win_A",-5,11,2,-35,0,0,0,1,0.916666666666667,0.65,0.5,0.45,0,"orthodox"
"126550",25,32,180,185,193,191,208,234,33,13,2,5,26,9,"win_A",-7,-5,2,-26,0,0,0,1,0.942857142857143,0.722222222222222,0.742857142857143,0.5,0,"orthodox"
"126551",32,30,185,191,191,206,212,218,13,15,4,0,9,11,"win_B",2,-6,-15,-6,0,0,0,0,0.764705882352941,1,0.529411764705882,0.733333333333333,1,"southpaw"
"126555",30,25,185,185,191,198,195,196,10,20,2,0,6,15,"win_B",5,0,-7,-1,0,0,0,0,0.833333333333333,1,0.5,0.75,1,"southpaw"
"126559",26,29,183,185,189,191,221,225,9,7,2,1,2,3,"win_A",-3,-2,-2,-4,0,0,0,0,0.818181818181818,0.875,0.181818181818182,0.375,0,"orthodox"
"126563",22,28,188,185,193,191,213,236,5,4,0,0,3,2,"win_A",-6,3,2,-23,0,0,0,1,1,1,0.6,0.5,0,"orthodox"
"126999",25,32,168,164,177,168,118,118,30,31,1,2,10,18,"win_A",-7,4,9,0,0,0,0,0,0.967741935483871,0.939393939393939,0.32258064516129,0.545454545454545,0,"southpaw"
"127001",31,29,180,164,187,168,121,121,28,29,2,1,19,18,"win_A",2,16,19,0,0,0,0,0,0.933333333333333,0.966666666666667,0.633333333333333,0.6,0,"orthodox"
"127005",27,25,164,163,168,168,112,112,26,24,0,2,17,10,"win_A",2,1,0,0,0,0,0,0,1,0.923076923076923,0.653846153846154,0.384615384615385,0,"orthodox"
"127008",25,24,164,163,168,168,112,112,23,22,0,1,17,9,"win_A",1,1,0,0,0,0,0,0,1,0.956521739130435,0.739130434782609,0.391304347826087,0,"orthodox"
"127146",17,20,173,170,175,170,117,118,1,1,0,2,0,1,"win_A",-3,3,5,-1,0,0,0,0,1,0.333333333333333,0,0.333333333333333,0,"orthodox"
"127147",20,31,170,166,170,168,117,118,1,9,1,5,1,2,"win_B",-11,4,2,-1,0,0,0,0,0.5,0.642857142857143,0.5,0.142857142857143,1,"Unknown"
"127202",24,19,178,188,183,183,170,168,1,0,0,1,1,0,"win_A",5,-10,0,2,0,0,0,0,1,0,1,0,0,"Unknown"
"127250",21,24,180,178,193,188,160,163,2,0,0,1,2,0,"win_A",-3,2,5,-3,0,0,0,0,1,0,1,0,0,"orthodox"
"128165",28,23,167,175,173,175,118,118,2,1,3,0,0,1,"win_B",5,-8,-2,0,0,0,0,0,0.4,1,0,1,1,"orthodox"
"128176",32,26,160,170,165,170,122,122,2,1,3,3,0,1,"win_A",6,-10,-5,0,0,0,0,0,0.4,0.25,0,0.25,0,"orthodox"
"128177",24,32,162,160,165,165,122,122,2,1,4,3,1,0,"win_B",-8,2,0,0,0,0,0,0,0.333333333333333,0.25,0.166666666666667,0,1,"orthodox"
"128178",31,19,160,167,165,167,121,122,0,0,2,2,0,0,"win_A",12,-7,-2,-1,0,0,0,0,0,0,0,0,0,"orthodox"
"128179",20,30,170,160,174,165,118,117,2,0,1,1,0,0,"win_A",-10,10,9,1,0,0,0,0,0.666666666666667,0,0,0,0,"southpaw"
"128242",25,20,181,175,185,170,159,161,3,4,3,0,0,2,"win_A",5,6,15,-2,0,0,0,0,0.5,1,0,0.5,0,"orthodox"
"128245",25,20,181,179,185,179,167,165,1,0,1,1,0,0,"win_A",5,2,6,2,0,0,0,0,0.5,0,0,0,0,"orthodox"
"129073",27,24,170,171,172,173,145,142,4,1,0,1,2,1,"win_A",3,-1,-1,3,0,0,0,0,1,0.5,0.5,0.5,0,"orthodox"
"129263",31,28,196,195,206,200,237,239,20,21,0,11,15,14,"win_A",3,1,6,-2,0,0,0,0,1,0.65625,0.75,0.4375,0,"orthodox"
"129589",32,32,193,180,201,190,205,202,4,15,2,8,3,8,"win_A",0,13,11,3,0,0,0,0,0.666666666666667,0.652173913043478,0.5,0.347826086956522,0,"Unknown"
"129953",25,38,180,175,183,183,155,154,16,24,1,17,6,9,"win_A",-13,5,0,1,0,1,0,0,0.941176470588235,0.585365853658537,0.352941176470588,0.219512195121951,0,"orthodox"
"129961",30,29,188,175,198,183,160,160,33,20,12,7,21,8,"win_A",1,13,15,0,0,0,0,0,0.733333333333333,0.740740740740741,0.466666666666667,0.296296296296296,0,"southpaw"
"129964",31,27,170,175,180,183,156,155,18,19,3,4,9,8,"win_A",4,-5,-3,1,0,0,0,0,0.857142857142857,0.826086956521739,0.428571428571429,0.347826086956522,0,"orthodox"
"129977",24,27,175,175,183,193,156,156,8,3,2,2,4,2,"win_A",-3,0,-10,0,0,0,0,0,0.8,0.6,0.4,0.4,0,"orthodox"
"130184",31,27,163,160,163,165,118,117,28,14,1,12,20,1,"win_A",4,3,-2,1,0,0,0,0,0.96551724137931,0.538461538461538,0.689655172413793,0.0384615384615385,0,"orthodox"
"130365",19,21,170,163,173,173,123,123,2,1,0,0,1,0,"win_B",-2,7,0,0,0,0,0,0,1,1,0.5,0,1,"orthodox"
"130409",21,19,171,174,174,173,140,139,2,3,1,0,0,1,"win_A",2,-3,1,1,0,0,0,0,0.666666666666667,1,0,0.333333333333333,0,"southpaw"
"130411",26,19,170,174,170,173,141,138,1,1,0,0,0,1,"win_B",7,-4,-3,3,0,0,0,0,1,1,0,1,1,"orthodox"
"130596",31,32,179,185,188,201,171,170,23,28,1,5,17,24,"win_A",-1,-6,-13,1,0,0,0,0,0.958333333333333,0.848484848484849,0.708333333333333,0.727272727272727,0,"orthodox"
"130601",28,30,188,185,198,201,160,157,27,24,12,3,17,22,"win_A",-2,3,-3,3,0,0,0,0,0.692307692307692,0.888888888888889,0.435897435897436,0.814814814814815,0,"southpaw"
"130609",28,29,185,191,201,201,160,160,17,31,2,6,17,28,"win_A",-1,-6,0,0,0,0,0,0,0.894736842105263,0.837837837837838,0.894736842105263,0.756756756756757,0,"orthodox"
"131407",27,29,163,170,163,165,113,112,13,14,1,5,11,12,"win_A",-2,-7,-2,1,0,0,0,0,0.928571428571429,0.736842105263158,0.785714285714286,0.631578947368421,0,"orthodox"
"131525",18,23,165,162,170,167,119,118,2,2,0,6,2,2,"win_A",-5,3,3,1,0,0,0,0,1,0.25,1,0.25,0,"southpaw"
"131672",20,25,178,170,185,178,136,131,2,8,0,16,1,6,"win_A",-5,8,7,5,0,0,0,0,1,0.333333333333333,0.5,0.25,0,"orthodox"
"131674",20,24,173,170,183,178,139,144,5,8,1,12,3,6,"win_A",-4,3,5,-5,0,0,0,0,0.833333333333333,0.4,0.5,0.3,0,"orthodox"
"131677",25,23,173,170,188,178,133,134,10,7,1,9,9,5,"win_A",2,3,10,-1,0,0,0,0,0.909090909090909,0.4375,0.818181818181818,0.3125,0,"orthodox"
"131678",22,23,168,170,173,178,135,139,6,7,1,8,3,5,"win_A",-1,-2,-5,-4,0,0,0,0,0.857142857142857,0.466666666666667,0.428571428571429,0.333333333333333,0,"orthodox"
"131680",22,22,178,170,185,178,134,132,2,6,0,7,2,5,"win_A",0,8,7,2,0,0,0,0,1,0.461538461538462,1,0.384615384615385,0,"orthodox"
"132553",19,18,179,175,179,179,141,146,2,0,3,1,0,0,"win_B",1,4,0,-5,0,0,0,0,0.4,0,0,0,1,"southpaw"
"132708",36,41,201,196,210,211,240,238,11,14,0,7,6,13,"win_A",-5,5,-1,2,1,1,0,0,1,0.666666666666667,0.545454545454545,0.619047619047619,0,"orthodox"
"132712",32,35,188,196,203,211,263,221,22,14,0,3,21,13,"win_A",-3,-8,-8,42,0,1,1,0,1,0.823529411764706,0.954545454545455,0.764705882352941,0,"orthodox"
"132713",34,37,196,184,211,188,278,252,13,21,3,8,12,11,"win_A",-3,12,23,26,0,1,1,0,0.8125,0.724137931034483,0.75,0.379310344827586,0,"orthodox"
"132714",30,34,193,196,204,211,261,237,22,12,2,3,19,11,"win_B",-4,-3,-7,24,0,0,1,0,0.916666666666667,0.8,0.791666666666667,0.733333333333333,1,"orthodox"
"132719",28,30,193,196,208,211,269,240,7,9,0,1,3,9,"win_A",-2,-3,-3,29,0,0,1,0,1,0.9,0.428571428571429,0.9,0,"orthodox"
"132727",24,24,196,185,211,188,265,225,2,14,0,3,2,13,"win_A",0,11,23,40,0,0,1,0,1,0.823529411764706,1,0.764705882352941,0,"orthodox"
"132817",17,18,178,170,178,173,139,139,1,1,0,0,0,0,"win_B",-1,8,5,0,0,0,0,0,1,1,0,0,1,"orthodox"
"132823",33,34,185,183,191,188,220,230,41,43,4,31,22,25,"win_A",-1,2,3,-10,0,0,0,0,0.911111111111111,0.581081081081081,0.488888888888889,0.337837837837838,0,"orthodox"
"132829",41,32,188,183,203,188,204,225,36,41,7,26,23,24,"win_A",9,5,15,-21,1,0,0,1,0.837209302325581,0.611940298507463,0.534883720930233,0.358208955223881,0,"orthodox"
"132834",31,40,183,188,188,198,201,264,39,35,22,46,23,29,"win_A",-9,-5,-10,-63,0,1,0,1,0.639344262295082,0.432098765432099,0.377049180327869,0.358024691358025,0,"Unknown"
"132835",31,42,183,183,188,185,208,205,38,17,22,12,23,10,"win_A",-11,0,3,3,0,1,0,0,0.633333333333333,0.586206896551724,0.383333333333333,0.344827586206897,0,"Unknown"
"132840",30,39,183,191,188,191,235,238,36,46,19,22,23,33,"win_A",-9,-8,-3,-3,0,1,0,0,0.654545454545455,0.676470588235294,0.418181818181818,0.485294117647059,0,"Unknown"
"132844",38,29,189,183,208,188,253,284,49,35,7,16,40,22,"win_A",9,6,20,-31,1,0,0,1,0.875,0.686274509803922,0.714285714285714,0.431372549019608,0,"orthodox"
"132850",26,28,193,183,188,188,249,224,18,32,7,12,9,19,"win_A",-2,10,0,25,0,0,1,0,0.72,0.727272727272727,0.36,0.431818181818182,0,"orthodox"
"132853",33,27,180,183,183,188,235,213,31,31,2,9,20,19,"win_A",6,-3,-5,22,0,0,1,0,0.939393939393939,0.775,0.606060606060606,0.475,0,"orthodox"
"132860",38,26,188,183,198,188,214,197,65,29,8,4,52,19,"win_A",12,5,10,17,1,0,1,0,0.89041095890411,0.878787878787879,0.712328767123288,0.575757575757576,0,"orthodox"
"132868",24,22,183,193,188,188,195,193,21,13,3,2,15,7,"win_A",2,-10,0,2,0,0,0,0,0.875,0.866666666666667,0.625,0.466666666666667,0,"Unknown"
"132870",23,30,183,185,188,190,177,174,19,20,2,4,14,10,"win_B",-7,-2,-2,3,0,0,0,0,0.904761904761905,0.833333333333333,0.666666666666667,0.416666666666667,1,"Unknown"
"132883",21,34,183,170,188,178,167,155,6,23,1,5,3,8,"win_A",-13,13,10,12,0,0,0,0,0.857142857142857,0.821428571428571,0.428571428571429,0.285714285714286,0,"Unknown"
"134013",21,28,183,180,183,180,148,148,3,0,1,1,1,0,"win_B",-7,3,3,0,0,0,0,0,0.75,0,0.25,0,1,"orthodox"
"134083",38,37,196,193,203,199,264,251,23,0,13,1,15,0,"win_A",1,3,4,13,1,1,0,0,0.638888888888889,0,0.416666666666667,0,0,"orthodox"
"134291",25,30,188,169,188,175,154,154,21,25,2,24,9,15,"win_A",-5,19,13,0,0,0,0,0,0.91304347826087,0.510204081632653,0.391304347826087,0.306122448979592,0,"orthodox"
"134296",23,29,175,169,189,175,154,154,11,23,0,19,9,15,"win_A",-6,6,14,0,0,0,0,0,1,0.547619047619048,0.818181818181818,0.357142857142857,0,"orthodox"
"134304",23,27,177,169,175,175,146,147,4,17,0,12,3,12,"win_A",-4,8,0,-1,0,0,0,0,1,0.586206896551724,0.75,0.413793103448276,0,"orthodox"
"134455",18,27,179,175,179,175,139,139,2,6,2,0,0,2,"win_B",-9,4,4,0,0,0,0,0,0.5,1,0,0.333333333333333,1,"southpaw"
"134456",18,21,179,171,179,174,140,140,2,1,1,1,0,0,"win_B",-3,8,5,0,0,0,0,0,0.666666666666667,0.5,0,0,1,"southpaw"
"134457",25,18,172,179,180,179,138,140,1,2,1,0,1,0,"win_A",7,-7,1,-2,0,0,0,0,0.5,1,0.5,0,0,"Unknown"
"134507",27,32,174,168,169,170,130,131,3,5,0,10,3,5,"win_A",-5,6,-1,-1,0,0,0,0,1,0.333333333333333,1,0.333333333333333,0,"orthodox"
"135158",19,16,174,175,177,175,134,135,1,1,1,0,1,0,"win_A",3,-1,2,-1,0,0,0,0,0.5,1,0.5,0,0,"orthodox"
"135740",29,27,178,183,180,189,167,173,4,2,7,5,3,2,"win_A",2,-5,-9,-6,0,0,0,0,0.363636363636364,0.285714285714286,0.272727272727273,0.285714285714286,0,"Unknown"
"135744",22,25,183,178,193,180,173,175,6,3,0,2,3,2,"win_A",-3,5,13,-2,0,0,0,0,1,0.6,0.5,0.4,0,"southpaw"
"135910",17,24,169,165,170,163,127,127,0,0,3,1,0,0,"win_A",-7,4,7,0,0,0,0,0,0,0,0,0,0,"southpaw"
"135911",28,16,167,169,178,170,120,120,3,0,0,1,1,0,"win_A",12,-2,8,0,0,0,0,0,1,0,0.333333333333333,0,0,"orthodox"
"136284",17,24,167,163,168,163,105,108,2,1,0,1,0,0,"win_A",-7,4,5,-3,0,0,0,0,1,0.5,0,0,0,"orthodox"
"136285",21,17,173,167,173,168,106,108,0,1,1,0,0,0,"win_B",4,6,5,-2,0,0,0,0,0,1,0,0,1,"Unknown"
"136296",22,33,188,191,188,203,293,253,11,6,0,3,7,2,"win_A",-11,-3,-15,40,0,0,1,0,1,0.666666666666667,0.636363636363636,0.222222222222222,0,"orthodox"
"136752",33,36,183,173,198,183,189,180,6,12,2,37,5,4,"win_A",-3,10,15,9,0,1,0,0,0.75,0.244897959183673,0.625,0.0816326530612245,0,"orthodox"
"136758",28,21,183,175,198,175,175,176,2,0,0,9,2,0,"win_A",7,8,23,-1,0,0,0,0,1,0,1,0,0,"orthodox"
"136808",22,22,170,165,174,172,122,122,0,3,2,1,0,0,"win_A",0,5,2,0,0,0,0,0,0,0.75,0,0,0,"orthodox"
"136809",27,21,165,170,165,174,117,115,2,0,4,1,0,0,"win_A",6,-5,-9,2,0,0,0,0,0.333333333333333,0,0,0,0,"southpaw"
"137304",24,34,164,160,165,170,124,122,15,4,2,9,10,1,"win_A",-10,4,-5,2,0,0,0,0,0.882352941176471,0.307692307692308,0.588235294117647,0.0769230769230769,0,"orthodox"
"137305",21,33,165,160,165,170,123,124,12,4,0,6,6,1,"win_A",-12,5,-5,-1,0,0,0,0,1,0.4,0.5,0.1,0,"orthodox"
"137309",22,22,165,160,173,170,124,122,2,2,0,3,0,1,"win_A",0,5,3,2,0,0,0,0,1,0.4,0,0.2,0,"southpaw"
"137310",23,22,157,160,175,170,122,118,4,2,0,2,2,1,"win_A",1,-3,5,4,0,0,0,0,1,0.5,0.5,0.25,0,"orthodox"
"137447",36,37,175,164,178,169,154,150,5,1,4,5,3,0,"win_A",-1,11,9,4,1,1,0,0,0.555555555555556,0.166666666666667,0.333333333333333,0,0,"southpaw"
"137848",21,29,175,168,175,164,121,122,1,1,2,7,0,0,"win_A",-8,7,11,-1,0,0,0,0,0.333333333333333,0.125,0,0,0,"southpaw"
"137849",21,27,175,167,175,173,121,119,0,1,2,1,0,0,"win_A",-6,8,2,2,0,0,0,0,0,0.5,0,0,0,"southpaw"
"138456",42,37,193,188,203,188,240,248,53,16,6,12,47,13,"win_A",5,5,15,-8,1,1,0,0,0.898305084745763,0.571428571428571,0.796610169491525,0.464285714285714,0,"orthodox"
"138459",23,35,188,188,188,188,240,246,17,15,0,9,11,13,"win_A",-12,0,0,-6,0,1,0,0,1,0.625,0.647058823529412,0.541666666666667,0,"orthodox"
"138463",34,38,188,188,188,198,249,265,13,34,6,41,12,29,"win_A",-4,0,-10,-16,0,1,0,1,0.684210526315789,0.453333333333333,0.631578947368421,0.386666666666667,0,"orthodox"
"138465",34,32,180,188,183,188,240,213,32,12,2,4,21,11,"win_A",2,-8,-5,27,0,0,1,0,0.941176470588235,0.75,0.617647058823529,0.6875,0,"orthodox"
"138470",22,29,185,188,188,188,234,213,9,7,0,2,6,6,"win_A",-7,-3,0,21,0,0,1,0,1,0.777777777777778,0.666666666666667,0.666666666666667,0,"orthodox"
"138472",31,28,198,188,213,188,241,233,10,6,1,1,8,6,"win_A",3,10,25,8,0,0,0,0,0.909090909090909,0.857142857142857,0.727272727272727,0.857142857142857,0,"orthodox"
"138474",32,28,188,188,196,188,251,289,8,4,4,1,6,4,"win_B",4,0,8,-38,0,0,0,1,0.666666666666667,0.8,0.5,0.8,1,"southpaw"
"139042",22,32,178,183,180,188,160,160,20,20,1,16,11,13,"win_A",-10,-5,-8,0,0,0,0,0,0.952380952380952,0.555555555555556,0.523809523809524,0.361111111111111,0,"southpaw"
"139044",29,31,178,183,183,188,153,153,21,19,5,13,10,12,"win_A",-2,-5,-5,0,0,0,0,0,0.807692307692308,0.59375,0.384615384615385,0.375,0,"orthodox"
"139045",32,31,173,183,178,188,160,159,17,19,2,12,13,12,"win_A",1,-10,-10,1,0,0,0,0,0.894736842105263,0.612903225806452,0.684210526315789,0.387096774193548,0,"orthodox"
"139046",28,30,173,183,178,188,154,154,28,19,1,11,20,12,"win_A",-2,-10,-10,0,0,0,0,0,0.96551724137931,0.633333333333333,0.689655172413793,0.4,0,"orthodox"
"139054",23,29,178,183,185,188,155,155,14,16,1,5,10,10,"win_A",-6,-5,-3,0,0,0,0,0,0.933333333333333,0.761904761904762,0.666666666666667,0.476190476190476,0,"orthodox"
"139062",27,36,183,175,188,183,163,160,11,26,2,86,7,18,"win_A",-9,8,5,3,0,1,0,0,0.846153846153846,0.232142857142857,0.538461538461538,0.160714285714286,0,"orthodox"
"139065",33,26,178,183,191,188,156,157,9,9,11,1,1,7,"win_B",7,-5,3,-1,0,0,0,0,0.45,0.9,0.05,0.7,1,"orthodox"
"139066",26,34,183,175,188,183,157,157,8,23,1,76,7,16,"win_A",-8,8,5,0,0,0,0,0,0.888888888888889,0.232323232323232,0.777777777777778,0.161616161616162,0,"orthodox"
"139068",29,24,173,183,188,188,146,145,8,7,0,0,7,6,"win_A",5,-10,0,1,0,0,0,0,1,1,0.875,0.857142857142857,0,"orthodox"
"139520",20,25,167,171,172,176,129,131,1,0,0,1,1,0,"win_A",-5,-4,-4,-2,0,0,0,0,1,0,1,0,0,"orthodox"
"140017",21,28,168,167,168,173,120,122,3,1,5,2,1,0,"win_A",-7,1,-5,-2,0,0,0,0,0.375,0.333333333333333,0.125,0,0,"southpaw"
"140284",21,20,175,173,172,166,145,143,2,1,1,1,2,0,"win_A",1,2,6,2,0,0,0,0,0.666666666666667,0.5,0.666666666666667,0,0,"orthodox"
"140622",17,24,175,170,175,170,125,126,1,0,1,3,0,0,"win_B",-7,5,5,-1,0,0,0,0,0.5,0,0,0,1,"orthodox"
"140674",27,27,170,163,180,173,124,125,5,5,2,8,1,0,"win_A",0,7,7,-1,0,0,0,0,0.714285714285714,0.384615384615385,0.142857142857143,0,0,"southpaw"
"140675",26,26,163,163,157,173,118,118,10,4,4,6,5,0,"win_B",0,0,-16,0,0,0,0,0,0.714285714285714,0.4,0.357142857142857,0,1,"orthodox"
"140727",18,22,170,161,170,163,107,107,2,0,2,3,0,0,"win_A",-4,9,7,0,0,0,0,0,0.5,0,0,0,0,"orthodox"
"140728",17,18,167,170,170,170,108,112,0,1,1,1,0,0,"win_B",-1,-3,0,-4,0,0,0,0,0,0.5,0,0,1,"orthodox"
"140729",18,19,170,167,170,167,109,111,0,0,1,1,0,0,"win_A",-1,3,3,-2,0,0,0,0,0,0,0,0,0,"orthodox"
"140800",20,19,165,164,162,163,129,129,2,1,0,3,2,0,"win_A",1,1,-1,0,0,0,0,0,1,0.25,1,0,0,"southpaw"
"141321",25,24,178,178,182,182,140,140,8,5,0,10,3,2,"win_A",1,0,0,0,0,0,0,0,1,0.333333333333333,0.375,0.133333333333333,0,"orthodox"
"141322",21,23,180,178,206,182,140,138,7,4,0,4,4,2,"win_A",-2,2,24,2,0,0,0,0,1,0.5,0.571428571428571,0.25,0,"orthodox"
"144886",29,21,189,192,190,190,175,174,3,4,0,0,3,1,"win_A",8,-3,0,1,0,0,0,0,1,1,1,0.25,0,"orthodox"
"145019",20,34,170,168,166,180,118,118,18,24,0,29,15,11,"win_A",-14,2,-14,0,0,0,0,0,1,0.452830188679245,0.833333333333333,0.207547169811321,0,"orthodox"
"145022",25,31,169,168,174,180,115,115,11,21,1,26,6,10,"win_A",-6,1,-6,0,0,0,0,0,0.916666666666667,0.446808510638298,0.5,0.212765957446809,0,"orthodox"
"145026",25,29,163,168,173,180,112,114,18,21,0,21,12,10,"win_A",-4,-5,-7,-2,0,0,0,0,1,0.5,0.666666666666667,0.238095238095238,0,"orthodox"
"145028",24,28,168,168,170,180,116,118,22,21,3,18,13,10,"win_A",-4,0,-10,-2,0,0,0,0,0.88,0.538461538461538,0.52,0.256410256410256,0,"orthodox"
"145036",25,25,163,168,165,180,108,108,17,20,4,11,14,10,"win_A",0,-5,-15,0,0,0,0,0,0.80952380952381,0.645161290322581,0.666666666666667,0.32258064516129,0,"southpaw"
"145038",27,24,152,168,160,180,108,107,10,19,0,9,3,10,"win_A",3,-16,-20,1,0,0,0,0,1,0.678571428571429,0.3,0.357142857142857,0,"southpaw"
"145039",30,24,165,168,157,180,113,113,24,19,7,8,23,10,"win_A",6,-3,-23,0,0,0,0,0,0.774193548387097,0.703703703703704,0.741935483870968,0.37037037037037,0,"orthodox"
"145047",21,22,170,168,175,180,111,110,4,13,0,6,3,8,"win_A",-1,2,-5,1,0,0,0,0,1,0.684210526315789,0.75,0.421052631578947,0,"orthodox"
"145051",22,23,168,163,180,165,106,107,9,10,6,4,6,8,"win_A",-1,5,15,-1,0,0,0,0,0.6,0.714285714285714,0.4,0.571428571428571,0,"orthodox"
"145060",20,21,168,163,180,165,111,110,6,6,0,0,6,6,"win_B",-1,5,15,1,0,0,0,0,1,1,1,1,1,"orthodox"
"145352",19,23,181,186,183,186,175,175,0,2,1,2,0,0,"win_B",-4,-5,-3,0,0,0,0,0,0,0.5,0,0,1,"orthodox"
"145353",22,23,186,180,186,175,173,175,1,9,1,1,0,7,"win_B",-1,6,11,-2,0,0,0,0,0.5,0.9,0,0.7,1,"orthodox"
"145417",20,17,166,168,166,168,116,118,1,3,0,0,0,0,"win_A",3,-2,-2,-2,0,0,0,0,1,1,0,0,0,"orthodox"
"145924",26,28,185,178,188,188,164,164,3,2,0,1,2,1,"win_A",-2,7,0,0,0,0,0,0,1,0.666666666666667,0.666666666666667,0.333333333333333,0,"southpaw"
"146075",20,30,183,170,183,170,159,160,2,0,0,4,0,0,"win_A",-10,13,13,-1,0,0,0,0,1,0,0,0,0,"orthodox"
"146106",21,29,168,168,168,164,121,122,2,1,4,6,1,0,"win_A",-8,0,4,-1,0,0,0,0,0.333333333333333,0.142857142857143,0.166666666666667,0,0,"southpaw"
"146151",23,35,180,178,180,178,148,152,3,6,0,12,2,4,"win_A",-12,2,2,-4,0,1,0,0,1,0.333333333333333,0.666666666666667,0.222222222222222,0,"orthodox"
"146517",24,26,180,178,185,178,166,167,1,1,0,0,1,0,"win_A",-2,2,7,-1,0,0,0,0,1,1,1,0,0,"orthodox"
"146797",21,21,170,178,170,178,115,112,1,1,0,0,0,1,"win_A",0,-8,-8,3,0,0,0,0,1,1,0,1,0,"orthodox"
"147002",29,29,180,188,188,201,219,258,1,0,0,3,0,0,"win_A",0,-8,-13,-39,0,0,0,1,1,0,0,0,0,"orthodox"
"147464",37,39,178,180,175,183,135,135,1,1,5,3,1,0,"win_B",-2,-2,-8,0,1,1,0,0,0.166666666666667,0.25,0.166666666666667,0,1,"orthodox"
"148299",18,25,172,180,163,185,128,129,0,1,1,0,0,0,"win_A",-7,-8,-22,-1,0,0,0,0,0,1,0,0,0,"orthodox"
"148542",18,16,179,179,177,178,139,140,1,0,1,1,1,0,"win_A",2,0,-1,-1,0,0,0,0,0.5,0,0.5,0,0,"southpaw"
"148705",20,21,192,180,190,183,174,174,1,0,0,1,0,0,"win_A",-1,12,7,0,0,0,0,0,1,0,0,0,0,"southpaw"
"148992",20,17,170,178,170,178,130,134,3,0,1,1,2,0,"win_A",3,-8,-8,-4,0,0,0,0,0.75,0,0.5,0,0,"southpaw"
"149549",37,39,178,168,185,178,159,159,17,16,9,23,4,14,"win_B",-2,10,7,0,1,1,0,0,0.653846153846154,0.41025641025641,0.153846153846154,0.358974358974359,1,"orthodox"
"149550",37,32,178,178,185,193,160,160,17,3,8,23,4,3,"win_B",5,0,-8,0,1,0,0,0,0.68,0.115384615384615,0.16,0.115384615384615,1,"orthodox"
"149551",27,36,175,178,178,185,157,160,27,17,1,7,24,4,"win_A",-9,-3,-7,-3,0,1,0,0,0.964285714285714,0.708333333333333,0.857142857142857,0.166666666666667,0,"southpaw"
"149836",19,19,183,168,176,176,113,113,2,1,1,1,1,1,"win_A",0,15,0,0,0,0,0,0,0.666666666666667,0.5,0.333333333333333,0.5,0,"orthodox"
"150665",26,36,169,167,173,169,137,135,1,0,0,2,0,0,"win_A",-10,2,4,2,0,1,0,0,1,0,0,0,0,"orthodox"
"150801",18,17,170,168,167,168,116,117,1,3,2,1,0,0,"win_A",1,2,-1,-1,0,0,0,0,0.333333333333333,0.75,0,0,0,"orthodox"
"151095",31,32,196,180,216,188,208,258,10,3,0,14,6,2,"win_A",-1,16,28,-50,0,0,0,1,1,0.176470588235294,0.6,0.117647058823529,0,"orthodox"
"151102",21,27,183,180,193,188,171,174,3,2,0,2,3,2,"win_A",-6,3,5,-3,0,0,0,0,1,0.5,1,0.5,0,"southpaw"
"151893",18,19,178,170,179,172,154,154,1,0,4,1,0,0,"win_B",-1,8,7,0,0,0,0,0,0.2,0,0,0,1,"orthodox"
"151894",26,28,170,165,170,165,125,125,0,0,2,2,0,0,"win_A",-2,5,5,0,0,0,0,0,0,0,0,0,0,"orthodox"
"152034",18,19,178,170,179,172,154,154,1,0,4,1,0,0,"win_B",-1,8,7,0,0,0,0,0,0.2,0,0,0,1,"orthodox"
"152035",26,28,170,165,170,165,125,125,0,0,2,2,0,0,"win_A",-2,5,5,0,0,0,0,0,0,0,0,0,0,"orthodox"
"152220",29,19,172,170,173,173,136,137,7,0,17,3,6,0,"win_A",10,2,0,-1,0,0,0,0,0.291666666666667,0,0.25,0,0,"orthodox"
"152777",21,19,174,183,175,186,154,154,0,0,1,1,0,0,"win_B",2,-9,-11,0,0,0,0,0,0,0,0,0,1,"orthodox"
"154553",29,21,168,158,160,153,113,112,29,6,7,17,14,3,"win_A",8,10,7,1,0,0,0,0,0.805555555555556,0.260869565217391,0.388888888888889,0.130434782608696,0,"orthodox"
"154558",18,21,170,158,166,153,116,115,5,4,0,11,4,1,"win_A",-3,12,13,1,0,0,0,0,1,0.266666666666667,0.8,0.0666666666666667,0,"orthodox"
"155840",27,25,188,168,193,175,170,170,9,8,0,22,8,3,"win_A",2,20,18,0,0,0,0,0,1,0.266666666666667,0.888888888888889,0.1,0,"orthodox"
"155843",21,23,175,168,175,175,158,150,15,8,1,18,13,3,"win_A",-2,7,0,8,0,0,0,0,0.9375,0.307692307692308,0.8125,0.115384615384615,0,"southpaw"
"155860",32,21,175,168,193,175,148,148,7,2,1,4,3,1,"win_A",11,7,18,0,0,0,0,0,0.875,0.333333333333333,0.375,0.166666666666667,0,"orthodox"
"155865",19,19,168,173,175,178,140,140,0,6,1,1,0,1,"win_A",0,-5,-3,0,0,0,0,0,0,0.857142857142857,0,0.142857142857143,0,"orthodox"
"155952",23,42,175,180,189,183,154,154,10,69,0,70,8,56,"win_A",-19,-5,6,0,0,1,0,0,1,0.496402877697842,0.8,0.402877697841727,0,"orthodox"
"155954",19,40,183,180,188,183,153,150,21,69,0,66,11,56,"win_A",-21,3,5,3,0,1,0,0,1,0.511111111111111,0.523809523809524,0.414814814814815,0,"orthodox"
"155974",33,37,171,180,173,183,147,145,34,56,8,55,10,45,"win_A",-4,-9,-10,2,0,1,0,0,0.80952380952381,0.504504504504504,0.238095238095238,0.405405405405405,0,"orthodox"
"155976",33,37,168,180,178,183,144,142,30,55,3,53,17,44,"win_A",-4,-12,-5,2,0,1,0,0,0.909090909090909,0.509259259259259,0.515151515151515,0.407407407407407,0,"orthodox"
"155981",33,36,168,180,178,183,143,144,29,52,3,51,17,42,"win_A",-3,-12,-5,-1,0,1,0,0,0.90625,0.504854368932039,0.53125,0.407766990291262,0,"orthodox"
"155983",23,36,183,180,183,183,154,154,22,52,1,49,17,42,"win_A",-13,3,0,0,0,1,0,0,0.956521739130435,0.514851485148515,0.739130434782609,0.415841584158416,0,"orthodox"
"155992",24,35,178,180,183,183,148,147,23,47,0,42,20,38,"win_A",-11,-2,0,1,0,1,0,0,1,0.528089887640449,0.869565217391304,0.426966292134831,0,"orthodox"
"155997",25,34,178,180,183,183,151,149,25,45,2,39,12,37,"win_A",-9,-2,0,2,0,0,0,0,0.925925925925926,0.535714285714286,0.444444444444444,0.44047619047619,0,"orthodox"
"155999",34,37,180,168,183,170,140,137,43,31,39,41,36,19,"win_A",-3,12,13,3,0,1,0,0,0.524390243902439,0.430555555555556,0.439024390243902,0.263888888888889,0,"orthodox"
"156005",32,34,180,180,191,183,139,144,46,39,8,33,30,34,"win_A",-2,0,8,-5,0,0,0,0,0.851851851851852,0.541666666666667,0.555555555555556,0.472222222222222,0,"orthodox"
"156006",26,34,170,180,178,183,142,139,9,39,4,32,3,34,"win_A",-8,-10,-5,3,0,0,0,0,0.692307692307692,0.549295774647887,0.230769230769231,0.47887323943662,0,"southpaw"
"156008",29,33,180,180,191,183,142,143,19,38,2,30,13,34,"win_A",-4,0,8,-1,0,0,0,0,0.904761904761905,0.558823529411765,0.619047619047619,0.5,0,"Unknown"
"156013",20,33,178,180,178,183,148,148,12,36,4,24,8,32,"win_B",-13,-2,-5,0,0,0,0,0,0.75,0.6,0.5,0.533333333333333,1,"orthodox"
"156015",33,32,175,180,173,183,139,139,52,36,20,22,36,32,"win_A",1,-5,-10,0,0,0,0,0,0.722222222222222,0.620689655172414,0.5,0.551724137931034,0,"orthodox"
"156028",27,31,182,180,185,183,150,158,16,32,1,13,12,29,"win_A",-4,2,2,-8,0,0,0,0,0.941176470588235,0.711111111111111,0.705882352941177,0.644444444444444,0,"orthodox"
"156032",29,31,175,180,183,183,130,130,20,29,5,11,11,26,"win_A",-2,-5,0,0,0,0,0,0,0.8,0.725,0.44,0.65,0,"orthodox"
"156035",33,30,170,180,178,183,140,140,36,27,3,10,30,24,"win_A",3,-10,-5,0,0,0,0,0,0.923076923076923,0.72972972972973,0.769230769230769,0.648648648648649,0,"orthodox"
"156037",30,28,180,173,183,180,130,130,25,8,10,1,22,8,"win_A",2,7,3,0,0,0,0,0,0.714285714285714,0.888888888888889,0.628571428571429,0.888888888888889,0,"orthodox"
"156050",22,23,171,180,175,183,130,130,26,13,3,7,25,12,"win_A",-1,-9,-8,0,0,0,0,0,0.896551724137931,0.65,0.862068965517241,0.6,0,"orthodox"
"156057",23,21,174,180,188,183,131,130,7,12,0,1,4,11,"win_A",2,-6,5,1,0,0,0,0,1,0.923076923076923,0.571428571428571,0.846153846153846,0,"orthodox"
"156059",20,21,175,180,178,183,135,135,6,11,0,0,4,10,"win_A",-1,-5,-5,0,0,0,0,0,1,1,0.666666666666667,0.909090909090909,0,"Unknown"
"156725",36,30,173,175,183,180,146,147,43,31,0,1,26,18,"win_A",6,-2,3,-1,1,0,0,0,1,0.96875,0.604651162790698,0.5625,0,"orthodox"
"156726",35,31,173,170,183,170,151,154,42,37,0,2,26,30,"win_A",4,3,13,-3,1,0,0,0,1,0.948717948717949,0.619047619047619,0.769230769230769,0,"orthodox"
"156727",33,38,173,174,183,180,146,147,40,46,0,5,25,39,"win_A",-5,-1,3,-1,0,1,0,0,1,0.901960784313726,0.625,0.764705882352941,0,"orthodox"
"156728",32,36,173,170,183,170,146,142,39,50,0,4,25,37,"win_A",-4,3,13,4,0,1,0,0,1,0.925925925925926,0.641025641025641,0.685185185185185,0,"orthodox"
"156729",30,29,173,171,183,165,147,145,38,43,0,0,24,31,"win_A",1,2,18,2,0,0,0,0,1,1,0.631578947368421,0.720930232558139,0,"orthodox"
"156730",30,34,173,179,183,185,150,154,37,38,0,4,24,30,"win_A",-4,-6,-2,-4,0,0,0,0,1,0.904761904761905,0.648648648648649,0.714285714285714,0,"orthodox"
"156731",35,29,170,173,173,183,146,147,43,36,9,0,13,24,"win_B",6,-3,-10,-1,1,0,0,0,0.826923076923077,1,0.25,0.666666666666667,1,"orthodox"
"156733",33,28,171,173,178,183,139,140,39,33,6,0,30,22,"win_B",5,-2,-5,-1,0,0,0,0,0.866666666666667,1,0.666666666666667,0.666666666666667,1,"orthodox"
"156737",25,28,173,171,183,175,134,135,28,46,0,5,20,42,"win_A",-3,2,8,-1,0,0,0,0,1,0.901960784313726,0.714285714285714,0.823529411764706,0,"orthodox"
"156741",23,23,173,179,183,178,130,130,24,33,0,0,18,27,"win_A",0,-6,5,0,0,0,0,0,1,1,0.75,0.818181818181818,0,"orthodox"
"156742",23,25,173,170,183,173,134,134,23,22,0,16,17,10,"win_A",-2,3,10,0,0,0,0,0,1,0.578947368421053,0.739130434782609,0.263157894736842,0,"orthodox"
"156743",23,29,173,167,183,171,130,130,22,40,0,6,17,28,"win_A",-6,6,12,0,0,0,0,0,1,0.869565217391304,0.772727272727273,0.608695652173913,0,"orthodox"
"156744",22,28,173,175,183,178,130,130,21,34,0,2,16,28,"win_A",-6,-2,5,0,0,0,0,0,1,0.944444444444444,0.761904761904762,0.777777777777778,0,"orthodox"
"156745",26,22,171,173,183,183,130,130,33,20,2,0,25,15,"win_B",4,-2,0,0,0,0,0,0,0.942857142857143,1,0.714285714285714,0.75,1,"orthodox"
"156746",21,27,173,163,183,165,130,129,19,44,0,2,15,30,"win_A",-6,10,18,1,0,0,0,0,1,0.956521739130435,0.789473684210526,0.652173913043478,0,"orthodox"
"156747",21,24,173,168,183,180,130,130,18,25,0,2,14,20,"win_A",-3,5,3,0,0,0,0,0,1,0.925925925925926,0.777777777777778,0.740740740740741,0,"orthodox"
"156748",21,32,173,180,183,183,130,130,17,38,0,1,13,17,"win_A",-11,-7,0,0,0,0,0,0,1,0.974358974358974,0.764705882352941,0.435897435897436,0,"orthodox"
"156752",21,25,173,170,183,173,130,132,13,17,0,4,11,9,"win_A",-4,3,10,-2,0,0,0,0,1,0.80952380952381,0.846153846153846,0.428571428571429,0,"orthodox"
"156756",20,24,173,174,183,175,131,132,9,18,0,3,7,14,"win_A",-4,-1,8,-1,0,0,0,0,1,0.857142857142857,0.777777777777778,0.666666666666667,0,"orthodox"
"156760",20,28,173,173,183,173,132,133,5,19,0,8,4,5,"win_A",-8,0,10,-1,0,0,0,0,1,0.703703703703704,0.8,0.185185185185185,0,"orthodox"
"156761",20,33,173,166,183,173,132,130,4,9,0,9,3,2,"win_A",-13,7,10,2,0,0,0,0,1,0.5,0.75,0.111111111111111,0,"orthodox"
"156766",44,27,180,178,184,185,160,159,174,44,18,1,109,8,"win_B",17,2,-1,1,1,0,0,0,0.90625,0.977777777777778,0.567708333333333,0.177777777777778,1,"orthodox"
"156798",41,26,180,175,184,175,159,161,149,29,11,8,97,24,"win_B",15,5,9,-2,1,0,0,0,0.93125,0.783783783783784,0.60625,0.648648648648649,1,"orthodox"
"156843",29,22,180,179,184,178,158,159,114,41,1,3,74,23,"win_A",7,1,6,-1,0,0,0,0,0.991304347826087,0.931818181818182,0.643478260869565,0.522727272727273,0,"orthodox"
"156878",26,27,180,180,184,178,152,148,79,30,1,20,53,4,"win_A",-1,0,6,4,0,0,0,0,0.9875,0.6,0.6625,0.08,0,"orthodox"
"156895",24,31,180,171,184,178,147,143,62,78,1,22,42,13,"win_A",-7,9,6,4,0,0,0,0,0.984126984126984,0.78,0.666666666666667,0.13,0,"orthodox"
"156901",23,24,173,180,170,184,150,159,52,56,9,1,14,38,"win_B",-1,-7,-14,-9,0,0,0,0,0.852459016393443,0.982456140350877,0.229508196721311,0.666666666666667,1,"orthodox"
"156913",33,22,166,180,170,184,145,140,135,44,17,1,91,30,"win_B",11,-14,-14,5,0,0,0,0,0.888157894736842,0.977777777777778,0.598684210526316,0.666666666666667,1,"orthodox"
"156960",45,20,180,191,191,198,191,204,185,15,22,0,131,12,"win_B",25,-11,-7,-13,1,0,0,0,0.893719806763285,1,0.632850241545894,0.8,1,"orthodox"
"156962",45,25,180,192,191,185,197,211,183,19,22,2,129,15,"win_A",20,-12,6,-14,1,0,0,0,0.892682926829268,0.904761904761905,0.629268292682927,0.714285714285714,0,"orthodox"
"156963",44,32,180,187,191,196,198,192,182,13,22,5,128,7,"win_A",12,-7,-5,6,1,0,0,0,0.892156862745098,0.722222222222222,0.627450980392157,0.388888888888889,0,"orthodox"
"156984",40,22,180,185,191,191,175,172,162,31,21,4,117,24,"win_A",18,-5,0,3,1,0,0,0,0.885245901639344,0.885714285714286,0.639344262295082,0.685714285714286,0,"orthodox"
"156994",39,28,180,189,191,188,196,211,153,41,20,24,109,22,"win_A",11,-9,3,-15,1,0,0,1,0.884393063583815,0.630769230769231,0.630057803468208,0.338461538461538,0,"orthodox"
"157006",36,24,180,176,191,176,180,175,142,24,19,0,104,11,"win_A",12,4,15,5,1,0,0,0,0.881987577639752,1,0.645962732919255,0.458333333333333,0,"orthodox"
"157047",32,21,180,178,191,188,172,172,103,25,17,0,76,15,"win_A",11,2,3,0,0,0,0,0,0.858333333333333,1,0.633333333333333,0.6,0,"orthodox"
"157050",32,35,180,173,191,193,174,184,100,183,17,55,73,110,"win_A",-3,7,-2,-10,0,1,0,0,0.854700854700855,0.76890756302521,0.623931623931624,0.46218487394958,0,"orthodox"
"157052",32,35,180,173,191,193,175,184,98,183,17,53,71,110,"win_A",-3,7,-2,-9,0,1,0,0,0.852173913043478,0.775423728813559,0.617391304347826,0.466101694915254,0,"orthodox"
"157060",31,28,180,182,191,193,172,187,92,66,15,11,69,25,"win_A",3,-2,-2,-15,0,0,0,1,0.85981308411215,0.857142857142857,0.644859813084112,0.324675324675325,0,"orthodox"
"157067",30,27,180,182,191,193,174,184,87,60,13,10,65,23,"win_A",3,-2,-2,-10,0,0,0,0,0.87,0.857142857142857,0.65,0.328571428571429,0,"orthodox"
"157076",24,29,183,180,185,191,174,171,37,80,4,11,19,62,"win_A",-5,3,-6,3,0,0,0,0,0.902439024390244,0.879120879120879,0.463414634146341,0.681318681318681,0,"orthodox"
"157086",28,31,180,178,191,189,162,166,72,55,9,12,55,27,"win_A",-3,2,2,-4,0,0,0,0,0.888888888888889,0.82089552238806,0.679012345679012,0.402985074626866,0,"orthodox"
"157099",26,27,175,180,191,191,161,155,61,60,9,8,37,47,"win_A",-1,-5,0,6,0,0,0,0,0.871428571428571,0.882352941176471,0.528571428571429,0.691176470588235,0,"orthodox"
"157119",23,30,180,179,191,184,159,160,44,86,4,20,35,51,"win_A",-7,1,7,-1,0,0,0,0,0.916666666666667,0.811320754716981,0.729166666666667,0.481132075471698,0,"orthodox"
"157124",23,29,180,179,191,184,159,160,39,85,4,19,30,51,"win_A",-6,1,7,-1,0,0,0,0,0.906976744186046,0.817307692307692,0.697674418604651,0.490384615384615,0,"orthodox"
"157130",22,18,180,179,191,185,161,172,34,9,3,3,27,6,"win_A",4,1,6,-11,0,0,0,0,0.918918918918919,0.75,0.72972972972973,0.5,0,"orthodox"
"157140",21,28,180,177,191,180,161,165,25,115,2,27,19,73,"win_A",-7,3,11,-4,0,0,0,0,0.925925925925926,0.809859154929577,0.703703703703704,0.514084507042254,0,"orthodox"
"157143",21,28,180,177,191,180,160,164,23,112,1,26,18,71,"win_B",-7,3,11,-4,0,0,0,0,0.958333333333333,0.811594202898551,0.75,0.514492753623188,1,"orthodox"
"157172",26,43,189,185,191,191,170,169,34,48,0,5,30,32,"win_B",-17,4,0,1,0,1,0,0,1,0.905660377358491,0.882352941176471,0.60377358490566,1,"orthodox"
"157173",43,36,185,180,191,185,173,173,48,44,4,0,32,32,"win_B",7,5,6,0,1,1,0,0,0.923076923076923,1,0.615384615384615,0.727272727272727,1,"orthodox"
"157174",42,35,185,179,191,183,170,170,47,51,4,3,32,25,"win_A",7,6,8,0,1,1,0,0,0.92156862745098,0.944444444444444,0.627450980392157,0.462962962962963,0,"orthodox"
"157175",37,41,188,185,191,191,174,174,24,46,3,4,18,32,"win_B",-4,3,0,0,1,1,0,0,0.888888888888889,0.92,0.666666666666667,0.64,1,"southpaw"
"157176",27,40,180,185,189,191,160,159,24,46,0,3,17,32,"win_A",-13,-5,-2,1,0,1,0,0,1,0.938775510204082,0.708333333333333,0.653061224489796,0,"orthodox"
"157177",40,26,185,180,191,189,160,160,46,23,2,0,32,17,"win_B",14,5,2,0,1,0,0,0,0.958333333333333,1,0.666666666666667,0.739130434782609,1,"orthodox"
"157179",39,31,185,179,191,185,156,155,44,37,2,3,31,29,"win_A",8,6,6,1,1,0,0,0,0.956521739130435,0.925,0.673913043478261,0.725,0,"orthodox"
"157180",39,34,185,177,191,185,159,160,43,36,2,4,31,27,"win_A",5,8,6,-1,1,0,0,0,0.955555555555556,0.9,0.688888888888889,0.675,0,"orthodox"
"157181",38,33,185,175,191,184,160,159,42,34,2,2,31,25,"win_A",5,10,7,1,1,0,0,0,0.954545454545455,0.944444444444444,0.704545454545455,0.694444444444444,0,"orthodox"
"157189",29,34,177,185,185,191,159,159,23,34,2,2,18,26,"win_B",-5,-8,-6,0,0,0,0,0,0.92,0.944444444444444,0.72,0.722222222222222,1,"southpaw"
"157190",34,33,177,185,180,191,160,160,47,33,6,2,34,25,"win_B",1,-8,-11,0,0,0,0,0,0.886792452830189,0.942857142857143,0.641509433962264,0.714285714285714,1,"orthodox"
"157191",30,32,177,185,185,191,160,160,27,32,5,2,19,25,"win_B",-2,-8,-6,0,0,0,0,0,0.84375,0.941176470588235,0.59375,0.735294117647059,1,"Unknown"
"157197",30,28,185,188,191,188,158,160,26,18,2,2,19,11,"win_A",2,-3,3,-2,0,0,0,0,0.928571428571429,0.9,0.678571428571429,0.55,0,"orthodox"
"157202",28,29,185,172,191,178,158,160,21,26,1,14,16,11,"win_A",-1,13,13,-2,0,0,0,0,0.954545454545455,0.65,0.727272727272727,0.275,0,"orthodox"
"157227",36,25,191,185,198,193,221,201,55,7,3,0,37,5,"win_A",11,6,5,20,1,0,1,0,0.948275862068966,1,0.637931034482759,0.714285714285714,0,"orthodox"
"157240",30,32,182,191,185,198,212,209,30,43,1,2,25,31,"win_B",-2,-9,-13,3,0,0,0,0,0.967741935483871,0.955555555555556,0.806451612903226,0.688888888888889,1,"orthodox"
"157242",31,30,191,191,198,203,212,205,41,30,2,1,31,23,"win_A",1,0,-5,7,0,0,0,0,0.953488372093023,0.967741935483871,0.720930232558139,0.741935483870968,0,"orthodox"
"157243",31,29,191,191,198,203,221,210,41,29,1,1,31,23,"win_B",2,0,-5,11,0,0,0,0,0.976190476190476,0.966666666666667,0.738095238095238,0.766666666666667,1,"orthodox"
"157252",29,28,191,191,198,193,227,256,32,29,1,2,26,20,"win_A",1,0,5,-29,0,0,0,1,0.96969696969697,0.935483870967742,0.787878787878788,0.645161290322581,0,"orthodox"
"157255",28,28,191,179,198,185,212,204,30,46,0,6,24,37,"win_A",0,12,13,8,0,0,0,0,1,0.884615384615385,0.8,0.711538461538462,0,"orthodox"
"157270",20,25,191,192,198,185,199,208,14,19,0,3,11,15,"win_A",-5,-1,13,-9,0,0,0,0,1,0.863636363636364,0.785714285714286,0.681818181818182,0,"orthodox"
"157286",37,31,188,182,193,193,203,180,65,78,2,20,52,28,"win_A",6,6,0,23,1,0,1,0,0.970149253731343,0.795918367346939,0.776119402985075,0.285714285714286,0,"orthodox"
"157298",28,32,187,188,184,193,207,182,62,54,10,1,13,46,"win_B",-4,-1,-9,25,0,0,1,0,0.861111111111111,0.981818181818182,0.180555555555556,0.836363636363636,1,"orthodox"
"157312",25,27,188,184,193,188,203,202,40,54,1,9,34,31,"win_A",-2,4,5,1,0,0,0,0,0.975609756097561,0.857142857142857,0.829268292682927,0.492063492063492,0,"orthodox"
"157329",22,30,188,185,193,193,198,192,24,48,0,7,20,33,"win_B",-8,3,0,6,0,0,0,0,1,0.872727272727273,0.833333333333333,0.6,1,"orthodox"
"157332",21,26,188,189,193,206,198,210,21,40,0,8,17,30,"win_A",-5,-1,-13,-12,0,0,0,0,1,0.833333333333333,0.80952380952381,0.625,0,"orthodox"
"157341",20,22,188,187,193,222,195,187,12,49,0,13,10,15,"win_A",-2,1,-29,8,0,0,0,0,1,0.790322580645161,0.833333333333333,0.241935483870968,0,"orthodox"
"157355",42,34,171,175,169,178,143,143,106,32,5,9,86,12,"win_A",8,-4,-9,0,1,0,0,0,0.954954954954955,0.780487804878049,0.774774774774775,0.292682926829268,0,"orthodox"
"157357",41,36,171,177,169,170,150,154,104,26,5,10,85,7,"win_A",5,-6,-1,-4,1,1,0,0,0.954128440366973,0.722222222222222,0.779816513761468,0.194444444444444,0,"orthodox"
"157360",37,34,171,175,169,173,147,147,102,181,4,13,83,121,"win_A",3,-4,-4,0,1,0,0,0,0.962264150943396,0.93298969072165,0.783018867924528,0.623711340206186,0,"orthodox"
"157366",34,31,171,179,169,173,148,146,98,22,2,6,80,11,"win_A",3,-8,-4,2,0,0,0,0,0.98,0.785714285714286,0.8,0.392857142857143,0,"orthodox"
"157367",34,36,171,177,169,175,151,149,97,34,2,5,80,12,"win_A",-2,-6,-6,2,0,1,0,0,0.97979797979798,0.871794871794872,0.808080808080808,0.307692307692308,0,"orthodox"
"157369",23,33,179,171,185,169,139,139,21,96,0,1,19,79,"win_A",-10,8,16,0,0,0,0,0,1,0.989690721649485,0.904761904761905,0.814432989690722,0,"orthodox"
"157370",33,26,171,184,169,192,144,144,95,21,1,3,78,12,"win_A",7,-13,-23,0,0,0,0,0,0.989583333333333,0.875,0.8125,0.5,0,"orthodox"
"157371",33,30,171,180,169,175,140,140,94,26,1,0,78,20,"win_A",3,-9,-6,0,0,0,0,0,0.989473684210526,1,0.821052631578947,0.769230769230769,0,"orthodox"
"157374",32,31,171,168,169,183,140,139,91,45,1,4,76,32,"win_A",1,3,-14,1,0,0,0,0,0.989130434782609,0.918367346938776,0.826086956521739,0.653061224489796,0,"orthodox"
"157375",27,32,171,171,168,169,140,140,32,90,3,1,18,75,"win_B",-5,0,-1,0,0,0,0,0,0.914285714285714,0.989010989010989,0.514285714285714,0.824175824175824,1,"orthodox"
"157376",31,32,171,173,169,173,140,140,89,49,1,2,75,39,"win_A",-1,-2,-4,0,0,0,0,0,0.988888888888889,0.96078431372549,0.833333333333333,0.764705882352941,0,"orthodox"
"157377",31,32,171,173,169,173,140,140,89,48,0,2,75,39,"win_B",-1,-2,-4,0,0,0,0,0,1,0.96,0.842696629213483,0.78,1,"orthodox"
"157385",30,30,169,171,175,169,140,140,40,81,1,0,17,68,"win_B",0,-2,6,0,0,0,0,0,0.975609756097561,1,0.414634146341463,0.839506172839506,1,"southpaw"
"157392",28,27,171,173,169,175,145,142,74,23,0,3,62,14,"win_A",1,-2,-6,3,0,0,0,0,1,0.884615384615385,0.837837837837838,0.538461538461538,0,"orthodox"
"157405",26,29,171,169,169,163,135,134,61,101,0,6,50,82,"win_A",-3,2,6,1,0,0,0,0,1,0.94392523364486,0.819672131147541,0.766355140186916,0,"orthodox"
"157467",48,46,189,191,198,196,226,238,43,64,10,2,28,43,"win_A",2,-2,2,-12,1,1,0,0,0.811320754716981,0.96969696969697,0.528301886792453,0.651515151515151,0,"orthodox"
"157468",47,41,189,188,198,188,220,250,42,47,10,4,27,28,"win_A",6,1,10,-30,1,1,0,1,0.807692307692308,0.92156862745098,0.519230769230769,0.549019607843137,0,"orthodox"
"157471",44,41,189,195,198,203,219,242,41,46,8,6,27,38,"win_A",3,-6,-5,-23,1,1,0,1,0.836734693877551,0.884615384615385,0.551020408163265,0.730769230769231,0,"orthodox"
"157475",32,40,187,189,188,198,220,214,35,38,2,5,20,25,"win_A",-8,-2,-10,6,0,1,0,0,0.945945945945946,0.883720930232558,0.540540540540541,0.581395348837209,0,"southpaw"
"157476",39,29,189,189,198,208,216,224,37,35,5,3,25,29,"win_A",10,0,-10,-8,1,0,0,0,0.880952380952381,0.921052631578947,0.595238095238095,0.763157894736842,0,"orthodox"
"157477",29,38,188,189,198,198,217,227,36,37,4,4,27,25,"win_A",-9,-1,0,-10,0,1,0,0,0.9,0.902439024390244,0.675,0.609756097560976,0,"orthodox"
"157478",37,28,189,188,198,198,221,224,36,36,4,3,25,27,"win_A",9,1,0,-3,1,0,0,0,0.9,0.923076923076923,0.625,0.692307692307692,0,"orthodox"
"157479",34,37,196,189,213,198,217,242,34,36,1,3,27,25,"win_A",-3,7,15,-25,0,1,0,1,0.971428571428571,0.923076923076923,0.771428571428571,0.641025641025641,0,"orthodox"
"157480",24,35,180,189,193,198,217,231,31,35,1,3,25,25,"win_B",-11,-9,-5,-14,0,1,0,0,0.96875,0.921052631578947,0.78125,0.657894736842105,1,"orthodox"
"157481",29,35,188,189,198,198,214,223,39,34,1,3,31,24,"win_B",-6,-1,0,-9,0,1,0,0,0.975,0.918918918918919,0.775,0.648648648648649,1,"southpaw"
"157482",30,34,178,189,180,198,218,218,45,33,2,3,39,24,"win_B",-4,-11,-18,0,0,0,0,0,0.957446808510638,0.916666666666667,0.829787234042553,0.666666666666667,1,"orthodox"
"157483",30,34,178,189,180,198,215,222,45,32,1,3,39,23,"win_B",-4,-11,-18,-7,0,0,0,0,0.978260869565217,0.914285714285714,0.847826086956522,0.657142857142857,1,"orthodox"
"157485",27,33,196,189,206,198,213,240,37,31,1,2,31,22,"win_A",-6,7,8,-27,0,0,0,1,0.973684210526316,0.939393939393939,0.815789473684211,0.666666666666667,0,"orthodox"
"157486",34,32,185,189,196,198,209,224,23,30,2,2,16,22,"win_B",2,-4,-2,-15,0,0,0,1,0.92,0.9375,0.64,0.6875,1,"orthodox"
"157487",26,31,188,189,198,198,214,214,34,30,0,1,30,22,"win_A",-5,-1,0,0,0,0,0,0,1,0.967741935483871,0.882352941176471,0.709677419354839,0,"southpaw"
"157488",25,31,196,189,206,198,217,246,34,29,0,1,29,22,"win_B",-6,7,8,-29,0,0,0,1,1,0.966666666666667,0.852941176470588,0.733333333333333,1,"orthodox"
"157489",30,28,189,191,198,199,212,228,28,32,1,4,22,32,"win_A",2,-2,-1,-16,0,0,0,1,0.96551724137931,0.888888888888889,0.758620689655172,0.888888888888889,0,"orthodox"
"157490",24,30,196,189,206,198,205,235,31,28,0,0,27,22,"win_A",-6,7,8,-30,0,0,0,1,1,1,0.870967741935484,0.785714285714286,0,"orthodox"
"157491",42,29,190,189,206,198,210,233,54,27,3,0,37,22,"win_B",13,1,8,-23,1,0,0,1,0.947368421052632,1,0.649122807017544,0.814814814814815,1,"orthodox"
"157492",29,25,189,181,198,199,210,215,26,26,0,7,21,23,"win_A",4,8,-1,-5,0,0,0,0,1,0.787878787878788,0.807692307692308,0.696969696969697,0,"orthodox"
"157493",28,42,189,192,198,199,208,257,25,69,0,2,21,65,"win_A",-14,-3,-1,-49,0,1,0,1,1,0.971830985915493,0.84,0.915492957746479,0,"orthodox"
"157494",30,28,192,189,211,198,208,246,30,24,4,0,20,20,"win_B",2,3,13,-38,0,0,0,1,0.882352941176471,1,0.588235294117647,0.833333333333333,1,"orthodox"
"157496",25,27,191,189,199,198,212,213,24,22,0,0,24,18,"win_B",-2,2,1,-1,0,0,0,0,1,1,1,0.818181818181818,1,"orthodox"
"157497",26,31,189,186,198,183,207,221,21,35,0,2,17,26,"win_A",-5,3,15,-14,0,0,0,0,1,0.945945945945946,0.80952380952381,0.702702702702703,0,"orthodox"
"157498",26,30,189,191,198,198,208,225,20,37,0,1,16,23,"win_A",-4,-2,0,-17,0,0,0,1,1,0.973684210526316,0.8,0.605263157894737,0,"orthodox"
"157499",26,30,189,191,198,196,210,222,19,29,0,2,15,24,"win_A",-4,-2,2,-12,0,0,0,0,1,0.935483870967742,0.789473684210526,0.774193548387097,0,"orthodox"
"157500",25,31,189,185,198,203,202,210,18,38,0,13,14,29,"win_A",-6,4,-5,-8,0,0,0,0,1,0.745098039215686,0.777777777777778,0.568627450980392,0,"orthodox"
"157502",34,25,170,189,180,198,187,190,28,16,4,0,17,12,"win_B",9,-19,-18,-3,0,0,0,0,0.875,1,0.53125,0.75,1,"orthodox"
"157503",24,32,189,182,198,188,189,190,15,21,0,4,11,11,"win_A",-8,7,10,-1,0,0,0,0,1,0.84,0.733333333333333,0.44,0,"orthodox"
"157567",29,38,188,171,193,188,190,208,73,173,7,34,43,98,"win_A",-9,17,5,-18,0,1,0,1,0.9125,0.835748792270531,0.5375,0.473429951690821,0,"orthodox"
"157589",37,24,171,198,188,206,191,230,156,18,29,20,89,12,"win_B",13,-27,-18,-39,1,0,0,1,0.843243243243243,0.473684210526316,0.481081081081081,0.315789473684211,1,"orthodox"
"157625",34,25,171,188,188,193,198,203,130,40,19,6,75,22,"win_B",9,-17,-5,-5,0,0,0,0,0.87248322147651,0.869565217391304,0.503355704697987,0.478260869565217,1,"orthodox"
"157627",34,38,171,178,188,188,198,196,128,110,19,21,74,69,"win_A",-4,-7,0,2,0,1,0,0,0.870748299319728,0.83969465648855,0.503401360544218,0.526717557251908,0,"orthodox"
"157628",34,27,171,196,188,207,206,211,127,11,19,9,73,7,"win_A",7,-25,-19,-5,0,0,0,0,0.86986301369863,0.55,0.5,0.35,0,"orthodox"
"157638",33,36,171,178,188,188,198,198,120,103,16,20,70,64,"win_A",-3,-7,0,0,0,1,0,0,0.882352941176471,0.83739837398374,0.514705882352941,0.520325203252033,0,"orthodox"
"157639",23,33,188,171,193,188,204,215,30,120,5,15,19,70,"win_A",-10,17,5,-11,0,0,0,0,0.857142857142857,0.888888888888889,0.542857142857143,0.518518518518518,0,"orthodox"
"157640",31,33,179,171,191,188,202,220,66,119,12,15,54,70,"win_B",-2,8,3,-18,0,0,0,1,0.846153846153846,0.888059701492537,0.692307692307692,0.522388059701492,1,"orthodox"
"157641",33,29,171,180,188,201,190,176,118,114,15,8,69,64,"win_A",4,-9,-13,14,0,0,0,0,0.887218045112782,0.934426229508197,0.518796992481203,0.524590163934426,0,"orthodox"
"157643",23,33,188,171,193,188,195,204,28,117,5,14,19,68,"win_A",-10,17,5,-9,0,0,0,0,0.848484848484849,0.893129770992366,0.575757575757576,0.519083969465649,0,"orthodox"
"157645",32,31,171,179,188,191,193,212,115,66,14,11,68,54,"win_A",1,-8,-3,-19,0,0,0,1,0.891472868217054,0.857142857142857,0.527131782945736,0.701298701298701,0,"orthodox"
"157647",23,32,188,171,193,188,190,210,27,114,4,13,19,67,"win_A",-9,17,5,-20,0,0,0,1,0.870967741935484,0.897637795275591,0.612903225806452,0.52755905511811,0,"orthodox"
"157648",23,32,188,171,193,188,195,205,26,114,4,12,19,67,"win_A",-9,17,5,-10,0,0,0,0,0.866666666666667,0.904761904761905,0.633333333333333,0.531746031746032,0,"orthodox"
"157655",31,22,171,188,188,193,190,210,109,23,10,1,65,19,"win_A",9,-17,-5,-20,0,0,0,1,0.915966386554622,0.958333333333333,0.546218487394958,0.791666666666667,0,"orthodox"
"157676",29,28,171,179,188,191,168,205,90,54,8,8,50,49,"win_A",1,-8,-3,-37,0,0,0,1,0.918367346938776,0.870967741935484,0.510204081632653,0.790322580645161,0,"orthodox"
"157682",27,28,179,171,191,188,170,198,52,85,6,7,49,48,"win_A",-1,8,3,-28,0,0,0,1,0.896551724137931,0.923913043478261,0.844827586206897,0.521739130434783,0,"orthodox"
"157684",28,32,171,178,188,188,178,195,83,39,7,15,47,25,"win_A",-4,-7,0,-17,0,0,0,1,0.922222222222222,0.722222222222222,0.522222222222222,0.462962962962963,0,"orthodox"
"157691",27,27,171,185,188,194,165,196,76,22,7,8,42,19,"win_A",0,-14,-6,-31,0,0,0,1,0.91566265060241,0.733333333333333,0.506024096385542,0.633333333333333,0,"orthodox"
"157696",27,31,171,178,188,188,170,190,71,32,7,13,39,21,"win_A",-4,-7,0,-20,0,0,0,1,0.91025641025641,0.711111111111111,0.5,0.466666666666667,0,"orthodox"
"157714",25,28,171,179,188,175,160,175,54,37,6,11,27,24,"win_A",-3,-8,13,-15,0,0,0,1,0.9,0.770833333333333,0.45,0.5,0,"orthodox"
"157735",28,23,184,171,188,188,156,185,37,35,5,4,16,18,"win_A",5,13,0,-29,0,0,0,1,0.880952380952381,0.897435897435897,0.380952380952381,0.461538461538462,0,"orthodox"
"157743",22,27,171,169,188,178,155,160,29,72,2,21,16,51,"win_A",-5,2,10,-5,0,0,0,0,0.935483870967742,0.774193548387097,0.516129032258065,0.548387096774194,0,"orthodox"
"157785",32,33,188,180,193,178,213,185,82,33,7,20,51,12,"win_A",-1,8,15,28,0,0,1,0,0.921348314606742,0.622641509433962,0.573033707865168,0.226415094339623,0,"orthodox"
"157791",30,36,188,180,193,201,215,177,76,128,7,39,45,70,"win_A",-6,8,-8,38,0,1,1,0,0.91566265060241,0.766467065868264,0.542168674698795,0.419161676646707,0,"orthodox"
"157792",30,36,188,180,193,201,211,193,75,128,7,38,44,70,"win_A",-6,8,-8,18,0,1,1,0,0.914634146341463,0.771084337349398,0.536585365853659,0.421686746987952,0,"orthodox"
"157795",29,25,188,198,193,206,216,236,72,20,6,23,43,12,"win_A",4,-10,-13,-20,0,0,0,1,0.923076923076923,0.465116279069767,0.551282051282051,0.27906976744186,0,"orthodox"
"157796",29,40,188,192,193,204,210,212,71,26,6,8,42,16,"win_A",-11,-4,-11,-2,0,1,0,0,0.922077922077922,0.764705882352941,0.545454545454545,0.470588235294118,0,"orthodox"
"157799",29,25,188,198,193,206,214,243,68,19,6,22,39,12,"win_A",4,-10,-13,-29,0,0,0,1,0.918918918918919,0.463414634146341,0.527027027027027,0.292682926829268,0,"orthodox"
"157805",28,25,188,198,193,206,210,230,62,19,6,21,34,12,"win_A",3,-10,-13,-20,0,0,0,1,0.911764705882353,0.475,0.5,0.3,0,"orthodox"
"157807",28,29,188,194,193,215,204,210,60,61,6,7,32,48,"win_A",-1,-6,-22,-6,0,0,0,0,0.909090909090909,0.897058823529412,0.484848484848485,0.705882352941177,0,"orthodox"
"157813",27,40,188,178,193,188,209,204,52,118,6,24,28,69,"win_A",-13,10,5,5,0,1,0,0,0.896551724137931,0.830985915492958,0.482758620689655,0.485915492957746,0,"orthodox"
"157833",31,23,179,188,191,193,208,219,61,24,10,3,53,19,"win_A",8,-9,-2,-11,0,0,0,0,0.859154929577465,0.888888888888889,0.746478873239437,0.703703703703704,0,"orthodox"
"157835",30,22,179,188,191,193,206,217,59,23,10,2,53,19,"win_A",8,-9,-2,-11,0,0,0,0,0.855072463768116,0.92,0.768115942028985,0.76,0,"orthodox"
"157864",31,25,173,187,180,193,164,172,258,52,15,8,48,20,"win_A",6,-14,-13,-8,0,0,0,0,0.945054945054945,0.866666666666667,0.175824175824176,0.333333333333333,0,"orthodox"
"157878",31,18,173,179,180,182,166,164,244,33,15,3,44,4,"win_A",13,-6,-2,2,0,0,0,0,0.942084942084942,0.916666666666667,0.16988416988417,0.111111111111111,0,"orthodox"
"157879",31,23,173,170,180,170,159,152,243,71,15,12,44,31,"win_A",8,3,10,7,0,0,0,0,0.941860465116279,0.855421686746988,0.170542635658915,0.373493975903614,0,"orthodox"
"157895",30,24,173,187,180,193,169,173,228,45,14,4,41,16,"win_A",6,-14,-13,-4,0,0,0,0,0.942148760330578,0.918367346938776,0.169421487603306,0.326530612244898,0,"orthodox"
"157915",29,20,173,182,180,185,168,166,211,39,11,9,36,8,"win_B",9,-9,-5,2,0,0,0,0,0.95045045045045,0.8125,0.162162162162162,0.166666666666667,1,"orthodox"
"157917",29,30,173,175,180,183,158,158,209,55,11,21,36,25,"win_A",-1,-2,-3,0,0,0,0,0,0.95,0.723684210526316,0.163636363636364,0.328947368421053,0,"orthodox"
"157922",28,20,173,182,180,185,166,166,205,36,10,6,35,7,"win_A",8,-9,-5,0,0,0,0,0,0.953488372093023,0.857142857142857,0.162790697674419,0.166666666666667,0,"orthodox"
"157925",28,28,173,180,180,196,164,188,202,35,10,29,35,16,"win_A",0,-7,-16,-24,0,0,0,1,0.952830188679245,0.546875,0.165094339622642,0.25,0,"orthodox"
"157926",28,28,173,180,180,196,168,180,201,35,10,28,35,16,"win_A",0,-7,-16,-12,0,0,0,0,0.95260663507109,0.555555555555556,0.165876777251185,0.253968253968254,0,"orthodox"
"157931",28,28,173,180,180,191,165,181,196,22,10,27,33,14,"win_A",0,-7,-11,-16,0,0,0,1,0.951456310679612,0.448979591836735,0.160194174757282,0.285714285714286,0,"orthodox"
"157935",27,30,173,174,180,180,164,163,192,95,10,26,32,35,"win_A",-3,-1,0,1,0,0,0,0,0.95049504950495,0.785123966942149,0.158415841584158,0.289256198347107,0,"orthodox"
"157936",27,27,173,180,180,191,163,179,191,21,10,26,32,14,"win_A",0,-7,-11,-16,0,0,0,1,0.950248756218905,0.446808510638298,0.159203980099502,0.297872340425532,0,"orthodox"
"157974",25,29,173,184,180,188,165,166,154,49,9,0,26,10,"win_B",-4,-11,-8,-1,0,0,0,0,0.94478527607362,1,0.159509202453988,0.204081632653061,1,"orthodox"
"157983",25,23,173,178,180,183,166,159,145,31,9,17,26,4,"win_A",2,-5,-3,7,0,0,0,0,0.941558441558442,0.645833333333333,0.168831168831169,0.0833333333333333,0,"orthodox"
"158000",25,31,173,175,180,183,159,155,128,88,9,6,25,30,"win_A",-6,-2,-3,4,0,0,0,0,0.934306569343066,0.936170212765957,0.182481751824818,0.319148936170213,0,"orthodox"
"158005",24,28,173,180,180,178,163,175,123,20,9,9,23,10,"win_A",-4,-7,2,-12,0,0,0,0,0.931818181818182,0.689655172413793,0.174242424242424,0.344827586206897,0,"orthodox"
"158008",24,27,173,180,180,178,170,180,120,147,9,33,23,22,"win_A",-3,-7,2,-10,0,0,0,0,0.930232558139535,0.816666666666667,0.178294573643411,0.122222222222222,0,"orthodox"
"158027",24,24,173,184,180,193,150,174,101,45,9,6,21,18,"win_A",0,-11,-13,-24,0,0,0,1,0.918181818181818,0.882352941176471,0.190909090909091,0.352941176470588,0,"orthodox"
"158039",23,25,173,175,180,183,160,158,89,44,9,16,21,17,"win_A",-2,-2,-3,2,0,0,0,0,0.908163265306122,0.733333333333333,0.214285714285714,0.283333333333333,0,"orthodox"
"158063",23,26,173,180,180,178,162,177,66,137,8,27,14,22,"win_A",-3,-7,2,-15,0,0,0,1,0.891891891891892,0.835365853658537,0.189189189189189,0.134146341463415,0,"orthodox"
"158075",22,27,173,179,180,197,157,160,54,23,8,15,8,9,"win_A",-5,-6,-17,-3,0,0,0,0,0.870967741935484,0.605263157894737,0.129032258064516,0.236842105263158,0,"orthodox"
"158101",21,24,173,184,180,188,158,158,32,18,4,0,4,8,"win_B",-3,-11,-8,0,0,0,0,0,0.888888888888889,1,0.111111111111111,0.444444444444444,1,"orthodox"
"158138",35,31,179,171,185,173,150,150,38,33,5,5,30,9,"win_A",4,8,12,0,1,0,0,0,0.883720930232558,0.868421052631579,0.697674418604651,0.236842105263158,0,"orthodox"
"158140",31,25,179,181,185,185,160,160,36,20,3,0,29,9,"win_A",6,-2,0,0,0,0,0,0,0.923076923076923,1,0.743589743589744,0.45,0,"orthodox"
"158141",32,30,174,179,180,185,154,154,38,36,2,2,35,29,"win_A",2,-5,-5,0,0,0,0,0,0.95,0.947368421052632,0.875,0.763157894736842,0,"orthodox"
"158143",29,24,179,178,185,178,154,154,34,22,2,1,27,20,"win_A",5,1,7,0,0,0,0,0,0.944444444444444,0.956521739130435,0.75,0.869565217391304,0,"orthodox"
"158144",28,33,179,178,185,183,154,154,33,51,2,4,27,34,"win_A",-5,1,2,0,0,0,0,0,0.942857142857143,0.927272727272727,0.771428571428571,0.618181818181818,0,"orthodox"
"158145",28,28,179,171,185,178,147,146,32,33,2,4,26,27,"win_A",0,8,7,1,0,0,0,0,0.941176470588235,0.891891891891892,0.764705882352941,0.72972972972973,0,"orthodox"
"158147",29,27,180,179,191,185,147,147,34,31,1,1,24,25,"win_B",2,1,6,0,0,0,0,0,0.971428571428571,0.96875,0.685714285714286,0.78125,1,"orthodox"
"158148",26,26,180,179,184,185,147,147,35,31,0,0,30,25,"win_A",0,1,-1,0,0,0,0,0,1,1,0.857142857142857,0.806451612903226,0,"orthodox"
"158149",27,26,176,179,183,185,147,147,48,30,2,0,28,24,"win_B",1,-3,-2,0,0,0,0,0,0.96,1,0.56,0.8,1,"orthodox"
"158152",24,28,179,180,185,183,147,147,26,27,0,2,21,18,"win_A",-4,-1,2,0,0,0,0,0,1,0.931034482758621,0.807692307692308,0.620689655172414,0,"orthodox"
"158153",24,35,179,169,185,175,147,147,25,63,0,3,21,31,"win_A",-11,10,10,0,0,1,0,0,1,0.954545454545455,0.84,0.46969696969697,0,"orthodox"
"158156",26,23,174,179,173,185,140,140,41,22,0,0,31,20,"win_B",3,-5,-12,0,0,0,0,0,1,1,0.75609756097561,0.909090909090909,1,"orthodox"
"158159",29,22,180,179,183,185,135,133,32,18,0,0,16,16,"win_B",7,1,-2,2,0,0,0,0,1,1,0.5,0.888888888888889,1,"orthodox"
"158161",29,22,170,179,170,185,135,134,36,16,3,0,26,15,"win_B",7,-9,-15,1,0,0,0,0,0.923076923076923,1,0.666666666666667,0.9375,1,"orthodox"
"158168",20,26,179,170,185,178,135,135,9,10,0,4,8,2,"win_A",-6,9,7,0,0,0,0,0,1,0.714285714285714,0.888888888888889,0.142857142857143,0,"orthodox"
"158181",37,29,165,165,173,170,130,130,38,30,3,2,27,14,"win_A",8,0,3,0,1,0,0,0,0.926829268292683,0.9375,0.658536585365854,0.4375,0,"orthodox"
"158182",25,37,170,165,175,173,130,130,41,37,2,3,23,26,"win_B",-12,5,2,0,0,1,0,0,0.953488372093023,0.925,0.534883720930233,0.65,1,"orthodox"
"158184",34,22,165,170,173,175,129,128,36,33,2,1,26,16,"win_A",12,-5,-2,1,0,0,0,0,0.947368421052632,0.970588235294118,0.684210526315789,0.470588235294118,0,"orthodox"
"158189",26,31,168,165,175,173,134,135,21,32,1,1,12,24,"win_A",-5,3,2,-1,0,0,0,0,0.954545454545455,0.96969696969697,0.545454545454545,0.727272727272727,0,"southpaw"
"158209",24,23,165,168,173,173,124,126,13,43,0,1,10,31,"win_B",1,-3,0,-2,0,0,0,0,1,0.977272727272727,0.769230769230769,0.704545454545455,1,"orthodox"
"158231",31,32,198,188,206,193,238,219,49,22,3,0,43,17,"win_A",-1,10,13,19,0,0,1,0,0.942307692307692,1,0.826923076923077,0.772727272727273,0,"orthodox"
"158236",29,25,198,188,206,196,244,243,44,24,3,0,39,21,"win_A",4,10,10,1,0,0,0,0,0.936170212765957,1,0.829787234042553,0.875,0,"orthodox"
"158238",28,36,198,193,206,203,244,218,42,20,3,2,38,17,"win_A",-8,5,3,26,0,1,1,0,0.933333333333333,0.909090909090909,0.844444444444444,0.772727272727273,0,"orthodox"
"158239",30,28,188,198,196,206,243,226,29,42,2,2,26,38,"win_A",2,-10,-10,17,0,0,1,0,0.935483870967742,0.954545454545455,0.838709677419355,0.863636363636364,0,"orthodox"
"158243",26,32,198,198,206,208,241,263,39,28,1,2,35,16,"win_A",-6,0,-2,-22,0,0,0,1,0.975,0.933333333333333,0.875,0.533333333333333,0,"orthodox"
"158244",26,41,198,185,206,196,243,228,38,30,1,4,34,22,"win_A",-15,13,10,15,0,1,1,0,0.974358974358974,0.882352941176471,0.871794871794872,0.647058823529412,0,"orthodox"
"158246",25,28,198,191,206,203,241,234,36,17,1,1,32,9,"win_A",-3,7,3,7,0,0,0,0,0.972972972972973,0.944444444444444,0.864864864864865,0.5,0,"orthodox"
"158253",23,35,198,185,206,201,236,234,29,42,1,8,26,38,"win_A",-12,13,5,2,0,1,0,0,0.966666666666667,0.84,0.866666666666667,0.76,0,"orthodox"
"158265",22,25,198,188,206,188,228,241,18,25,0,1,15,21,"win_A",-3,10,18,-13,0,0,0,0,1,0.961538461538462,0.833333333333333,0.807692307692308,0,"orthodox"
"158267",21,28,198,193,206,196,228,256,16,15,0,1,14,8,"win_A",-7,5,10,-28,0,0,0,1,1,0.9375,0.875,0.5,0,"orthodox"
"158340",23,25,182,171,193,179,148,155,27,34,2,0,21,25,"win_A",-2,11,14,-7,0,0,0,0,0.931034482758621,1,0.724137931034483,0.735294117647059,0,"Unknown"
"158375",35,25,171,171,183,178,147,145,81,42,6,3,54,34,"win_B",10,0,5,2,1,0,0,0,0.931034482758621,0.933333333333333,0.620689655172414,0.755555555555556,1,"orthodox"
"158381",33,26,171,169,183,170,147,145,76,40,5,2,52,26,"win_A",7,2,13,2,0,0,0,0,0.938271604938272,0.952380952380952,0.641975308641975,0.619047619047619,0,"orthodox"
"158419",25,28,171,165,183,173,140,140,40,39,3,10,23,11,"win_A",-3,6,10,0,0,0,0,0,0.930232558139535,0.795918367346939,0.534883720930233,0.224489795918367,0,"orthodox"
"158564",30,24,170,175,178,173,135,135,50,47,5,4,22,30,"win_A",6,-5,5,0,0,0,0,0,0.909090909090909,0.92156862745098,0.4,0.588235294117647,0,"orthodox"
"158572",27,32,170,165,178,165,135,135,43,78,4,11,17,16,"win_A",-5,5,13,0,0,0,0,0,0.914893617021277,0.876404494382023,0.361702127659574,0.179775280898876,0,"orthodox"
"158573",27,28,170,167,178,173,135,135,42,71,4,18,16,27,"win_A",-1,3,5,0,0,0,0,0,0.91304347826087,0.797752808988764,0.347826086956522,0.303370786516854,0,"orthodox"
"158620",39,50,169,170,175,168,162,159,73,103,4,15,35,70,"win_A",-11,-1,7,3,1,1,0,0,0.948051948051948,0.872881355932203,0.454545454545455,0.593220338983051,0,"southpaw"
"158624",27,47,175,170,184,168,159,160,25,101,1,13,19,70,"win_A",-20,5,16,-1,0,1,0,0,0.961538461538462,0.885964912280702,0.730769230769231,0.614035087719298,0,"orthodox"
"158627",45,29,170,173,168,175,166,167,98,101,13,5,70,70,"win_A",16,-3,-7,-1,1,0,0,0,0.882882882882883,0.952830188679245,0.630630630630631,0.660377358490566,0,"orthodox"
"158631",45,34,170,169,168,175,157,160,96,58,11,3,68,28,"win_B",11,1,-7,-3,1,0,0,0,0.897196261682243,0.950819672131147,0.635514018691589,0.459016393442623,1,"orthodox"
"158634",43,30,170,178,168,178,168,162,93,16,11,0,66,13,"win_A",13,-8,-10,6,1,0,0,0,0.894230769230769,1,0.634615384615385,0.8125,0,"orthodox"
"158636",43,27,170,173,168,173,167,166,92,25,10,4,65,10,"win_A",16,-3,-5,1,1,0,0,0,0.901960784313726,0.862068965517241,0.637254901960784,0.344827586206897,0,"orthodox"
"158640",42,21,170,177,168,183,163,158,89,19,9,1,63,9,"win_A",21,-7,-15,5,1,0,0,0,0.908163265306122,0.95,0.642857142857143,0.45,0,"orthodox"
"158646",38,33,170,178,168,188,158,160,85,35,7,1,61,25,"win_B",5,-8,-20,-2,1,0,0,0,0.923913043478261,0.972222222222222,0.66304347826087,0.694444444444444,1,"orthodox"
"158659",31,25,170,173,168,178,152,149,75,29,4,8,56,26,"win_A",6,-3,-10,3,0,0,0,0,0.949367088607595,0.783783783783784,0.708860759493671,0.702702702702703,0,"orthodox"
"158665",24,29,178,170,188,168,146,146,27,72,1,1,18,56,"win_A",-5,8,20,0,0,0,0,0,0.964285714285714,0.986301369863014,0.642857142857143,0.767123287671233,0,"orthodox"
"158706",21,27,170,175,168,178,135,135,31,26,1,5,27,13,"win_A",-6,-5,-10,0,0,0,0,0,0.96875,0.838709677419355,0.84375,0.419354838709677,0,"orthodox"
"158762",34,32,184,179,188,175,212,193,53,51,5,15,25,34,"win_A",2,5,13,19,0,0,1,0,0.913793103448276,0.772727272727273,0.431034482758621,0.515151515151515,0,"orthodox"
"158763",35,32,183,184,194,188,208,227,19,52,0,5,16,24,"win_B",3,-1,6,-19,1,0,0,1,1,0.912280701754386,0.842105263157895,0.421052631578947,1,"orthodox"
"158765",31,23,184,185,188,193,209,191,50,19,5,1,23,16,"win_A",8,-1,-5,18,0,0,1,0,0.909090909090909,0.95,0.418181818181818,0.8,0,"orthodox"
"158773",28,23,184,185,188,194,185,174,42,5,5,3,18,3,"win_A",5,-1,-6,11,0,0,0,0,0.893617021276596,0.625,0.382978723404255,0.375,0,"orthodox"
"158778",27,28,189,184,203,188,195,195,4,36,6,5,4,16,"win_B",-1,5,15,0,0,0,0,0,0.4,0.878048780487805,0.4,0.390243902439024,1,"Unknown"
"158780",27,26,184,178,188,188,205,185,34,9,5,7,15,4,"win_A",1,6,0,20,0,0,1,0,0.871794871794872,0.5625,0.384615384615385,0.25,0,"orthodox"
"158798",26,19,184,179,188,191,190,207,18,8,3,2,8,8,"win_A",7,5,-3,-17,0,0,0,1,0.857142857142857,0.8,0.380952380952381,0.8,0,"orthodox"
"158800",25,24,184,192,188,201,180,210,16,25,3,7,8,11,"win_A",1,-8,-13,-30,0,0,0,1,0.842105263157895,0.78125,0.421052631578947,0.34375,0,"orthodox"
"158806",24,21,184,192,188,204,180,203,10,15,3,1,7,10,"win_A",3,-8,-16,-23,0,0,0,1,0.769230769230769,0.9375,0.538461538461538,0.625,0,"orthodox"
"158808",24,25,184,182,188,197,185,155,8,31,3,3,7,25,"win_A",-1,2,-9,30,0,0,1,0,0.727272727272727,0.911764705882353,0.636363636363636,0.735294117647059,0,"orthodox"
"158815",22,21,184,189,188,203,168,175,3,0,1,1,3,0,"win_A",1,-5,-15,-7,0,0,0,0,0.75,0,0.75,0,0,"orthodox"
"158833",36,21,171,171,183,175,158,158,79,26,16,1,21,11,"win_B",15,0,8,0,1,0,0,0,0.831578947368421,0.962962962962963,0.221052631578947,0.407407407407407,1,"orthodox"
"158834",36,31,171,173,183,180,160,160,78,49,16,13,21,42,"win_A",5,-2,3,0,1,0,0,0,0.829787234042553,0.790322580645161,0.223404255319149,0.67741935483871,0,"orthodox"
"158837",35,22,171,178,183,187,157,159,77,42,14,2,21,37,"win_B",13,-7,-4,-2,1,0,0,0,0.846153846153846,0.954545454545455,0.230769230769231,0.840909090909091,1,"orthodox"
"158844",33,24,171,168,183,174,154,152,71,16,12,0,21,12,"win_A",9,3,9,2,0,0,0,0,0.855421686746988,1,0.253012048192771,0.75,0,"orthodox"
"158852",32,40,171,173,183,180,157,167,63,60,11,18,20,27,"win_A",-8,-2,3,-10,0,1,0,0,0.851351351351351,0.769230769230769,0.27027027027027,0.346153846153846,0,"orthodox"
"158867",28,28,171,178,183,185,152,160,51,45,7,3,18,8,"win_A",0,-7,-2,-8,0,0,0,0,0.879310344827586,0.9375,0.310344827586207,0.166666666666667,0,"orthodox"
"158878",26,29,171,168,183,170,145,145,42,48,5,11,15,27,"win_A",-3,3,13,0,0,0,0,0,0.893617021276596,0.813559322033898,0.319148936170213,0.457627118644068,0,"orthodox"
"158907",22,20,171,174,183,183,151,151,17,24,1,2,6,7,"win_B",2,-3,0,0,0,0,0,0,0.944444444444444,0.923076923076923,0.333333333333333,0.269230769230769,1,"orthodox"
"158908",22,20,171,174,183,183,150,150,16,24,1,1,6,7,"win_A",2,-3,0,0,0,0,0,0,0.941176470588235,0.96,0.352941176470588,0.28,0,"orthodox"
"158928",33,26,169,171,180,172,132,132,157,43,10,14,100,26,"win_B",7,-2,8,0,0,0,0,0,0.940119760479042,0.754385964912281,0.598802395209581,0.456140350877193,1,"orthodox"
"158934",32,23,169,160,180,168,132,133,151,38,10,9,95,18,"win_A",9,9,12,-1,0,0,0,0,0.937888198757764,0.808510638297872,0.590062111801242,0.382978723404255,0,"orthodox"
"158938",31,21,169,173,180,177,135,142,148,35,9,5,95,12,"win_B",10,-4,3,-7,0,0,0,0,0.942675159235669,0.875,0.605095541401274,0.3,1,"orthodox"
"158964",27,22,169,168,180,178,133,133,123,3,7,1,81,1,"win_A",5,1,2,0,0,0,0,0,0.946153846153846,0.75,0.623076923076923,0.25,0,"orthodox"
"158994",20,26,160,169,165,180,133,124,52,94,2,6,36,59,"win_A",-6,-9,-15,9,0,0,0,0,0.962962962962963,0.94,0.666666666666667,0.59,0,"orthodox"
"159097",41,39,185,187,198,192,191,188,59,27,4,14,46,25,"win_B",2,-2,6,3,1,1,0,0,0.936507936507937,0.658536585365854,0.73015873015873,0.609756097560976,1,"orthodox"
"159104",35,30,185,180,198,196,184,186,52,19,4,2,42,18,"win_A",5,5,2,-2,1,0,0,0,0.928571428571429,0.904761904761905,0.75,0.857142857142857,0,"orthodox"
"159105",35,30,185,177,198,188,184,184,51,19,4,4,41,8,"win_A",5,8,10,0,1,0,0,0,0.927272727272727,0.826086956521739,0.745454545454545,0.347826086956522,0,"orthodox"
"159108",27,32,184,185,196,198,174,173,30,49,0,3,18,40,"win_B",-5,-1,-2,1,0,0,0,0,1,0.942307692307692,0.6,0.769230769230769,1,"orthodox"
"159113",29,28,185,185,198,188,160,160,45,24,2,4,38,15,"win_B",1,0,10,0,0,0,0,0,0.957446808510638,0.857142857142857,0.808510638297872,0.535714285714286,1,"orthodox"
"159118",27,26,185,185,198,198,160,160,40,22,2,0,34,16,"win_A",1,0,0,0,0,0,0,0,0.952380952380952,1,0.80952380952381,0.727272727272727,0,"orthodox"
"159127",25,22,178,185,188,198,145,146,30,32,1,0,21,30,"win_A",3,-7,-10,-1,0,0,0,0,0.967741935483871,1,0.67741935483871,0.9375,0,"orthodox"
"159172",25,25,177,180,191,193,160,160,48,51,2,15,40,32,"win_A",0,-3,-2,0,0,0,0,0,0.96,0.772727272727273,0.8,0.484848484848485,0,"southpaw"
"159244",23,28,164,163,178,165,135,135,65,125,5,18,22,41,"win_A",-5,1,13,0,0,0,0,0,0.928571428571429,0.874125874125874,0.314285714285714,0.286713286713287,0,"orthodox"
"159248",27,28,163,168,165,170,137,145,122,53,17,11,39,21,"win_B",-1,-5,-5,-8,0,0,0,0,0.877697841726619,0.828125,0.280575539568345,0.328125,1,"orthodox"
"159258",26,28,163,165,165,170,135,136,113,81,16,14,35,24,"win_A",-2,-2,-5,-1,0,0,0,0,0.875968992248062,0.852631578947368,0.271317829457364,0.252631578947368,0,"orthodox"
"159271",25,20,163,164,165,174,131,132,102,62,14,8,32,14,"win_A",5,-1,-9,-1,0,0,0,0,0.879310344827586,0.885714285714286,0.275862068965517,0.2,0,"orthodox"
"159276",25,23,163,168,165,165,133,130,97,93,14,5,30,40,"win_A",2,-5,0,3,0,0,0,0,0.873873873873874,0.948979591836735,0.27027027027027,0.408163265306122,0,"orthodox"
"159281",24,23,163,163,165,170,133,136,95,59,11,5,30,4,"win_B",1,0,-5,-3,0,0,0,0,0.89622641509434,0.921875,0.283018867924528,0.0625,1,"orthodox"
"159388",35,26,165,168,165,173,107,107,50,17,0,2,37,9,"win_A",9,-3,-8,0,1,0,0,0,1,0.894736842105263,0.74,0.473684210526316,0,"orthodox"
"159390",29,33,163,165,168,165,108,107,14,48,1,0,6,36,"win_B",-4,-2,3,1,0,0,0,0,0.933333333333333,1,0.4,0.75,1,"orthodox"
"159392",31,24,165,159,165,163,105,105,46,25,0,1,35,18,"win_A",7,6,2,0,0,0,0,0,1,0.961538461538462,0.760869565217391,0.692307692307692,0,"orthodox"
"159398",28,25,165,157,165,160,104,105,40,30,0,2,30,19,"win_A",3,8,5,-1,0,0,0,0,1,0.9375,0.75,0.59375,0,"orthodox"
"159402",27,24,165,165,165,175,105,104,36,21,0,0,27,14,"win_A",3,0,-10,1,0,0,0,0,1,1,0.75,0.666666666666667,0,"orthodox"
"159444",40,26,182,182,182,197,168,168,64,37,9,4,56,28,"win_A",14,0,-15,0,1,0,0,0,0.876712328767123,0.902439024390244,0.767123287671233,0.682926829268293,0,"orthodox"
"159449",39,27,182,183,182,194,172,219,60,16,8,0,53,13,"win_B",12,-1,-12,-47,1,0,0,1,0.882352941176471,1,0.779411764705882,0.8125,1,"orthodox"
"159451",37,28,182,188,182,199,158,195,58,27,8,5,51,15,"win_A",9,-6,-17,-37,1,0,0,1,0.878787878787879,0.84375,0.772727272727273,0.46875,0,"orthodox"
"159455",36,24,182,183,182,194,167,206,55,10,7,0,48,8,"win_B",12,-1,-12,-39,1,0,0,1,0.887096774193548,1,0.774193548387097,0.8,1,"orthodox"
"159457",30,33,185,182,185,182,167,184,10,53,0,7,4,46,"win_B",-3,3,3,-17,0,0,0,1,1,0.883333333333333,0.4,0.766666666666667,1,"orthodox"
"159459",32,26,182,182,182,188,165,180,52,104,6,4,45,81,"win_A",6,0,-6,-15,0,0,0,1,0.896551724137931,0.962962962962963,0.775862068965517,0.75,0,"orthodox"
"159486",28,22,182,182,182,188,165,178,25,43,6,2,19,29,"win_A",6,0,-6,-13,0,0,0,0,0.806451612903226,0.955555555555556,0.612903225806452,0.644444444444444,0,"orthodox"
"159553",25,26,165,157,175,160,136,134,151,93,20,18,61,32,"win_A",-1,8,15,2,0,0,0,0,0.883040935672515,0.837837837837838,0.35672514619883,0.288288288288288,0,"orthodox"
"159596",22,32,165,173,175,178,138,141,109,143,19,34,44,23,"win_A",-10,-8,-3,-3,0,0,0,0,0.8515625,0.807909604519774,0.34375,0.129943502824859,0,"orthodox"
"159611",21,32,165,173,175,178,133,139,94,130,19,32,39,22,"win_A",-11,-8,-3,-6,0,0,0,0,0.831858407079646,0.802469135802469,0.345132743362832,0.135802469135802,0,"orthodox"
"159618",21,28,165,165,175,173,133,126,87,96,19,10,33,19,"win_A",-7,0,2,7,0,0,0,0,0.820754716981132,0.905660377358491,0.311320754716981,0.179245283018868,0,"orthodox"
"159662",19,26,165,165,175,173,130,128,46,72,16,7,16,15,"win_B",-7,0,2,2,0,0,0,0,0.741935483870968,0.911392405063291,0.258064516129032,0.189873417721519,1,"orthodox"
"159665",18,21,165,164,175,160,133,130,44,67,15,18,16,8,"win_B",-3,1,15,3,0,0,0,0,0.745762711864407,0.788235294117647,0.271186440677966,0.0941176470588235,1,"orthodox"
"159729",37,35,170,170,175,170,135,135,36,48,3,4,22,35,"win_B",2,0,5,0,1,1,0,0,0.923076923076923,0.923076923076923,0.564102564102564,0.673076923076923,1,"southpaw"
"159730",34,27,170,165,170,175,128,129,47,27,3,3,35,19,"win_A",7,5,-5,-1,0,0,0,0,0.94,0.9,0.7,0.633333333333333,0,"orthodox"
"159731",33,33,170,168,170,178,129,130,46,63,3,4,35,42,"win_A",0,2,-8,-1,0,0,0,0,0.938775510204082,0.940298507462687,0.714285714285714,0.626865671641791,0,"orthodox"
"159734",26,32,169,170,175,170,125,125,36,44,0,2,20,33,"win_A",-6,-1,5,0,0,0,0,0,1,0.956521739130435,0.555555555555556,0.717391304347826,0,"orthodox"
"159735",31,34,170,175,170,188,125,126,43,37,2,4,33,26,"win_A",-3,-5,-18,-1,0,0,0,0,0.955555555555556,0.902439024390244,0.733333333333333,0.634146341463415,0,"orthodox"
"159740",28,28,170,173,170,175,125,125,37,20,2,1,29,10,"win_A",0,-3,-5,0,0,0,0,0,0.948717948717949,0.952380952380952,0.743589743589744,0.476190476190476,0,"orthodox"
"159742",27,29,170,168,170,173,125,125,35,25,2,5,27,16,"win_A",-2,2,-3,0,0,0,0,0,0.945945945945946,0.833333333333333,0.72972972972973,0.533333333333333,0,"orthodox"
"159744",27,33,170,168,170,170,127,129,33,25,2,5,25,19,"win_A",-6,2,0,-2,0,0,0,0,0.942857142857143,0.833333333333333,0.714285714285714,0.633333333333333,0,"orthodox"
"159750",25,28,170,163,170,168,127,130,28,23,1,11,21,18,"win_A",-3,7,2,-3,0,0,0,0,0.96551724137931,0.676470588235294,0.724137931034483,0.529411764705882,0,"orthodox"
"159753",24,26,170,168,170,165,124,125,25,31,1,8,18,26,"win_A",-2,2,5,-1,0,0,0,0,0.961538461538462,0.794871794871795,0.692307692307692,0.666666666666667,0,"orthodox"
"159755",24,27,170,180,170,180,126,127,23,9,1,2,16,5,"win_A",-3,-10,-10,-1,0,0,0,0,0.958333333333333,0.818181818181818,0.666666666666667,0.454545454545455,0,"orthodox"
"159756",24,29,170,165,170,168,125,125,22,22,1,5,16,13,"win_A",-5,5,2,0,0,0,0,0,0.956521739130435,0.814814814814815,0.695652173913043,0.481481481481481,0,"orthodox"
"159759",23,27,170,162,170,163,125,126,19,20,1,5,14,11,"win_A",-4,8,7,-1,0,0,0,0,0.95,0.8,0.7,0.44,0,"orthodox"
"159771",21,23,170,170,170,173,124,126,7,1,1,6,5,1,"win_A",-2,0,-3,-2,0,0,0,0,0.875,0.142857142857143,0.625,0.142857142857143,0,"orthodox"
"159780",42,25,178,184,183,192,142,141,77,17,7,3,62,11,"win_B",17,-6,-9,1,1,0,0,0,0.916666666666667,0.85,0.738095238095238,0.55,1,"orthodox"
"159782",29,33,174,178,180,183,143,144,31,75,1,7,18,61,"win_B",-4,-4,-3,-1,0,0,0,0,0.96875,0.914634146341463,0.5625,0.74390243902439,1,"orthodox"
"159784",27,31,168,178,175,183,139,140,33,74,0,6,31,60,"win_A",-4,-10,-8,-1,0,0,0,0,1,0.925,0.939393939393939,0.75,0,"orthodox"
"159797",28,23,178,165,183,166,130,130,62,36,5,6,51,19,"win_A",5,13,17,0,0,0,0,0,0.925373134328358,0.857142857142857,0.761194029850746,0.452380952380952,0,"orthodox"
"159801",27,25,178,171,183,168,130,129,58,43,5,8,48,32,"win_A",2,7,15,1,0,0,0,0,0.920634920634921,0.843137254901961,0.761904761904762,0.627450980392157,0,"orthodox"
"159828",22,23,178,157,183,160,126,124,32,35,4,5,27,25,"win_A",-1,21,23,2,0,0,0,0,0.888888888888889,0.875,0.75,0.625,0,"orthodox"
"159877",32,27,170,179,170,182,176,178,123,176,20,35,56,13,"win_A",5,-9,-12,-2,0,0,0,0,0.86013986013986,0.834123222748815,0.391608391608392,0.0616113744075829,0,"orthodox"
"159882",31,22,170,170,170,183,170,161,120,72,18,12,54,43,"win_B",9,0,-13,9,0,0,0,0,0.869565217391304,0.857142857142857,0.391304347826087,0.511904761904762,1,"orthodox"
"159885",26,31,185,170,193,170,174,188,44,118,5,17,30,53,"win_A",-5,15,23,-14,0,0,0,0,0.897959183673469,0.874074074074074,0.612244897959184,0.392592592592593,0,"orthodox"
"159889",30,21,170,180,170,188,172,195,115,41,16,16,52,22,"win_A",9,-10,-18,-23,0,0,0,1,0.877862595419847,0.719298245614035,0.396946564885496,0.385964912280702,0,"orthodox"
"159907",28,28,170,180,170,185,164,175,97,50,16,14,40,17,"win_A",0,-10,-15,-11,0,0,0,0,0.858407079646018,0.78125,0.353982300884956,0.265625,0,"orthodox"
"159918",26,22,170,174,170,173,158,155,87,59,15,13,36,21,"win_A",4,-4,-3,3,0,0,0,0,0.852941176470588,0.819444444444444,0.352941176470588,0.291666666666667,0,"orthodox"
"159933",24,23,170,171,170,173,144,146,74,70,13,16,31,19,"win_B",1,-1,-3,-2,0,0,0,0,0.850574712643678,0.813953488372093,0.35632183908046,0.22093023255814,1,"orthodox"
"159936",24,26,170,170,170,175,150,151,71,57,13,27,31,16,"win_A",-2,0,-5,-1,0,0,0,0,0.845238095238095,0.678571428571429,0.369047619047619,0.19047619047619,0,"orthodox"
"159938",23,22,170,173,170,180,150,155,69,81,12,12,30,20,"win_A",1,-3,-10,-5,0,0,0,0,0.851851851851852,0.870967741935484,0.37037037037037,0.21505376344086,0,"orthodox"
"160023",35,25,174,175,180,183,147,147,43,27,4,2,37,13,"win_A",10,-1,-3,0,1,0,0,0,0.914893617021277,0.931034482758621,0.787234042553192,0.448275862068966,0,"orthodox"
"160024",34,28,174,178,180,178,153,154,42,26,4,3,36,22,"win_A",6,-4,2,-1,0,0,0,0,0.91304347826087,0.896551724137931,0.782608695652174,0.758620689655172,0,"orthodox"
"160026",34,28,174,180,180,168,148,148,40,33,4,0,35,28,"win_A",6,-6,12,0,0,0,0,0,0.909090909090909,1,0.795454545454545,0.848484848484849,0,"orthodox"
"160027",33,26,174,175,180,178,148,148,39,18,4,1,35,9,"win_A",7,-1,2,0,0,0,0,0,0.906976744186046,0.947368421052632,0.813953488372093,0.473684210526316,0,"orthodox"
"160028",32,33,179,174,183,180,154,154,47,39,3,3,25,35,"win_A",-1,5,3,0,0,0,0,0,0.94,0.928571428571429,0.5,0.833333333333333,0,"southpaw"
"160029",32,32,179,174,183,180,154,154,46,39,3,2,25,35,"win_A",0,5,3,0,0,0,0,0,0.938775510204082,0.951219512195122,0.510204081632653,0.853658536585366,0,"southpaw"
"160030",31,30,183,174,185,180,147,147,34,38,0,1,26,35,"win_A",1,9,5,0,0,0,0,0,1,0.974358974358974,0.764705882352941,0.897435897435897,0,"orthodox"
"160031",31,30,183,174,185,180,146,147,33,38,0,0,26,35,"win_A",1,9,5,-1,0,0,0,0,1,1,0.787878787878788,0.921052631578947,0,"orthodox"
"160032",29,30,174,170,180,180,147,147,37,30,0,3,34,23,"win_A",-1,4,0,0,0,0,0,0,1,0.909090909090909,0.918918918918919,0.696969696969697,0,"orthodox"
"160033",29,28,174,178,180,178,147,147,36,28,0,0,33,18,"win_A",1,-4,2,0,0,0,0,0,1,1,0.916666666666667,0.642857142857143,0,"orthodox"
"160035",28,32,174,177,180,170,148,148,33,24,0,6,31,7,"win_A",-4,-3,10,0,0,0,0,0,1,0.8,0.939393939393939,0.233333333333333,0,"orthodox"
"160036",28,30,174,180,180,183,146,147,32,30,0,3,30,19,"win_A",-2,-6,-3,-1,0,0,0,0,1,0.909090909090909,0.9375,0.575757575757576,0,"orthodox"
"160039",27,32,174,165,180,170,135,135,29,37,0,3,27,15,"win_A",-5,9,10,0,0,0,0,0,1,0.925,0.931034482758621,0.375,0,"orthodox"
"160042",26,33,174,170,180,170,135,135,26,45,0,4,24,30,"win_A",-7,4,10,0,0,0,0,0,1,0.918367346938776,0.923076923076923,0.612244897959184,0,"orthodox"
"160043",26,24,174,170,180,180,135,135,25,20,0,1,23,13,"win_A",2,4,0,0,0,0,0,0,1,0.952380952380952,0.92,0.619047619047619,0,"orthodox"
"160056",22,28,174,165,180,175,136,138,12,34,0,16,11,23,"win_A",-6,9,5,-2,0,0,0,0,1,0.68,0.916666666666667,0.46,0,"orthodox"
"160059",22,21,174,168,180,168,134,135,9,19,0,6,9,10,"win_A",1,6,12,-1,0,0,0,0,1,0.76,1,0.4,0,"orthodox"
"160086",35,27,165,157,173,160,129,132,214,36,8,35,61,11,"win_A",8,8,13,-3,1,0,0,0,0.963963963963964,0.507042253521127,0.274774774774775,0.154929577464789,0,"orthodox"
"160138",29,17,165,175,173,175,130,130,165,26,5,12,52,13,"win_A",12,-10,-2,0,0,0,0,0,0.970588235294118,0.684210526315789,0.305882352941176,0.342105263157895,0,"orthodox"
"160170",26,22,165,174,173,178,126,124,136,92,2,6,45,62,"win_A",4,-9,-5,2,0,0,0,0,0.985507246376812,0.938775510204082,0.326086956521739,0.63265306122449,0,"orthodox"
"160242",20,34,165,165,173,165,128,127,65,90,1,24,23,17,"win_A",-14,0,8,1,0,0,0,0,0.984848484848485,0.789473684210526,0.348484848484849,0.149122807017544,0,"orthodox"
"160316",23,26,168,170,170,178,146,139,48,114,7,21,18,61,"win_A",-3,-2,-8,7,0,0,0,0,0.872727272727273,0.844444444444444,0.327272727272727,0.451851851851852,0,"orthodox"
"160317",23,26,168,170,170,178,142,138,47,113,7,20,18,60,"win_A",-3,-2,-8,4,0,0,0,0,0.87037037037037,0.849624060150376,0.333333333333333,0.451127819548872,0,"orthodox"
"160318",22,25,168,170,170,178,141,138,47,108,6,19,18,58,"win_B",-3,-2,-8,3,0,0,0,0,0.886792452830189,0.850393700787402,0.339622641509434,0.456692913385827,1,"orthodox"
"160324",21,27,168,173,170,178,144,146,41,88,6,17,15,42,"win_A",-6,-5,-8,-2,0,0,0,0,0.872340425531915,0.838095238095238,0.319148936170213,0.4,0,"orthodox"
"160331",20,24,168,170,170,170,135,135,36,107,4,6,12,22,"win_B",-4,-2,0,0,0,0,0,0,0.9,0.946902654867257,0.3,0.194690265486726,1,"orthodox"
"160373",39,31,173,180,180,191,166,164,58,78,18,2,27,32,"win_A",8,-7,-11,2,1,0,0,0,0.763157894736842,0.975,0.355263157894737,0.4,0,"orthodox"
"160377",37,31,173,178,180,188,167,173,55,39,17,2,26,27,"win_A",6,-5,-8,-6,1,0,0,0,0.763888888888889,0.951219512195122,0.361111111111111,0.658536585365854,0,"orthodox"
"160379",37,30,173,178,180,188,167,175,53,39,17,1,25,27,"win_A",7,-5,-8,-8,1,0,0,0,0.757142857142857,0.975,0.357142857142857,0.675,0,"orthodox"
"160382",35,28,173,173,180,183,163,159,50,23,16,7,24,16,"win_A",7,0,-3,4,1,0,0,0,0.757575757575758,0.766666666666667,0.363636363636364,0.533333333333333,0,"orthodox"
"160389",31,33,173,173,175,180,159,160,55,45,4,14,24,21,"win_B",-2,0,-5,-1,0,0,0,0,0.932203389830508,0.76271186440678,0.406779661016949,0.355932203389831,1,"orthodox"
"160465",34,24,183,188,185,203,191,192,89,23,14,3,49,11,"win_B",10,-5,-18,-1,0,0,0,0,0.864077669902913,0.884615384615385,0.475728155339806,0.423076923076923,1,"orthodox"
"160475",26,32,188,183,198,185,190,201,21,83,2,10,16,46,"win_B",-6,5,13,-11,0,0,0,0,0.91304347826087,0.89247311827957,0.695652173913043,0.494623655913978,1,"orthodox"
"160484",31,32,183,182,185,193,185,183,76,82,8,23,42,30,"win_A",-1,1,-8,2,0,0,0,0,0.904761904761905,0.780952380952381,0.5,0.285714285714286,0,"orthodox"
"160486",31,28,183,184,185,175,189,187,74,52,8,11,41,33,"win_A",3,-1,10,2,0,0,0,0,0.902439024390244,0.825396825396825,0.5,0.523809523809524,0,"orthodox"
"160490",30,29,183,185,185,182,189,178,72,77,6,17,40,21,"win_A",1,-2,3,11,0,0,0,0,0.923076923076923,0.819148936170213,0.512820512820513,0.223404255319149,0,"orthodox"
"160492",30,37,183,183,185,188,182,194,71,49,5,16,39,31,"win_B",-7,0,-3,-12,0,1,0,0,0.934210526315789,0.753846153846154,0.513157894736842,0.476923076923077,1,"orthodox"
"160494",29,37,183,183,185,188,186,194,69,49,5,15,39,31,"win_A",-8,0,-3,-8,0,1,0,0,0.932432432432432,0.765625,0.527027027027027,0.484375,0,"orthodox"
"160495",29,34,183,180,185,185,185,193,68,64,5,27,38,29,"win_A",-5,3,0,-8,0,0,0,0,0.931506849315068,0.703296703296703,0.520547945205479,0.318681318681319,0,"orthodox"
"160505",27,28,183,182,185,193,176,178,57,66,5,12,31,25,"win_A",-1,1,-8,-2,0,0,0,0,0.919354838709677,0.846153846153846,0.5,0.320512820512821,0,"orthodox"
"160513",26,33,183,178,185,189,173,168,48,60,5,15,24,30,"win_A",-7,5,-4,5,0,0,0,0,0.905660377358491,0.8,0.452830188679245,0.4,0,"orthodox"
"160520",25,26,183,182,185,193,175,186,41,52,4,7,21,20,"win_A",-1,1,-8,-11,0,0,0,0,0.911111111111111,0.88135593220339,0.466666666666667,0.338983050847458,0,"orthodox"
"160531",21,28,183,178,185,189,168,165,30,38,3,7,15,23,"win_B",-7,5,-4,3,0,0,0,0,0.909090909090909,0.844444444444444,0.454545454545455,0.511111111111111,1,"orthodox"
"160533",21,20,183,185,185,182,166,184,29,21,2,6,15,6,"win_A",1,-2,3,-18,0,0,0,1,0.935483870967742,0.777777777777778,0.483870967741935,0.222222222222222,0,"orthodox"
"160539",24,20,175,183,191,185,160,151,52,23,6,2,32,11,"win_B",4,-8,6,9,0,0,0,0,0.896551724137931,0.92,0.551724137931034,0.44,1,"orthodox"
"160566",35,26,168,180,175,184,147,147,40,33,2,0,17,29,"win_B",9,-12,-9,0,1,0,0,0,0.952380952380952,1,0.404761904761905,0.878787878787879,1,"southpaw"
"160567",33,24,168,182,175,185,147,146,39,20,1,0,16,13,"win_A",9,-14,-10,1,0,0,0,0,0.975,1,0.4,0.65,0,"southpaw"
"160568",32,27,168,180,175,183,147,147,38,23,1,1,16,14,"win_A",5,-12,-8,0,0,0,0,0,0.974358974358974,0.958333333333333,0.41025641025641,0.583333333333333,0,"southpaw"
"160569",32,26,168,180,175,183,147,147,37,23,1,0,16,14,"win_A",6,-12,-8,0,0,0,0,0,0.973684210526316,1,0.421052631578947,0.608695652173913,0,"southpaw"
"160572",30,30,168,169,175,178,147,146,33,64,1,3,15,44,"win_A",0,-1,-3,1,0,0,0,0,0.970588235294118,0.955223880597015,0.441176470588235,0.656716417910448,0,"southpaw"
"160576",28,26,168,183,175,188,140,139,29,28,1,1,14,26,"win_A",2,-15,-13,1,0,0,0,0,0.966666666666667,0.96551724137931,0.466666666666667,0.896551724137931,0,"southpaw"
"160578",28,36,168,175,175,185,141,141,27,78,1,10,13,54,"win_A",-8,-7,-10,0,0,1,0,0,0.964285714285714,0.886363636363636,0.464285714285714,0.613636363636364,0,"southpaw"
"160579",27,25,168,165,175,173,135,135,26,38,1,3,13,27,"win_A",2,3,2,0,0,0,0,0,0.962962962962963,0.926829268292683,0.481481481481481,0.658536585365854,0,"southpaw"
"160581",27,24,168,172,175,175,135,135,24,26,1,2,13,16,"win_A",3,-4,0,0,0,0,0,0,0.96,0.928571428571429,0.52,0.571428571428571,0,"southpaw"
"160606",27,34,170,173,175,183,140,140,29,51,2,6,27,35,"win_A",-7,-3,-8,0,0,0,0,0,0.935483870967742,0.894736842105263,0.870967741935484,0.614035087719298,0,"orthodox"
"160610",28,29,168,173,178,183,134,133,26,48,1,2,16,34,"win_A",-1,-5,-5,1,0,0,0,0,0.962962962962963,0.96,0.592592592592593,0.68,0,"orthodox"
"160612",27,33,173,168,183,168,130,130,46,40,1,3,34,24,"win_A",-6,5,15,0,0,0,0,0,0.978723404255319,0.930232558139535,0.723404255319149,0.558139534883721,0,"orthodox"
"160613",27,31,173,165,183,165,130,130,45,40,1,2,34,28,"win_A",-4,8,18,0,0,0,0,0,0.978260869565217,0.952380952380952,0.739130434782609,0.666666666666667,0,"orthodox"
"160614",27,29,173,175,183,170,130,129,44,37,1,5,33,23,"win_A",-2,-2,13,1,0,0,0,0,0.977777777777778,0.880952380952381,0.733333333333333,0.547619047619048,0,"orthodox"
"160615",26,22,173,168,183,173,126,126,43,24,1,4,32,6,"win_A",4,5,10,0,0,0,0,0,0.977272727272727,0.857142857142857,0.727272727272727,0.214285714285714,0,"orthodox"
"160617",26,32,173,166,183,168,126,126,41,34,1,1,31,12,"win_A",-6,7,15,0,0,0,0,0,0.976190476190476,0.971428571428571,0.738095238095238,0.342857142857143,0,"orthodox"
"160618",28,25,168,173,178,183,126,126,54,41,3,0,39,31,"win_A",3,-5,-5,0,0,0,0,0,0.947368421052632,1,0.684210526315789,0.75609756097561,0,"orthodox"
"160621",24,30,173,161,183,163,130,135,38,24,0,1,30,11,"win_A",-6,12,20,-5,0,0,0,0,1,0.96,0.789473684210526,0.44,0,"orthodox"
"160622",24,33,173,170,183,180,126,126,37,51,0,4,29,34,"win_A",-9,3,3,0,0,0,0,0,1,0.927272727272727,0.783783783783784,0.618181818181818,0,"orthodox"
"160637",19,30,173,170,183,178,120,122,22,33,0,3,18,21,"win_A",-11,3,5,-2,0,0,0,0,1,0.916666666666667,0.818181818181818,0.583333333333333,0,"orthodox"
"160645",18,23,173,168,183,165,122,122,14,27,0,5,12,23,"win_A",-5,5,18,0,0,0,0,0,1,0.84375,0.857142857142857,0.71875,0,"orthodox"
"160680",32,27,185,183,213,180,189,213,33,38,1,2,23,29,"win_A",5,2,33,-24,0,0,0,1,0.970588235294118,0.95,0.676470588235294,0.725,0,"orthodox"
"160684",24,26,183,184,180,183,182,196,35,21,1,0,26,13,"win_B",-2,-1,-3,-14,0,0,0,0,0.972222222222222,1,0.722222222222222,0.619047619047619,1,"orthodox"
"160697",20,25,183,177,180,178,170,170,21,56,1,12,13,27,"win_A",-5,6,2,0,0,0,0,0,0.954545454545455,0.823529411764706,0.590909090909091,0.397058823529412,0,"orthodox"
"160706",19,32,183,185,180,182,168,177,13,80,0,21,8,22,"win_B",-13,-2,-2,-9,0,0,0,0,1,0.792079207920792,0.615384615384615,0.217821782178218,1,"orthodox"
"160710",19,24,183,177,180,178,167,171,9,48,0,6,7,25,"win_A",-5,6,2,-4,0,0,0,0,1,0.888888888888889,0.777777777777778,0.462962962962963,0,"orthodox"
"160855",28,22,183,180,193,188,188,192,74,20,1,7,46,13,"win_A",6,3,5,-4,0,0,0,0,0.986666666666667,0.740740740740741,0.613333333333333,0.481481481481481,0,"orthodox"
"160856",28,35,183,180,193,178,186,189,73,34,1,22,45,13,"win_A",-7,3,15,-3,0,1,0,0,0.986486486486487,0.607142857142857,0.608108108108108,0.232142857142857,0,"orthodox"
"160929",33,28,180,179,185,188,168,167,40,21,0,0,31,17,"win_A",5,1,-3,1,0,0,0,0,1,1,0.775,0.80952380952381,0,"southpaw"
"160934",31,29,180,182,185,180,167,168,35,25,0,2,28,18,"win_A",2,-2,5,-1,0,0,0,0,1,0.925925925925926,0.8,0.666666666666667,0,"southpaw"
"160941",28,23,180,183,185,178,168,167,28,20,0,1,23,13,"win_A",5,-3,7,1,0,0,0,0,1,0.952380952380952,0.821428571428571,0.619047619047619,0,"southpaw"
"160958",23,20,180,173,185,173,170,168,11,7,0,9,10,5,"win_A",3,7,12,2,0,0,0,0,1,0.4375,0.909090909090909,0.3125,0,"southpaw"
"161018",23,24,175,168,183,170,129,130,47,25,7,2,16,10,"win_B",-1,7,13,-1,0,0,0,0,0.87037037037037,0.925925925925926,0.296296296296296,0.37037037037037,1,"orthodox"
"161169",25,27,178,175,188,185,153,153,29,36,1,0,20,18,"win_A",-2,3,3,0,0,0,0,0,0.966666666666667,1,0.666666666666667,0.5,0,"orthodox"
"161173",23,25,178,178,188,185,146,147,24,28,0,5,15,9,"win_A",-2,0,3,-1,0,0,0,0,1,0.848484848484849,0.625,0.272727272727273,0,"orthodox"
"161174",23,27,178,179,188,188,147,147,23,45,0,3,14,28,"win_A",-4,-1,0,0,0,0,0,0,1,0.9375,0.608695652173913,0.583333333333333,0,"orthodox"
"161175",23,25,178,173,188,175,151,153,22,30,0,4,13,21,"win_A",-2,5,13,-2,0,0,0,0,1,0.882352941176471,0.590909090909091,0.617647058823529,0,"orthodox"
"161176",23,24,178,180,188,193,153,160,21,49,0,14,13,30,"win_A",-1,-2,-5,-7,0,0,0,0,1,0.777777777777778,0.619047619047619,0.476190476190476,0,"orthodox"
"161181",22,31,178,168,188,174,149,151,16,44,0,13,9,30,"win_A",-9,10,14,-2,0,0,0,0,1,0.771929824561403,0.5625,0.526315789473684,0,"orthodox"
"161215",34,51,166,165,170,173,139,137,137,13,18,3,93,4,"win_A",-17,1,-3,2,0,1,0,0,0.883870967741936,0.8125,0.6,0.25,0,"orthodox"
"161231",32,26,166,173,170,173,144,143,123,51,15,26,85,35,"win_A",6,-7,-3,1,0,0,0,0,0.891304347826087,0.662337662337662,0.615942028985507,0.454545454545455,0,"orthodox"
"161238",32,28,166,170,170,170,143,145,116,115,15,32,80,55,"win_A",4,-4,0,-2,0,0,0,0,0.885496183206107,0.782312925170068,0.610687022900763,0.374149659863946,0,"orthodox"
"161254",29,29,166,168,170,168,140,146,103,84,12,54,68,40,"win_A",0,-2,2,-6,0,0,0,0,0.895652173913044,0.608695652173913,0.591304347826087,0.289855072463768,0,"orthodox"
"161263",29,28,166,168,170,168,134,147,95,77,11,47,62,36,"win_A",1,-2,2,-13,0,0,0,0,0.89622641509434,0.620967741935484,0.584905660377358,0.290322580645161,0,"orthodox"
"161283",27,30,166,160,170,160,124,126,75,105,11,22,47,25,"win_A",-3,6,10,-2,0,0,0,0,0.872093023255814,0.826771653543307,0.546511627906977,0.196850393700787,0,"orthodox"
"161291",27,33,166,156,170,163,130,134,67,187,11,38,39,70,"win_A",-6,10,7,-4,0,0,0,0,0.858974358974359,0.831111111111111,0.5,0.311111111111111,0,"orthodox"
"161312",26,19,166,165,170,168,128,128,47,44,10,9,22,14,"win_A",7,1,2,0,0,0,0,0,0.824561403508772,0.830188679245283,0.385964912280702,0.264150943396226,0,"orthodox"
"161332",25,21,166,164,170,174,129,130,32,65,5,9,15,14,"win_B",4,2,-4,-1,0,0,0,0,0.864864864864865,0.878378378378378,0.405405405405405,0.189189189189189,1,"orthodox"
"161370",52,35,190,182,206,198,254,334,68,65,6,2,44,50,"win_A",17,8,8,-80,1,1,0,1,0.918918918918919,0.970149253731343,0.594594594594595,0.746268656716418,0,"orthodox"
"161371",51,49,190,185,206,198,255,234,67,41,6,17,43,28,"win_A",2,5,8,21,1,1,1,0,0.917808219178082,0.706896551724138,0.589041095890411,0.482758620689655,0,"orthodox"
"161372",49,46,190,193,206,208,250,275,66,44,6,16,42,32,"win_A",3,-3,-2,-25,1,1,0,1,0.916666666666667,0.733333333333333,0.583333333333333,0.533333333333333,0,"orthodox"
"161373",47,21,190,193,206,203,248,205,65,9,6,8,42,5,"win_A",26,-3,3,43,1,0,1,0,0.915492957746479,0.529411764705882,0.591549295774648,0.294117647058824,0,"orthodox"
"161374",31,47,191,190,196,206,247,248,31,65,0,5,19,42,"win_A",-16,1,-10,-1,0,1,0,0,1,0.928571428571429,0.612903225806452,0.6,0,"orthodox"
"161375",46,27,190,185,206,191,240,226,64,15,5,4,41,11,"win_A",19,5,15,14,1,0,0,0,0.927536231884058,0.789473684210526,0.594202898550725,0.578947368421053,0,"orthodox"
"161379",29,45,188,190,208,206,236,231,25,61,5,4,18,40,"win_A",-16,-2,2,5,0,1,0,0,0.833333333333333,0.938461538461538,0.6,0.615384615384615,0,"orthodox"
"161382",43,30,190,195,206,203,243,237,58,32,4,9,40,23,"win_A",13,-5,3,6,1,0,0,0,0.935483870967742,0.780487804878049,0.645161290322581,0.560975609756098,0,"orthodox"
"161383",43,35,190,180,206,191,232,212,57,31,4,2,39,7,"win_A",8,10,15,20,1,1,1,0,0.934426229508197,0.939393939393939,0.639344262295082,0.212121212121212,0,"orthodox"
"161385",43,28,190,191,206,208,234,240,55,16,4,6,37,15,"win_A",15,-1,-2,-6,1,0,0,0,0.932203389830508,0.727272727272727,0.627118644067797,0.681818181818182,0,"orthodox"
"161386",43,28,190,182,206,183,238,234,54,18,4,15,37,8,"win_A",15,8,23,4,1,0,0,0,0.931034482758621,0.545454545454545,0.637931034482759,0.242424242424242,0,"orthodox"
"161394",36,29,190,189,206,193,223,205,48,28,1,0,34,19,"win_B",7,1,13,18,1,0,1,0,0.979591836734694,1,0.693877551020408,0.678571428571429,1,"orthodox"
"161399",34,23,190,184,206,193,219,200,44,10,0,0,31,6,"win_A",11,6,13,19,0,0,1,0,1,1,0.704545454545455,0.6,0,"orthodox"
"161411",29,34,190,183,206,201,210,211,31,59,0,7,22,57,"win_A",-5,7,5,-1,0,0,0,0,1,0.893939393939394,0.709677419354839,0.863636363636364,0,"orthodox"
"161412",29,28,190,185,206,198,215,202,30,19,0,8,21,13,"win_A",1,5,8,13,0,0,0,0,1,0.703703703703704,0.7,0.481481481481481,0,"orthodox"
"161413",29,23,190,182,206,188,214,207,29,13,0,0,20,9,"win_A",6,8,18,7,0,0,0,0,1,1,0.689655172413793,0.692307692307692,0,"orthodox"
"161415",28,34,190,191,206,203,209,220,27,40,0,4,19,32,"win_A",-6,-1,3,-11,0,0,0,0,1,0.909090909090909,0.703703703703704,0.727272727272727,0,"orthodox"
"161416",28,32,190,183,206,201,210,210,26,54,0,6,19,52,"win_A",-4,7,5,0,0,0,0,0,1,0.9,0.730769230769231,0.866666666666667,0,"orthodox"
"161512",22,24,180,173,185,180,156,163,30,97,11,18,8,11,"win_B",-2,7,5,-7,0,0,0,0,0.731707317073171,0.843478260869565,0.195121951219512,0.0956521739130435,1,"Unknown"
"161513",19,24,179,173,182,180,155,164,44,97,9,17,6,11,"win_A",-5,6,2,-9,0,0,0,0,0.830188679245283,0.850877192982456,0.113207547169811,0.0964912280701754,0,"orthodox"
"161514",19,24,179,173,182,180,155,164,43,97,9,16,6,11,"win_A",-5,6,2,-9,0,0,0,0,0.826923076923077,0.858407079646018,0.115384615384615,0.0973451327433628,0,"orthodox"
"161770",36,30,173,175,183,180,146,147,43,31,0,1,26,18,"win_A",6,-2,3,-1,1,0,0,0,1,0.96875,0.604651162790698,0.5625,0,"orthodox"
"161771",35,31,173,170,183,170,151,154,42,37,0,2,26,30,"win_A",4,3,13,-3,1,0,0,0,1,0.948717948717949,0.619047619047619,0.769230769230769,0,"orthodox"
"161772",33,38,173,174,183,180,146,147,40,46,0,5,25,39,"win_A",-5,-1,3,-1,0,1,0,0,1,0.901960784313726,0.625,0.764705882352941,0,"orthodox"
"161773",32,36,173,170,183,170,146,142,39,50,0,4,25,37,"win_A",-4,3,13,4,0,1,0,0,1,0.925925925925926,0.641025641025641,0.685185185185185,0,"orthodox"
"161774",30,29,173,171,183,165,147,145,38,43,0,0,24,31,"win_A",1,2,18,2,0,0,0,0,1,1,0.631578947368421,0.720930232558139,0,"orthodox"
"161775",30,34,173,179,183,185,150,154,37,38,0,4,24,30,"win_A",-4,-6,-2,-4,0,0,0,0,1,0.904761904761905,0.648648648648649,0.714285714285714,0,"orthodox"
"161776",35,29,170,173,173,183,146,147,43,36,9,0,13,24,"win_B",6,-3,-10,-1,1,0,0,0,0.826923076923077,1,0.25,0.666666666666667,1,"orthodox"
"161778",33,28,171,173,178,183,139,140,39,33,6,0,30,22,"win_B",5,-2,-5,-1,0,0,0,0,0.866666666666667,1,0.666666666666667,0.666666666666667,1,"orthodox"
"161782",25,28,173,171,183,175,134,135,28,46,0,5,20,42,"win_A",-3,2,8,-1,0,0,0,0,1,0.901960784313726,0.714285714285714,0.823529411764706,0,"orthodox"
"161786",23,23,173,179,183,178,130,130,24,33,0,0,18,27,"win_A",0,-6,5,0,0,0,0,0,1,1,0.75,0.818181818181818,0,"orthodox"
"161787",23,25,173,170,183,173,134,134,23,22,0,16,17,10,"win_A",-2,3,10,0,0,0,0,0,1,0.578947368421053,0.739130434782609,0.263157894736842,0,"orthodox"
"161788",23,29,173,167,183,171,130,130,22,40,0,6,17,28,"win_A",-6,6,12,0,0,0,0,0,1,0.869565217391304,0.772727272727273,0.608695652173913,0,"orthodox"
"161789",22,28,173,175,183,178,130,130,21,34,0,2,16,28,"win_A",-6,-2,5,0,0,0,0,0,1,0.944444444444444,0.761904761904762,0.777777777777778,0,"orthodox"
"161790",26,22,171,173,183,183,130,130,33,20,2,0,25,15,"win_B",4,-2,0,0,0,0,0,0,0.942857142857143,1,0.714285714285714,0.75,1,"orthodox"
"161791",21,27,173,163,183,165,130,129,19,44,0,2,15,30,"win_A",-6,10,18,1,0,0,0,0,1,0.956521739130435,0.789473684210526,0.652173913043478,0,"orthodox"
"161792",21,24,173,168,183,180,130,130,18,25,0,2,14,20,"win_A",-3,5,3,0,0,0,0,0,1,0.925925925925926,0.777777777777778,0.740740740740741,0,"orthodox"
"161793",21,32,173,180,183,183,130,130,17,38,0,1,13,17,"win_A",-11,-7,0,0,0,0,0,0,1,0.974358974358974,0.764705882352941,0.435897435897436,0,"orthodox"
"161797",21,25,173,170,183,173,130,132,13,17,0,4,11,9,"win_A",-4,3,10,-2,0,0,0,0,1,0.80952380952381,0.846153846153846,0.428571428571429,0,"orthodox"
"161801",20,24,173,174,183,175,131,132,9,18,0,3,7,14,"win_A",-4,-1,8,-1,0,0,0,0,1,0.857142857142857,0.777777777777778,0.666666666666667,0,"orthodox"
"161805",20,28,173,173,183,173,132,133,5,19,0,8,4,5,"win_A",-8,0,10,-1,0,0,0,0,1,0.703703703703704,0.8,0.185185185185185,0,"orthodox"
"161806",20,33,173,166,183,173,132,130,4,9,0,9,3,2,"win_A",-13,7,10,2,0,0,0,0,1,0.5,0.75,0.111111111111111,0,"orthodox"
"161811",44,27,180,178,184,185,160,159,174,44,18,1,109,8,"win_B",17,2,-1,1,1,0,0,0,0.90625,0.977777777777778,0.567708333333333,0.177777777777778,1,"orthodox"
"161843",41,26,180,175,184,175,159,161,149,29,11,8,97,24,"win_B",15,5,9,-2,1,0,0,0,0.93125,0.783783783783784,0.60625,0.648648648648649,1,"orthodox"
"161888",29,22,180,179,184,178,158,159,114,41,1,3,74,23,"win_A",7,1,6,-1,0,0,0,0,0.991304347826087,0.931818181818182,0.643478260869565,0.522727272727273,0,"orthodox"
"161923",26,27,180,180,184,178,152,148,79,30,1,20,53,4,"win_A",-1,0,6,4,0,0,0,0,0.9875,0.6,0.6625,0.08,0,"orthodox"
"161940",24,31,180,171,184,178,147,143,62,78,1,22,42,13,"win_A",-7,9,6,4,0,0,0,0,0.984126984126984,0.78,0.666666666666667,0.13,0,"orthodox"
"161946",23,24,173,180,170,184,150,159,52,56,9,1,14,38,"win_B",-1,-7,-14,-9,0,0,0,0,0.852459016393443,0.982456140350877,0.229508196721311,0.666666666666667,1,"orthodox"
"161958",33,22,166,180,170,184,145,140,135,44,17,1,91,30,"win_B",11,-14,-14,5,0,0,0,0,0.888157894736842,0.977777777777778,0.598684210526316,0.666666666666667,1,"orthodox"
"162005",45,20,180,191,191,198,191,204,185,15,22,0,131,12,"win_B",25,-11,-7,-13,1,0,0,0,0.893719806763285,1,0.632850241545894,0.8,1,"orthodox"
"162007",45,25,180,192,191,185,197,211,183,19,22,2,129,15,"win_A",20,-12,6,-14,1,0,0,0,0.892682926829268,0.904761904761905,0.629268292682927,0.714285714285714,0,"orthodox"
"162008",44,32,180,187,191,196,198,192,182,13,22,5,128,7,"win_A",12,-7,-5,6,1,0,0,0,0.892156862745098,0.722222222222222,0.627450980392157,0.388888888888889,0,"orthodox"
"162029",40,22,180,185,191,191,175,172,162,31,21,4,117,24,"win_A",18,-5,0,3,1,0,0,0,0.885245901639344,0.885714285714286,0.639344262295082,0.685714285714286,0,"orthodox"
"162039",39,28,180,189,191,188,196,211,153,41,20,24,109,22,"win_A",11,-9,3,-15,1,0,0,1,0.884393063583815,0.630769230769231,0.630057803468208,0.338461538461538,0,"orthodox"
"162051",36,24,180,176,191,176,180,175,142,24,19,0,104,11,"win_A",12,4,15,5,1,0,0,0,0.881987577639752,1,0.645962732919255,0.458333333333333,0,"orthodox"
"162092",32,21,180,178,191,188,172,172,103,25,17,0,76,15,"win_A",11,2,3,0,0,0,0,0,0.858333333333333,1,0.633333333333333,0.6,0,"orthodox"
"162095",32,35,180,173,191,193,174,184,100,183,17,55,73,110,"win_A",-3,7,-2,-10,0,1,0,0,0.854700854700855,0.76890756302521,0.623931623931624,0.46218487394958,0,"orthodox"
"162097",32,35,180,173,191,193,175,184,98,183,17,53,71,110,"win_A",-3,7,-2,-9,0,1,0,0,0.852173913043478,0.775423728813559,0.617391304347826,0.466101694915254,0,"orthodox"
"162105",31,28,180,182,191,193,172,187,92,66,15,11,69,25,"win_A",3,-2,-2,-15,0,0,0,1,0.85981308411215,0.857142857142857,0.644859813084112,0.324675324675325,0,"orthodox"
"162112",30,27,180,182,191,193,174,184,87,60,13,10,65,23,"win_A",3,-2,-2,-10,0,0,0,0,0.87,0.857142857142857,0.65,0.328571428571429,0,"orthodox"
"162121",24,29,183,180,185,191,174,171,37,80,4,11,19,62,"win_A",-5,3,-6,3,0,0,0,0,0.902439024390244,0.879120879120879,0.463414634146341,0.681318681318681,0,"orthodox"
"162131",28,31,180,178,191,189,162,166,72,55,9,12,55,27,"win_A",-3,2,2,-4,0,0,0,0,0.888888888888889,0.82089552238806,0.679012345679012,0.402985074626866,0,"orthodox"
"162144",26,27,175,180,191,191,161,155,61,60,9,8,37,47,"win_A",-1,-5,0,6,0,0,0,0,0.871428571428571,0.882352941176471,0.528571428571429,0.691176470588235,0,"orthodox"
"162164",23,30,180,179,191,184,159,160,44,86,4,20,35,51,"win_A",-7,1,7,-1,0,0,0,0,0.916666666666667,0.811320754716981,0.729166666666667,0.481132075471698,0,"orthodox"
"162169",23,29,180,179,191,184,159,160,39,85,4,19,30,51,"win_A",-6,1,7,-1,0,0,0,0,0.906976744186046,0.817307692307692,0.697674418604651,0.490384615384615,0,"orthodox"
"162175",22,18,180,179,191,185,161,172,34,9,3,3,27,6,"win_A",4,1,6,-11,0,0,0,0,0.918918918918919,0.75,0.72972972972973,0.5,0,"orthodox"
"162185",21,28,180,177,191,180,161,165,25,115,2,27,19,73,"win_A",-7,3,11,-4,0,0,0,0,0.925925925925926,0.809859154929577,0.703703703703704,0.514084507042254,0,"orthodox"
"162188",21,28,180,177,191,180,160,164,23,112,1,26,18,71,"win_B",-7,3,11,-4,0,0,0,0,0.958333333333333,0.811594202898551,0.75,0.514492753623188,1,"orthodox"
"162217",26,43,189,185,191,191,170,169,34,48,0,5,30,32,"win_B",-17,4,0,1,0,1,0,0,1,0.905660377358491,0.882352941176471,0.60377358490566,1,"orthodox"
"162218",43,36,185,180,191,185,173,173,48,44,4,0,32,32,"win_B",7,5,6,0,1,1,0,0,0.923076923076923,1,0.615384615384615,0.727272727272727,1,"orthodox"
"162219",42,35,185,179,191,183,170,170,47,51,4,3,32,25,"win_A",7,6,8,0,1,1,0,0,0.92156862745098,0.944444444444444,0.627450980392157,0.462962962962963,0,"orthodox"
"162220",37,41,188,185,191,191,174,174,24,46,3,4,18,32,"win_B",-4,3,0,0,1,1,0,0,0.888888888888889,0.92,0.666666666666667,0.64,1,"southpaw"
"162221",27,40,180,185,189,191,160,159,24,46,0,3,17,32,"win_A",-13,-5,-2,1,0,1,0,0,1,0.938775510204082,0.708333333333333,0.653061224489796,0,"orthodox"
"162222",40,26,185,180,191,189,160,160,46,23,2,0,32,17,"win_B",14,5,2,0,1,0,0,0,0.958333333333333,1,0.666666666666667,0.739130434782609,1,"orthodox"
"162224",39,31,185,179,191,185,156,155,44,37,2,3,31,29,"win_A",8,6,6,1,1,0,0,0,0.956521739130435,0.925,0.673913043478261,0.725,0,"orthodox"
"162225",39,34,185,177,191,185,159,160,43,36,2,4,31,27,"win_A",5,8,6,-1,1,0,0,0,0.955555555555556,0.9,0.688888888888889,0.675,0,"orthodox"
"162226",38,33,185,175,191,184,160,159,42,34,2,2,31,25,"win_A",5,10,7,1,1,0,0,0,0.954545454545455,0.944444444444444,0.704545454545455,0.694444444444444,0,"orthodox"
"162234",29,34,177,185,185,191,159,159,23,34,2,2,18,26,"win_B",-5,-8,-6,0,0,0,0,0,0.92,0.944444444444444,0.72,0.722222222222222,1,"southpaw"
"162235",34,33,177,185,180,191,160,160,47,33,6,2,34,25,"win_B",1,-8,-11,0,0,0,0,0,0.886792452830189,0.942857142857143,0.641509433962264,0.714285714285714,1,"orthodox"
"162236",30,32,177,185,185,191,160,160,27,32,5,2,19,25,"win_B",-2,-8,-6,0,0,0,0,0,0.84375,0.941176470588235,0.59375,0.735294117647059,1,"Unknown"
"162242",30,28,185,188,191,188,158,160,26,18,2,2,19,11,"win_A",2,-3,3,-2,0,0,0,0,0.928571428571429,0.9,0.678571428571429,0.55,0,"orthodox"
"162247",28,29,185,172,191,178,158,160,21,26,1,14,16,11,"win_A",-1,13,13,-2,0,0,0,0,0.954545454545455,0.65,0.727272727272727,0.275,0,"orthodox"
"162272",36,25,191,185,198,193,221,201,55,7,3,0,37,5,"win_A",11,6,5,20,1,0,1,0,0.948275862068966,1,0.637931034482759,0.714285714285714,0,"orthodox"
"162285",30,32,182,191,185,198,212,209,30,43,1,2,25,31,"win_B",-2,-9,-13,3,0,0,0,0,0.967741935483871,0.955555555555556,0.806451612903226,0.688888888888889,1,"orthodox"
"162287",31,30,191,191,198,203,212,205,41,30,2,1,31,23,"win_A",1,0,-5,7,0,0,0,0,0.953488372093023,0.967741935483871,0.720930232558139,0.741935483870968,0,"orthodox"
"162288",31,29,191,191,198,203,221,210,41,29,1,1,31,23,"win_B",2,0,-5,11,0,0,0,0,0.976190476190476,0.966666666666667,0.738095238095238,0.766666666666667,1,"orthodox"
"162297",29,28,191,191,198,193,227,256,32,29,1,2,26,20,"win_A",1,0,5,-29,0,0,0,1,0.96969696969697,0.935483870967742,0.787878787878788,0.645161290322581,0,"orthodox"
"162300",28,28,191,179,198,185,212,204,30,46,0,6,24,37,"win_A",0,12,13,8,0,0,0,0,1,0.884615384615385,0.8,0.711538461538462,0,"orthodox"
"162315",20,25,191,192,198,185,199,208,14,19,0,3,11,15,"win_A",-5,-1,13,-9,0,0,0,0,1,0.863636363636364,0.785714285714286,0.681818181818182,0,"orthodox"
"162331",37,31,188,182,193,193,203,180,65,78,2,20,52,28,"win_A",6,6,0,23,1,0,1,0,0.970149253731343,0.795918367346939,0.776119402985075,0.285714285714286,0,"orthodox"
"162343",28,32,187,188,184,193,207,182,62,54,10,1,13,46,"win_B",-4,-1,-9,25,0,0,1,0,0.861111111111111,0.981818181818182,0.180555555555556,0.836363636363636,1,"orthodox"
"162357",25,27,188,184,193,188,203,202,40,54,1,9,34,31,"win_A",-2,4,5,1,0,0,0,0,0.975609756097561,0.857142857142857,0.829268292682927,0.492063492063492,0,"orthodox"
"162374",22,30,188,185,193,193,198,192,24,48,0,7,20,33,"win_B",-8,3,0,6,0,0,0,0,1,0.872727272727273,0.833333333333333,0.6,1,"orthodox"
"162377",21,26,188,189,193,206,198,210,21,40,0,8,17,30,"win_A",-5,-1,-13,-12,0,0,0,0,1,0.833333333333333,0.80952380952381,0.625,0,"orthodox"
"162386",20,22,188,187,193,222,195,187,12,49,0,13,10,15,"win_A",-2,1,-29,8,0,0,0,0,1,0.790322580645161,0.833333333333333,0.241935483870968,0,"orthodox"
"162400",42,34,171,175,169,178,143,143,106,32,5,9,86,12,"win_A",8,-4,-9,0,1,0,0,0,0.954954954954955,0.780487804878049,0.774774774774775,0.292682926829268,0,"orthodox"
"162402",41,36,171,177,169,170,150,154,104,26,5,10,85,7,"win_A",5,-6,-1,-4,1,1,0,0,0.954128440366973,0.722222222222222,0.779816513761468,0.194444444444444,0,"orthodox"
"162405",37,34,171,175,169,173,147,147,102,181,4,13,83,121,"win_A",3,-4,-4,0,1,0,0,0,0.962264150943396,0.93298969072165,0.783018867924528,0.623711340206186,0,"orthodox"
"162411",34,31,171,179,169,173,148,146,98,22,2,6,80,11,"win_A",3,-8,-4,2,0,0,0,0,0.98,0.785714285714286,0.8,0.392857142857143,0,"orthodox"
"162412",34,36,171,177,169,175,151,149,97,34,2,5,80,12,"win_A",-2,-6,-6,2,0,1,0,0,0.97979797979798,0.871794871794872,0.808080808080808,0.307692307692308,0,"orthodox"
"162414",23,33,179,171,185,169,139,139,21,96,0,1,19,79,"win_A",-10,8,16,0,0,0,0,0,1,0.989690721649485,0.904761904761905,0.814432989690722,0,"orthodox"
"162415",33,26,171,184,169,192,144,144,95,21,1,3,78,12,"win_A",7,-13,-23,0,0,0,0,0,0.989583333333333,0.875,0.8125,0.5,0,"orthodox"
"162416",33,30,171,180,169,175,140,140,94,26,1,0,78,20,"win_A",3,-9,-6,0,0,0,0,0,0.989473684210526,1,0.821052631578947,0.769230769230769,0,"orthodox"
"162419",32,31,171,168,169,183,140,139,91,45,1,4,76,32,"win_A",1,3,-14,1,0,0,0,0,0.989130434782609,0.918367346938776,0.826086956521739,0.653061224489796,0,"orthodox"
"162420",27,32,171,171,168,169,140,140,32,90,3,1,18,75,"win_B",-5,0,-1,0,0,0,0,0,0.914285714285714,0.989010989010989,0.514285714285714,0.824175824175824,1,"orthodox"
"162421",31,32,171,173,169,173,140,140,89,49,1,2,75,39,"win_A",-1,-2,-4,0,0,0,0,0,0.988888888888889,0.96078431372549,0.833333333333333,0.764705882352941,0,"orthodox"
"162422",31,32,171,173,169,173,140,140,89,48,0,2,75,39,"win_B",-1,-2,-4,0,0,0,0,0,1,0.96,0.842696629213483,0.78,1,"orthodox"
"162430",30,30,169,171,175,169,140,140,40,81,1,0,17,68,"win_B",0,-2,6,0,0,0,0,0,0.975609756097561,1,0.414634146341463,0.839506172839506,1,"southpaw"
"162437",28,27,171,173,169,175,145,142,74,23,0,3,62,14,"win_A",1,-2,-6,3,0,0,0,0,1,0.884615384615385,0.837837837837838,0.538461538461538,0,"orthodox"
"162450",26,29,171,169,169,163,135,134,61,101,0,6,50,82,"win_A",-3,2,6,1,0,0,0,0,1,0.94392523364486,0.819672131147541,0.766355140186916,0,"orthodox"
"162512",48,46,189,191,198,196,226,238,43,64,10,2,28,43,"win_A",2,-2,2,-12,1,1,0,0,0.811320754716981,0.96969696969697,0.528301886792453,0.651515151515151,0,"orthodox"
"162513",47,41,189,188,198,188,220,250,42,47,10,4,27,28,"win_A",6,1,10,-30,1,1,0,1,0.807692307692308,0.92156862745098,0.519230769230769,0.549019607843137,0,"orthodox"
"162516",44,41,189,195,198,203,219,242,41,46,8,6,27,38,"win_A",3,-6,-5,-23,1,1,0,1,0.836734693877551,0.884615384615385,0.551020408163265,0.730769230769231,0,"orthodox"
"162520",32,40,187,189,188,198,220,214,35,38,2,5,20,25,"win_A",-8,-2,-10,6,0,1,0,0,0.945945945945946,0.883720930232558,0.540540540540541,0.581395348837209,0,"southpaw"
"162521",39,29,189,189,198,208,216,224,37,35,5,3,25,29,"win_A",10,0,-10,-8,1,0,0,0,0.880952380952381,0.921052631578947,0.595238095238095,0.763157894736842,0,"orthodox"
"162522",29,38,188,189,198,198,217,227,36,37,4,4,27,25,"win_A",-9,-1,0,-10,0,1,0,0,0.9,0.902439024390244,0.675,0.609756097560976,0,"orthodox"
"162523",37,28,189,188,198,198,221,224,36,36,4,3,25,27,"win_A",9,1,0,-3,1,0,0,0,0.9,0.923076923076923,0.625,0.692307692307692,0,"orthodox"
"162524",34,37,196,189,213,198,217,242,34,36,1,3,27,25,"win_A",-3,7,15,-25,0,1,0,1,0.971428571428571,0.923076923076923,0.771428571428571,0.641025641025641,0,"orthodox"
"162525",24,35,180,189,193,198,217,231,31,35,1,3,25,25,"win_B",-11,-9,-5,-14,0,1,0,0,0.96875,0.921052631578947,0.78125,0.657894736842105,1,"orthodox"
"162526",29,35,188,189,198,198,214,223,39,34,1,3,31,24,"win_B",-6,-1,0,-9,0,1,0,0,0.975,0.918918918918919,0.775,0.648648648648649,1,"southpaw"
"162527",30,34,178,189,180,198,218,218,45,33,2,3,39,24,"win_B",-4,-11,-18,0,0,0,0,0,0.957446808510638,0.916666666666667,0.829787234042553,0.666666666666667,1,"orthodox"
"162528",30,34,178,189,180,198,215,222,45,32,1,3,39,23,"win_B",-4,-11,-18,-7,0,0,0,0,0.978260869565217,0.914285714285714,0.847826086956522,0.657142857142857,1,"orthodox"
"162530",27,33,196,189,206,198,213,240,37,31,1,2,31,22,"win_A",-6,7,8,-27,0,0,0,1,0.973684210526316,0.939393939393939,0.815789473684211,0.666666666666667,0,"orthodox"
"162531",34,32,185,189,196,198,209,224,23,30,2,2,16,22,"win_B",2,-4,-2,-15,0,0,0,1,0.92,0.9375,0.64,0.6875,1,"orthodox"
"162532",26,31,188,189,198,198,214,214,34,30,0,1,30,22,"win_A",-5,-1,0,0,0,0,0,0,1,0.967741935483871,0.882352941176471,0.709677419354839,0,"southpaw"
"162533",25,31,196,189,206,198,217,246,34,29,0,1,29,22,"win_B",-6,7,8,-29,0,0,0,1,1,0.966666666666667,0.852941176470588,0.733333333333333,1,"orthodox"
"162534",30,28,189,191,198,199,212,228,28,32,1,4,22,32,"win_A",2,-2,-1,-16,0,0,0,1,0.96551724137931,0.888888888888889,0.758620689655172,0.888888888888889,0,"orthodox"
"162535",24,30,196,189,206,198,205,235,31,28,0,0,27,22,"win_A",-6,7,8,-30,0,0,0,1,1,1,0.870967741935484,0.785714285714286,0,"orthodox"
"162536",42,29,190,189,206,198,210,233,54,27,3,0,37,22,"win_B",13,1,8,-23,1,0,0,1,0.947368421052632,1,0.649122807017544,0.814814814814815,1,"orthodox"
"162537",29,25,189,181,198,199,210,215,26,26,0,7,21,23,"win_A",4,8,-1,-5,0,0,0,0,1,0.787878787878788,0.807692307692308,0.696969696969697,0,"orthodox"
"162538",28,42,189,192,198,199,208,257,25,69,0,2,21,65,"win_A",-14,-3,-1,-49,0,1,0,1,1,0.971830985915493,0.84,0.915492957746479,0,"orthodox"
"162539",30,28,192,189,211,198,208,246,30,24,4,0,20,20,"win_B",2,3,13,-38,0,0,0,1,0.882352941176471,1,0.588235294117647,0.833333333333333,1,"orthodox"
"162541",25,27,191,189,199,198,212,213,24,22,0,0,24,18,"win_B",-2,2,1,-1,0,0,0,0,1,1,1,0.818181818181818,1,"orthodox"
"162542",26,31,189,186,198,183,207,221,21,35,0,2,17,26,"win_A",-5,3,15,-14,0,0,0,0,1,0.945945945945946,0.80952380952381,0.702702702702703,0,"orthodox"
"162543",26,30,189,191,198,198,208,225,20,37,0,1,16,23,"win_A",-4,-2,0,-17,0,0,0,1,1,0.973684210526316,0.8,0.605263157894737,0,"orthodox"
"162544",26,30,189,191,198,196,210,222,19,29,0,2,15,24,"win_A",-4,-2,2,-12,0,0,0,0,1,0.935483870967742,0.789473684210526,0.774193548387097,0,"orthodox"
"162545",25,31,189,185,198,203,202,210,18,38,0,13,14,29,"win_A",-6,4,-5,-8,0,0,0,0,1,0.745098039215686,0.777777777777778,0.568627450980392,0,"orthodox"
"162547",34,25,170,189,180,198,187,190,28,16,4,0,17,12,"win_B",9,-19,-18,-3,0,0,0,0,0.875,1,0.53125,0.75,1,"orthodox"
"162548",24,32,189,182,198,188,189,190,15,21,0,4,11,11,"win_A",-8,7,10,-1,0,0,0,0,1,0.84,0.733333333333333,0.44,0,"orthodox"
"162612",29,38,188,171,193,188,190,208,73,173,7,34,43,98,"win_A",-9,17,5,-18,0,1,0,1,0.9125,0.835748792270531,0.5375,0.473429951690821,0,"orthodox"
"162634",37,24,171,198,188,206,191,230,156,18,29,20,89,12,"win_B",13,-27,-18,-39,1,0,0,1,0.843243243243243,0.473684210526316,0.481081081081081,0.315789473684211,1,"orthodox"
"162670",34,25,171,188,188,193,198,203,130,40,19,6,75,22,"win_B",9,-17,-5,-5,0,0,0,0,0.87248322147651,0.869565217391304,0.503355704697987,0.478260869565217,1,"orthodox"
"162672",34,38,171,178,188,188,198,196,128,110,19,21,74,69,"win_A",-4,-7,0,2,0,1,0,0,0.870748299319728,0.83969465648855,0.503401360544218,0.526717557251908,0,"orthodox"
"162673",34,27,171,196,188,207,206,211,127,11,19,9,73,7,"win_A",7,-25,-19,-5,0,0,0,0,0.86986301369863,0.55,0.5,0.35,0,"orthodox"
"162683",33,36,171,178,188,188,198,198,120,103,16,20,70,64,"win_A",-3,-7,0,0,0,1,0,0,0.882352941176471,0.83739837398374,0.514705882352941,0.520325203252033,0,"orthodox"
"162684",23,33,188,171,193,188,204,215,30,120,5,15,19,70,"win_A",-10,17,5,-11,0,0,0,0,0.857142857142857,0.888888888888889,0.542857142857143,0.518518518518518,0,"orthodox"
"162685",31,33,179,171,191,188,202,220,66,119,12,15,54,70,"win_B",-2,8,3,-18,0,0,0,1,0.846153846153846,0.888059701492537,0.692307692307692,0.522388059701492,1,"orthodox"
"162686",33,29,171,180,188,201,190,176,118,114,15,8,69,64,"win_A",4,-9,-13,14,0,0,0,0,0.887218045112782,0.934426229508197,0.518796992481203,0.524590163934426,0,"orthodox"
"162688",23,33,188,171,193,188,195,204,28,117,5,14,19,68,"win_A",-10,17,5,-9,0,0,0,0,0.848484848484849,0.893129770992366,0.575757575757576,0.519083969465649,0,"orthodox"
"162690",32,31,171,179,188,191,193,212,115,66,14,11,68,54,"win_A",1,-8,-3,-19,0,0,0,1,0.891472868217054,0.857142857142857,0.527131782945736,0.701298701298701,0,"orthodox"
"162692",23,32,188,171,193,188,190,210,27,114,4,13,19,67,"win_A",-9,17,5,-20,0,0,0,1,0.870967741935484,0.897637795275591,0.612903225806452,0.52755905511811,0,"orthodox"
"162693",23,32,188,171,193,188,195,205,26,114,4,12,19,67,"win_A",-9,17,5,-10,0,0,0,0,0.866666666666667,0.904761904761905,0.633333333333333,0.531746031746032,0,"orthodox"
"162700",31,22,171,188,188,193,190,210,109,23,10,1,65,19,"win_A",9,-17,-5,-20,0,0,0,1,0.915966386554622,0.958333333333333,0.546218487394958,0.791666666666667,0,"orthodox"
"162721",29,28,171,179,188,191,168,205,90,54,8,8,50,49,"win_A",1,-8,-3,-37,0,0,0,1,0.918367346938776,0.870967741935484,0.510204081632653,0.790322580645161,0,"orthodox"
"162727",27,28,179,171,191,188,170,198,52,85,6,7,49,48,"win_A",-1,8,3,-28,0,0,0,1,0.896551724137931,0.923913043478261,0.844827586206897,0.521739130434783,0,"orthodox"
"162729",28,32,171,178,188,188,178,195,83,39,7,15,47,25,"win_A",-4,-7,0,-17,0,0,0,1,0.922222222222222,0.722222222222222,0.522222222222222,0.462962962962963,0,"orthodox"
"162736",27,27,171,185,188,194,165,196,76,22,7,8,42,19,"win_A",0,-14,-6,-31,0,0,0,1,0.91566265060241,0.733333333333333,0.506024096385542,0.633333333333333,0,"orthodox"
"162741",27,31,171,178,188,188,170,190,71,32,7,13,39,21,"win_A",-4,-7,0,-20,0,0,0,1,0.91025641025641,0.711111111111111,0.5,0.466666666666667,0,"orthodox"
"162759",25,28,171,179,188,175,160,175,54,37,6,11,27,24,"win_A",-3,-8,13,-15,0,0,0,1,0.9,0.770833333333333,0.45,0.5,0,"orthodox"
"162780",28,23,184,171,188,188,156,185,37,35,5,4,16,18,"win_A",5,13,0,-29,0,0,0,1,0.880952380952381,0.897435897435897,0.380952380952381,0.461538461538462,0,"orthodox"
"162788",22,27,171,169,188,178,155,160,29,72,2,21,16,51,"win_A",-5,2,10,-5,0,0,0,0,0.935483870967742,0.774193548387097,0.516129032258065,0.548387096774194,0,"orthodox"
"162830",32,33,188,180,193,178,213,185,82,33,7,20,51,12,"win_A",-1,8,15,28,0,0,1,0,0.921348314606742,0.622641509433962,0.573033707865168,0.226415094339623,0,"orthodox"
"162836",30,36,188,180,193,201,215,177,76,128,7,39,45,70,"win_A",-6,8,-8,38,0,1,1,0,0.91566265060241,0.766467065868264,0.542168674698795,0.419161676646707,0,"orthodox"
"162837",30,36,188,180,193,201,211,193,75,128,7,38,44,70,"win_A",-6,8,-8,18,0,1,1,0,0.914634146341463,0.771084337349398,0.536585365853659,0.421686746987952,0,"orthodox"
"162840",29,25,188,198,193,206,216,236,72,20,6,23,43,12,"win_A",4,-10,-13,-20,0,0,0,1,0.923076923076923,0.465116279069767,0.551282051282051,0.27906976744186,0,"orthodox"
"162841",29,40,188,192,193,204,210,212,71,26,6,8,42,16,"win_A",-11,-4,-11,-2,0,1,0,0,0.922077922077922,0.764705882352941,0.545454545454545,0.470588235294118,0,"orthodox"
"162844",29,25,188,198,193,206,214,243,68,19,6,22,39,12,"win_A",4,-10,-13,-29,0,0,0,1,0.918918918918919,0.463414634146341,0.527027027027027,0.292682926829268,0,"orthodox"
"162850",28,25,188,198,193,206,210,230,62,19,6,21,34,12,"win_A",3,-10,-13,-20,0,0,0,1,0.911764705882353,0.475,0.5,0.3,0,"orthodox"
"162852",28,29,188,194,193,215,204,210,60,61,6,7,32,48,"win_A",-1,-6,-22,-6,0,0,0,0,0.909090909090909,0.897058823529412,0.484848484848485,0.705882352941177,0,"orthodox"
"162858",27,40,188,178,193,188,209,204,52,118,6,24,28,69,"win_A",-13,10,5,5,0,1,0,0,0.896551724137931,0.830985915492958,0.482758620689655,0.485915492957746,0,"orthodox"
"162878",31,23,179,188,191,193,208,219,61,24,10,3,53,19,"win_A",8,-9,-2,-11,0,0,0,0,0.859154929577465,0.888888888888889,0.746478873239437,0.703703703703704,0,"orthodox"
"162880",30,22,179,188,191,193,206,217,59,23,10,2,53,19,"win_A",8,-9,-2,-11,0,0,0,0,0.855072463768116,0.92,0.768115942028985,0.76,0,"orthodox"
"162909",31,25,173,187,180,193,164,172,258,52,15,8,48,20,"win_A",6,-14,-13,-8,0,0,0,0,0.945054945054945,0.866666666666667,0.175824175824176,0.333333333333333,0,"orthodox"
"162923",31,18,173,179,180,182,166,164,244,33,15,3,44,4,"win_A",13,-6,-2,2,0,0,0,0,0.942084942084942,0.916666666666667,0.16988416988417,0.111111111111111,0,"orthodox"
"162924",31,23,173,170,180,170,159,152,243,71,15,12,44,31,"win_A",8,3,10,7,0,0,0,0,0.941860465116279,0.855421686746988,0.170542635658915,0.373493975903614,0,"orthodox"
"162940",30,24,173,187,180,193,169,173,228,45,14,4,41,16,"win_A",6,-14,-13,-4,0,0,0,0,0.942148760330578,0.918367346938776,0.169421487603306,0.326530612244898,0,"orthodox"
"162960",29,20,173,182,180,185,168,166,211,39,11,9,36,8,"win_B",9,-9,-5,2,0,0,0,0,0.95045045045045,0.8125,0.162162162162162,0.166666666666667,1,"orthodox"
"162962",29,30,173,175,180,183,158,158,209,55,11,21,36,25,"win_A",-1,-2,-3,0,0,0,0,0,0.95,0.723684210526316,0.163636363636364,0.328947368421053,0,"orthodox"
"162967",28,20,173,182,180,185,166,166,205,36,10,6,35,7,"win_A",8,-9,-5,0,0,0,0,0,0.953488372093023,0.857142857142857,0.162790697674419,0.166666666666667,0,"orthodox"
"162970",28,28,173,180,180,196,164,188,202,35,10,29,35,16,"win_A",0,-7,-16,-24,0,0,0,1,0.952830188679245,0.546875,0.165094339622642,0.25,0,"orthodox"
"162971",28,28,173,180,180,196,168,180,201,35,10,28,35,16,"win_A",0,-7,-16,-12,0,0,0,0,0.95260663507109,0.555555555555556,0.165876777251185,0.253968253968254,0,"orthodox"
"162976",28,28,173,180,180,191,165,181,196,22,10,27,33,14,"win_A",0,-7,-11,-16,0,0,0,1,0.951456310679612,0.448979591836735,0.160194174757282,0.285714285714286,0,"orthodox"
"162980",27,30,173,174,180,180,164,163,192,95,10,26,32,35,"win_A",-3,-1,0,1,0,0,0,0,0.95049504950495,0.785123966942149,0.158415841584158,0.289256198347107,0,"orthodox"
"162981",27,27,173,180,180,191,163,179,191,21,10,26,32,14,"win_A",0,-7,-11,-16,0,0,0,1,0.950248756218905,0.446808510638298,0.159203980099502,0.297872340425532,0,"orthodox"
"163019",25,29,173,184,180,188,165,166,154,49,9,0,26,10,"win_B",-4,-11,-8,-1,0,0,0,0,0.94478527607362,1,0.159509202453988,0.204081632653061,1,"orthodox"
"163028",25,23,173,178,180,183,166,159,145,31,9,17,26,4,"win_A",2,-5,-3,7,0,0,0,0,0.941558441558442,0.645833333333333,0.168831168831169,0.0833333333333333,0,"orthodox"
"163045",25,31,173,175,180,183,159,155,128,88,9,6,25,30,"win_A",-6,-2,-3,4,0,0,0,0,0.934306569343066,0.936170212765957,0.182481751824818,0.319148936170213,0,"orthodox"
"163050",24,28,173,180,180,178,163,175,123,20,9,9,23,10,"win_A",-4,-7,2,-12,0,0,0,0,0.931818181818182,0.689655172413793,0.174242424242424,0.344827586206897,0,"orthodox"
"163053",24,27,173,180,180,178,170,180,120,147,9,33,23,22,"win_A",-3,-7,2,-10,0,0,0,0,0.930232558139535,0.816666666666667,0.178294573643411,0.122222222222222,0,"orthodox"
"163072",24,24,173,184,180,193,150,174,101,45,9,6,21,18,"win_A",0,-11,-13,-24,0,0,0,1,0.918181818181818,0.882352941176471,0.190909090909091,0.352941176470588,0,"orthodox"
"163084",23,25,173,175,180,183,160,158,89,44,9,16,21,17,"win_A",-2,-2,-3,2,0,0,0,0,0.908163265306122,0.733333333333333,0.214285714285714,0.283333333333333,0,"orthodox"
"163108",23,26,173,180,180,178,162,177,66,137,8,27,14,22,"win_A",-3,-7,2,-15,0,0,0,1,0.891891891891892,0.835365853658537,0.189189189189189,0.134146341463415,0,"orthodox"
"163120",22,27,173,179,180,197,157,160,54,23,8,15,8,9,"win_A",-5,-6,-17,-3,0,0,0,0,0.870967741935484,0.605263157894737,0.129032258064516,0.236842105263158,0,"orthodox"
"163146",21,24,173,184,180,188,158,158,32,18,4,0,4,8,"win_B",-3,-11,-8,0,0,0,0,0,0.888888888888889,1,0.111111111111111,0.444444444444444,1,"orthodox"
"163183",35,31,179,171,185,173,150,150,38,33,5,5,30,9,"win_A",4,8,12,0,1,0,0,0,0.883720930232558,0.868421052631579,0.697674418604651,0.236842105263158,0,"orthodox"
"163185",31,25,179,181,185,185,160,160,36,20,3,0,29,9,"win_A",6,-2,0,0,0,0,0,0,0.923076923076923,1,0.743589743589744,0.45,0,"orthodox"
"163186",32,30,174,179,180,185,154,154,38,36,2,2,35,29,"win_A",2,-5,-5,0,0,0,0,0,0.95,0.947368421052632,0.875,0.763157894736842,0,"orthodox"
"163188",29,24,179,178,185,178,154,154,34,22,2,1,27,20,"win_A",5,1,7,0,0,0,0,0,0.944444444444444,0.956521739130435,0.75,0.869565217391304,0,"orthodox"
"163189",28,33,179,178,185,183,154,154,33,51,2,4,27,34,"win_A",-5,1,2,0,0,0,0,0,0.942857142857143,0.927272727272727,0.771428571428571,0.618181818181818,0,"orthodox"
"163190",28,28,179,171,185,178,147,146,32,33,2,4,26,27,"win_A",0,8,7,1,0,0,0,0,0.941176470588235,0.891891891891892,0.764705882352941,0.72972972972973,0,"orthodox"
"163192",29,27,180,179,191,185,147,147,34,31,1,1,24,25,"win_B",2,1,6,0,0,0,0,0,0.971428571428571,0.96875,0.685714285714286,0.78125,1,"orthodox"
"163193",26,26,180,179,184,185,147,147,35,31,0,0,30,25,"win_A",0,1,-1,0,0,0,0,0,1,1,0.857142857142857,0.806451612903226,0,"orthodox"
"163194",27,26,176,179,183,185,147,147,48,30,2,0,28,24,"win_B",1,-3,-2,0,0,0,0,0,0.96,1,0.56,0.8,1,"orthodox"
"163197",24,28,179,180,185,183,147,147,26,27,0,2,21,18,"win_A",-4,-1,2,0,0,0,0,0,1,0.931034482758621,0.807692307692308,0.620689655172414,0,"orthodox"
"163198",24,35,179,169,185,175,147,147,25,63,0,3,21,31,"win_A",-11,10,10,0,0,1,0,0,1,0.954545454545455,0.84,0.46969696969697,0,"orthodox"
"163201",26,23,174,179,173,185,140,140,41,22,0,0,31,20,"win_B",3,-5,-12,0,0,0,0,0,1,1,0.75609756097561,0.909090909090909,1,"orthodox"
"163204",29,22,180,179,183,185,135,133,32,18,0,0,16,16,"win_B",7,1,-2,2,0,0,0,0,1,1,0.5,0.888888888888889,1,"orthodox"
"163206",29,22,170,179,170,185,135,134,36,16,3,0,26,15,"win_B",7,-9,-15,1,0,0,0,0,0.923076923076923,1,0.666666666666667,0.9375,1,"orthodox"
"163213",20,26,179,170,185,178,135,135,9,10,0,4,8,2,"win_A",-6,9,7,0,0,0,0,0,1,0.714285714285714,0.888888888888889,0.142857142857143,0,"orthodox"
"163226",37,29,165,165,173,170,130,130,38,30,3,2,27,14,"win_A",8,0,3,0,1,0,0,0,0.926829268292683,0.9375,0.658536585365854,0.4375,0,"orthodox"
"163227",25,37,170,165,175,173,130,130,41,37,2,3,23,26,"win_B",-12,5,2,0,0,1,0,0,0.953488372093023,0.925,0.534883720930233,0.65,1,"orthodox"
"163229",34,22,165,170,173,175,129,128,36,33,2,1,26,16,"win_A",12,-5,-2,1,0,0,0,0,0.947368421052632,0.970588235294118,0.684210526315789,0.470588235294118,0,"orthodox"
"163234",26,31,168,165,175,173,134,135,21,32,1,1,12,24,"win_A",-5,3,2,-1,0,0,0,0,0.954545454545455,0.96969696969697,0.545454545454545,0.727272727272727,0,"southpaw"
"163254",24,23,165,168,173,173,124,126,13,43,0,1,10,31,"win_B",1,-3,0,-2,0,0,0,0,1,0.977272727272727,0.769230769230769,0.704545454545455,1,"orthodox"
"163276",31,32,198,188,206,193,238,219,49,22,3,0,43,17,"win_A",-1,10,13,19,0,0,1,0,0.942307692307692,1,0.826923076923077,0.772727272727273,0,"orthodox"
"163281",29,25,198,188,206,196,244,243,44,24,3,0,39,21,"win_A",4,10,10,1,0,0,0,0,0.936170212765957,1,0.829787234042553,0.875,0,"orthodox"
"163283",28,36,198,193,206,203,244,218,42,20,3,2,38,17,"win_A",-8,5,3,26,0,1,1,0,0.933333333333333,0.909090909090909,0.844444444444444,0.772727272727273,0,"orthodox"
"163284",30,28,188,198,196,206,243,226,29,42,2,2,26,38,"win_A",2,-10,-10,17,0,0,1,0,0.935483870967742,0.954545454545455,0.838709677419355,0.863636363636364,0,"orthodox"
"163288",26,32,198,198,206,208,241,263,39,28,1,2,35,16,"win_A",-6,0,-2,-22,0,0,0,1,0.975,0.933333333333333,0.875,0.533333333333333,0,"orthodox"
"163289",26,41,198,185,206,196,243,228,38,30,1,4,34,22,"win_A",-15,13,10,15,0,1,1,0,0.974358974358974,0.882352941176471,0.871794871794872,0.647058823529412,0,"orthodox"
"163291",25,28,198,191,206,203,241,234,36,17,1,1,32,9,"win_A",-3,7,3,7,0,0,0,0,0.972972972972973,0.944444444444444,0.864864864864865,0.5,0,"orthodox"
"163298",23,35,198,185,206,201,236,234,29,42,1,8,26,38,"win_A",-12,13,5,2,0,1,0,0,0.966666666666667,0.84,0.866666666666667,0.76,0,"orthodox"
"163310",22,25,198,188,206,188,228,241,18,25,0,1,15,21,"win_A",-3,10,18,-13,0,0,0,0,1,0.961538461538462,0.833333333333333,0.807692307692308,0,"orthodox"
"163312",21,28,198,193,206,196,228,256,16,15,0,1,14,8,"win_A",-7,5,10,-28,0,0,0,1,1,0.9375,0.875,0.5,0,"orthodox"
"163385",23,25,182,171,193,179,148,155,27,34,2,0,21,25,"win_A",-2,11,14,-7,0,0,0,0,0.931034482758621,1,0.724137931034483,0.735294117647059,0,"Unknown"
"163420",35,25,171,171,183,178,147,145,81,42,6,3,54,34,"win_B",10,0,5,2,1,0,0,0,0.931034482758621,0.933333333333333,0.620689655172414,0.755555555555556,1,"orthodox"
"163426",33,26,171,169,183,170,147,145,76,40,5,2,52,26,"win_A",7,2,13,2,0,0,0,0,0.938271604938272,0.952380952380952,0.641975308641975,0.619047619047619,0,"orthodox"
"163464",25,28,171,165,183,173,140,140,40,39,3,10,23,11,"win_A",-3,6,10,0,0,0,0,0,0.930232558139535,0.795918367346939,0.534883720930233,0.224489795918367,0,"orthodox"
"163609",30,24,170,175,178,173,135,135,50,47,5,4,22,30,"win_A",6,-5,5,0,0,0,0,0,0.909090909090909,0.92156862745098,0.4,0.588235294117647,0,"orthodox"
"163617",27,32,170,165,178,165,135,135,43,78,4,11,17,16,"win_A",-5,5,13,0,0,0,0,0,0.914893617021277,0.876404494382023,0.361702127659574,0.179775280898876,0,"orthodox"
"163618",27,28,170,167,178,173,135,135,42,71,4,18,16,27,"win_A",-1,3,5,0,0,0,0,0,0.91304347826087,0.797752808988764,0.347826086956522,0.303370786516854,0,"orthodox"
"163665",39,50,169,170,175,168,162,159,73,103,4,15,35,70,"win_A",-11,-1,7,3,1,1,0,0,0.948051948051948,0.872881355932203,0.454545454545455,0.593220338983051,0,"southpaw"
"163669",27,47,175,170,184,168,159,160,25,101,1,13,19,70,"win_A",-20,5,16,-1,0,1,0,0,0.961538461538462,0.885964912280702,0.730769230769231,0.614035087719298,0,"orthodox"
"163672",45,29,170,173,168,175,166,167,98,101,13,5,70,70,"win_A",16,-3,-7,-1,1,0,0,0,0.882882882882883,0.952830188679245,0.630630630630631,0.660377358490566,0,"orthodox"
"163676",45,34,170,169,168,175,157,160,96,58,11,3,68,28,"win_B",11,1,-7,-3,1,0,0,0,0.897196261682243,0.950819672131147,0.635514018691589,0.459016393442623,1,"orthodox"
"163679",43,30,170,178,168,178,168,162,93,16,11,0,66,13,"win_A",13,-8,-10,6,1,0,0,0,0.894230769230769,1,0.634615384615385,0.8125,0,"orthodox"
"163681",43,27,170,173,168,173,167,166,92,25,10,4,65,10,"win_A",16,-3,-5,1,1,0,0,0,0.901960784313726,0.862068965517241,0.637254901960784,0.344827586206897,0,"orthodox"
"163685",42,21,170,177,168,183,163,158,89,19,9,1,63,9,"win_A",21,-7,-15,5,1,0,0,0,0.908163265306122,0.95,0.642857142857143,0.45,0,"orthodox"
"163691",38,33,170,178,168,188,158,160,85,35,7,1,61,25,"win_B",5,-8,-20,-2,1,0,0,0,0.923913043478261,0.972222222222222,0.66304347826087,0.694444444444444,1,"orthodox"
"163704",31,25,170,173,168,178,152,149,75,29,4,8,56,26,"win_A",6,-3,-10,3,0,0,0,0,0.949367088607595,0.783783783783784,0.708860759493671,0.702702702702703,0,"orthodox"
"163710",24,29,178,170,188,168,146,146,27,72,1,1,18,56,"win_A",-5,8,20,0,0,0,0,0,0.964285714285714,0.986301369863014,0.642857142857143,0.767123287671233,0,"orthodox"
"163751",21,27,170,175,168,178,135,135,31,26,1,5,27,13,"win_A",-6,-5,-10,0,0,0,0,0,0.96875,0.838709677419355,0.84375,0.419354838709677,0,"orthodox"
"163807",34,32,184,179,188,175,212,193,53,51,5,15,25,34,"win_A",2,5,13,19,0,0,1,0,0.913793103448276,0.772727272727273,0.431034482758621,0.515151515151515,0,"orthodox"
"163808",35,32,183,184,194,188,208,227,19,52,0,5,16,24,"win_B",3,-1,6,-19,1,0,0,1,1,0.912280701754386,0.842105263157895,0.421052631578947,1,"orthodox"
"163810",31,23,184,185,188,193,209,191,50,19,5,1,23,16,"win_A",8,-1,-5,18,0,0,1,0,0.909090909090909,0.95,0.418181818181818,0.8,0,"orthodox"
"163818",28,23,184,185,188,194,185,174,42,5,5,3,18,3,"win_A",5,-1,-6,11,0,0,0,0,0.893617021276596,0.625,0.382978723404255,0.375,0,"orthodox"
"163823",27,28,189,184,203,188,195,195,4,36,6,5,4,16,"win_B",-1,5,15,0,0,0,0,0,0.4,0.878048780487805,0.4,0.390243902439024,1,"Unknown"
"163825",27,26,184,178,188,188,205,185,34,9,5,7,15,4,"win_A",1,6,0,20,0,0,1,0,0.871794871794872,0.5625,0.384615384615385,0.25,0,"orthodox"
"163843",26,19,184,179,188,191,190,207,18,8,3,2,8,8,"win_A",7,5,-3,-17,0,0,0,1,0.857142857142857,0.8,0.380952380952381,0.8,0,"orthodox"
"163845",25,24,184,192,188,201,180,210,16,25,3,7,8,11,"win_A",1,-8,-13,-30,0,0,0,1,0.842105263157895,0.78125,0.421052631578947,0.34375,0,"orthodox"
"163851",24,21,184,192,188,204,180,203,10,15,3,1,7,10,"win_A",3,-8,-16,-23,0,0,0,1,0.769230769230769,0.9375,0.538461538461538,0.625,0,"orthodox"
"163853",24,25,184,182,188,197,185,155,8,31,3,3,7,25,"win_A",-1,2,-9,30,0,0,1,0,0.727272727272727,0.911764705882353,0.636363636363636,0.735294117647059,0,"orthodox"
"163860",22,21,184,189,188,203,168,175,3,0,1,1,3,0,"win_A",1,-5,-15,-7,0,0,0,0,0.75,0,0.75,0,0,"orthodox"
"163878",36,21,171,171,183,175,158,158,79,26,16,1,21,11,"win_B",15,0,8,0,1,0,0,0,0.831578947368421,0.962962962962963,0.221052631578947,0.407407407407407,1,"orthodox"
"163879",36,31,171,173,183,180,160,160,78,49,16,13,21,42,"win_A",5,-2,3,0,1,0,0,0,0.829787234042553,0.790322580645161,0.223404255319149,0.67741935483871,0,"orthodox"
"163882",35,22,171,178,183,187,157,159,77,42,14,2,21,37,"win_B",13,-7,-4,-2,1,0,0,0,0.846153846153846,0.954545454545455,0.230769230769231,0.840909090909091,1,"orthodox"
"163889",33,24,171,168,183,174,154,152,71,16,12,0,21,12,"win_A",9,3,9,2,0,0,0,0,0.855421686746988,1,0.253012048192771,0.75,0,"orthodox"
"163897",32,40,171,173,183,180,157,167,63,60,11,18,20,27,"win_A",-8,-2,3,-10,0,1,0,0,0.851351351351351,0.769230769230769,0.27027027027027,0.346153846153846,0,"orthodox"
"163912",28,28,171,178,183,185,152,160,51,45,7,3,18,8,"win_A",0,-7,-2,-8,0,0,0,0,0.879310344827586,0.9375,0.310344827586207,0.166666666666667,0,"orthodox"
"163923",26,29,171,168,183,170,145,145,42,48,5,11,15,27,"win_A",-3,3,13,0,0,0,0,0,0.893617021276596,0.813559322033898,0.319148936170213,0.457627118644068,0,"orthodox"
"163952",22,20,171,174,183,183,151,151,17,24,1,2,6,7,"win_B",2,-3,0,0,0,0,0,0,0.944444444444444,0.923076923076923,0.333333333333333,0.269230769230769,1,"orthodox"
"163953",22,20,171,174,183,183,150,150,16,24,1,1,6,7,"win_A",2,-3,0,0,0,0,0,0,0.941176470588235,0.96,0.352941176470588,0.28,0,"orthodox"
"163973",33,26,169,171,180,172,132,132,157,43,10,14,100,26,"win_B",7,-2,8,0,0,0,0,0,0.940119760479042,0.754385964912281,0.598802395209581,0.456140350877193,1,"orthodox"
"163979",32,23,169,160,180,168,132,133,151,38,10,9,95,18,"win_A",9,9,12,-1,0,0,0,0,0.937888198757764,0.808510638297872,0.590062111801242,0.382978723404255,0,"orthodox"
"163983",31,21,169,173,180,177,135,142,148,35,9,5,95,12,"win_B",10,-4,3,-7,0,0,0,0,0.942675159235669,0.875,0.605095541401274,0.3,1,"orthodox"
"164009",27,22,169,168,180,178,133,133,123,3,7,1,81,1,"win_A",5,1,2,0,0,0,0,0,0.946153846153846,0.75,0.623076923076923,0.25,0,"orthodox"
"164039",20,26,160,169,165,180,133,124,52,94,2,6,36,59,"win_A",-6,-9,-15,9,0,0,0,0,0.962962962962963,0.94,0.666666666666667,0.59,0,"orthodox"
"164142",41,39,185,187,198,192,191,188,59,27,4,14,46,25,"win_B",2,-2,6,3,1,1,0,0,0.936507936507937,0.658536585365854,0.73015873015873,0.609756097560976,1,"orthodox"
"164149",35,30,185,180,198,196,184,186,52,19,4,2,42,18,"win_A",5,5,2,-2,1,0,0,0,0.928571428571429,0.904761904761905,0.75,0.857142857142857,0,"orthodox"
"164150",35,30,185,177,198,188,184,184,51,19,4,4,41,8,"win_A",5,8,10,0,1,0,0,0,0.927272727272727,0.826086956521739,0.745454545454545,0.347826086956522,0,"orthodox"
"164153",27,32,184,185,196,198,174,173,30,49,0,3,18,40,"win_B",-5,-1,-2,1,0,0,0,0,1,0.942307692307692,0.6,0.769230769230769,1,"orthodox"
"164158",29,28,185,185,198,188,160,160,45,24,2,4,38,15,"win_B",1,0,10,0,0,0,0,0,0.957446808510638,0.857142857142857,0.808510638297872,0.535714285714286,1,"orthodox"
"164163",27,26,185,185,198,198,160,160,40,22,2,0,34,16,"win_A",1,0,0,0,0,0,0,0,0.952380952380952,1,0.80952380952381,0.727272727272727,0,"orthodox"
"164172",25,22,178,185,188,198,145,146,30,32,1,0,21,30,"win_A",3,-7,-10,-1,0,0,0,0,0.967741935483871,1,0.67741935483871,0.9375,0,"orthodox"
"164217",25,25,177,180,191,193,160,160,48,51,2,15,40,32,"win_A",0,-3,-2,0,0,0,0,0,0.96,0.772727272727273,0.8,0.484848484848485,0,"southpaw"
"164289",23,28,164,163,178,165,135,135,65,125,5,18,22,41,"win_A",-5,1,13,0,0,0,0,0,0.928571428571429,0.874125874125874,0.314285714285714,0.286713286713287,0,"orthodox"
"164293",27,28,163,168,165,170,137,145,122,53,17,11,39,21,"win_B",-1,-5,-5,-8,0,0,0,0,0.877697841726619,0.828125,0.280575539568345,0.328125,1,"orthodox"
"164303",26,28,163,165,165,170,135,136,113,81,16,14,35,24,"win_A",-2,-2,-5,-1,0,0,0,0,0.875968992248062,0.852631578947368,0.271317829457364,0.252631578947368,0,"orthodox"
"164316",25,20,163,164,165,174,131,132,102,62,14,8,32,14,"win_A",5,-1,-9,-1,0,0,0,0,0.879310344827586,0.885714285714286,0.275862068965517,0.2,0,"orthodox"
"164321",25,23,163,168,165,165,133,130,97,93,14,5,30,40,"win_A",2,-5,0,3,0,0,0,0,0.873873873873874,0.948979591836735,0.27027027027027,0.408163265306122,0,"orthodox"
"164326",24,23,163,163,165,170,133,136,95,59,11,5,30,4,"win_B",1,0,-5,-3,0,0,0,0,0.89622641509434,0.921875,0.283018867924528,0.0625,1,"orthodox"
"164433",35,26,165,168,165,173,107,107,50,17,0,2,37,9,"win_A",9,-3,-8,0,1,0,0,0,1,0.894736842105263,0.74,0.473684210526316,0,"orthodox"
"164435",29,33,163,165,168,165,108,107,14,48,1,0,6,36,"win_B",-4,-2,3,1,0,0,0,0,0.933333333333333,1,0.4,0.75,1,"orthodox"
"164437",31,24,165,159,165,163,105,105,46,25,0,1,35,18,"win_A",7,6,2,0,0,0,0,0,1,0.961538461538462,0.760869565217391,0.692307692307692,0,"orthodox"
"164443",28,25,165,157,165,160,104,105,40,30,0,2,30,19,"win_A",3,8,5,-1,0,0,0,0,1,0.9375,0.75,0.59375,0,"orthodox"
"164447",27,24,165,165,165,175,105,104,36,21,0,0,27,14,"win_A",3,0,-10,1,0,0,0,0,1,1,0.75,0.666666666666667,0,"orthodox"
"164489",40,26,182,182,182,197,168,168,64,37,9,4,56,28,"win_A",14,0,-15,0,1,0,0,0,0.876712328767123,0.902439024390244,0.767123287671233,0.682926829268293,0,"orthodox"
"164494",39,27,182,183,182,194,172,219,60,16,8,0,53,13,"win_B",12,-1,-12,-47,1,0,0,1,0.882352941176471,1,0.779411764705882,0.8125,1,"orthodox"
"164496",37,28,182,188,182,199,158,195,58,27,8,5,51,15,"win_A",9,-6,-17,-37,1,0,0,1,0.878787878787879,0.84375,0.772727272727273,0.46875,0,"orthodox"
"164500",36,24,182,183,182,194,167,206,55,10,7,0,48,8,"win_B",12,-1,-12,-39,1,0,0,1,0.887096774193548,1,0.774193548387097,0.8,1,"orthodox"
"164502",30,33,185,182,185,182,167,184,10,53,0,7,4,46,"win_B",-3,3,3,-17,0,0,0,1,1,0.883333333333333,0.4,0.766666666666667,1,"orthodox"
"164504",32,26,182,182,182,188,165,180,52,104,6,4,45,81,"win_A",6,0,-6,-15,0,0,0,1,0.896551724137931,0.962962962962963,0.775862068965517,0.75,0,"orthodox"
"164531",28,22,182,182,182,188,165,178,25,43,6,2,19,29,"win_A",6,0,-6,-13,0,0,0,0,0.806451612903226,0.955555555555556,0.612903225806452,0.644444444444444,0,"orthodox"
"164598",25,26,165,157,175,160,136,134,151,93,20,18,61,32,"win_A",-1,8,15,2,0,0,0,0,0.883040935672515,0.837837837837838,0.35672514619883,0.288288288288288,0,"orthodox"
"164641",22,32,165,173,175,178,138,141,109,143,19,34,44,23,"win_A",-10,-8,-3,-3,0,0,0,0,0.8515625,0.807909604519774,0.34375,0.129943502824859,0,"orthodox"
"164656",21,32,165,173,175,178,133,139,94,130,19,32,39,22,"win_A",-11,-8,-3,-6,0,0,0,0,0.831858407079646,0.802469135802469,0.345132743362832,0.135802469135802,0,"orthodox"
"164663",21,28,165,165,175,173,133,126,87,96,19,10,33,19,"win_A",-7,0,2,7,0,0,0,0,0.820754716981132,0.905660377358491,0.311320754716981,0.179245283018868,0,"orthodox"
"164707",19,26,165,165,175,173,130,128,46,72,16,7,16,15,"win_B",-7,0,2,2,0,0,0,0,0.741935483870968,0.911392405063291,0.258064516129032,0.189873417721519,1,"orthodox"
"164710",18,21,165,164,175,160,133,130,44,67,15,18,16,8,"win_B",-3,1,15,3,0,0,0,0,0.745762711864407,0.788235294117647,0.271186440677966,0.0941176470588235,1,"orthodox"
"164774",37,35,170,170,175,170,135,135,36,48,3,4,22,35,"win_B",2,0,5,0,1,1,0,0,0.923076923076923,0.923076923076923,0.564102564102564,0.673076923076923,1,"southpaw"
"164775",34,27,170,165,170,175,128,129,47,27,3,3,35,19,"win_A",7,5,-5,-1,0,0,0,0,0.94,0.9,0.7,0.633333333333333,0,"orthodox"
"164776",33,33,170,168,170,178,129,130,46,63,3,4,35,42,"win_A",0,2,-8,-1,0,0,0,0,0.938775510204082,0.940298507462687,0.714285714285714,0.626865671641791,0,"orthodox"
"164779",26,32,169,170,175,170,125,125,36,44,0,2,20,33,"win_A",-6,-1,5,0,0,0,0,0,1,0.956521739130435,0.555555555555556,0.717391304347826,0,"orthodox"
"164780",31,34,170,175,170,188,125,126,43,37,2,4,33,26,"win_A",-3,-5,-18,-1,0,0,0,0,0.955555555555556,0.902439024390244,0.733333333333333,0.634146341463415,0,"orthodox"
"164785",28,28,170,173,170,175,125,125,37,20,2,1,29,10,"win_A",0,-3,-5,0,0,0,0,0,0.948717948717949,0.952380952380952,0.743589743589744,0.476190476190476,0,"orthodox"
"164787",27,29,170,168,170,173,125,125,35,25,2,5,27,16,"win_A",-2,2,-3,0,0,0,0,0,0.945945945945946,0.833333333333333,0.72972972972973,0.533333333333333,0,"orthodox"
"164789",27,33,170,168,170,170,127,129,33,25,2,5,25,19,"win_A",-6,2,0,-2,0,0,0,0,0.942857142857143,0.833333333333333,0.714285714285714,0.633333333333333,0,"orthodox"
"164795",25,28,170,163,170,168,127,130,28,23,1,11,21,18,"win_A",-3,7,2,-3,0,0,0,0,0.96551724137931,0.676470588235294,0.724137931034483,0.529411764705882,0,"orthodox"
"164798",24,26,170,168,170,165,124,125,25,31,1,8,18,26,"win_A",-2,2,5,-1,0,0,0,0,0.961538461538462,0.794871794871795,0.692307692307692,0.666666666666667,0,"orthodox"
"164800",24,27,170,180,170,180,126,127,23,9,1,2,16,5,"win_A",-3,-10,-10,-1,0,0,0,0,0.958333333333333,0.818181818181818,0.666666666666667,0.454545454545455,0,"orthodox"
"164801",24,29,170,165,170,168,125,125,22,22,1,5,16,13,"win_A",-5,5,2,0,0,0,0,0,0.956521739130435,0.814814814814815,0.695652173913043,0.481481481481481,0,"orthodox"
"164804",23,27,170,162,170,163,125,126,19,20,1,5,14,11,"win_A",-4,8,7,-1,0,0,0,0,0.95,0.8,0.7,0.44,0,"orthodox"
"164816",21,23,170,170,170,173,124,126,7,1,1,6,5,1,"win_A",-2,0,-3,-2,0,0,0,0,0.875,0.142857142857143,0.625,0.142857142857143,0,"orthodox"
"164825",42,25,178,184,183,192,142,141,77,17,7,3,62,11,"win_B",17,-6,-9,1,1,0,0,0,0.916666666666667,0.85,0.738095238095238,0.55,1,"orthodox"
"164827",29,33,174,178,180,183,143,144,31,75,1,7,18,61,"win_B",-4,-4,-3,-1,0,0,0,0,0.96875,0.914634146341463,0.5625,0.74390243902439,1,"orthodox"
"164829",27,31,168,178,175,183,139,140,33,74,0,6,31,60,"win_A",-4,-10,-8,-1,0,0,0,0,1,0.925,0.939393939393939,0.75,0,"orthodox"
"164842",28,23,178,165,183,166,130,130,62,36,5,6,51,19,"win_A",5,13,17,0,0,0,0,0,0.925373134328358,0.857142857142857,0.761194029850746,0.452380952380952,0,"orthodox"
"164846",27,25,178,171,183,168,130,129,58,43,5,8,48,32,"win_A",2,7,15,1,0,0,0,0,0.920634920634921,0.843137254901961,0.761904761904762,0.627450980392157,0,"orthodox"
"164873",22,23,178,157,183,160,126,124,32,35,4,5,27,25,"win_A",-1,21,23,2,0,0,0,0,0.888888888888889,0.875,0.75,0.625,0,"orthodox"
"164922",32,27,170,179,170,182,176,178,123,176,20,35,56,13,"win_A",5,-9,-12,-2,0,0,0,0,0.86013986013986,0.834123222748815,0.391608391608392,0.0616113744075829,0,"orthodox"
"164927",31,22,170,170,170,183,170,161,120,72,18,12,54,43,"win_B",9,0,-13,9,0,0,0,0,0.869565217391304,0.857142857142857,0.391304347826087,0.511904761904762,1,"orthodox"
"164930",26,31,185,170,193,170,174,188,44,118,5,17,30,53,"win_A",-5,15,23,-14,0,0,0,0,0.897959183673469,0.874074074074074,0.612244897959184,0.392592592592593,0,"orthodox"
"164934",30,21,170,180,170,188,172,195,115,41,16,16,52,22,"win_A",9,-10,-18,-23,0,0,0,1,0.877862595419847,0.719298245614035,0.396946564885496,0.385964912280702,0,"orthodox"
"164952",28,28,170,180,170,185,164,175,97,50,16,14,40,17,"win_A",0,-10,-15,-11,0,0,0,0,0.858407079646018,0.78125,0.353982300884956,0.265625,0,"orthodox"
"164963",26,22,170,174,170,173,158,155,87,59,15,13,36,21,"win_A",4,-4,-3,3,0,0,0,0,0.852941176470588,0.819444444444444,0.352941176470588,0.291666666666667,0,"orthodox"
"164978",24,23,170,171,170,173,144,146,74,70,13,16,31,19,"win_B",1,-1,-3,-2,0,0,0,0,0.850574712643678,0.813953488372093,0.35632183908046,0.22093023255814,1,"orthodox"
"164981",24,26,170,170,170,175,150,151,71,57,13,27,31,16,"win_A",-2,0,-5,-1,0,0,0,0,0.845238095238095,0.678571428571429,0.369047619047619,0.19047619047619,0,"orthodox"
"164983",23,22,170,173,170,180,150,155,69,81,12,12,30,20,"win_A",1,-3,-10,-5,0,0,0,0,0.851851851851852,0.870967741935484,0.37037037037037,0.21505376344086,0,"orthodox"
"165068",35,25,174,175,180,183,147,147,43,27,4,2,37,13,"win_A",10,-1,-3,0,1,0,0,0,0.914893617021277,0.931034482758621,0.787234042553192,0.448275862068966,0,"orthodox"
"165069",34,28,174,178,180,178,153,154,42,26,4,3,36,22,"win_A",6,-4,2,-1,0,0,0,0,0.91304347826087,0.896551724137931,0.782608695652174,0.758620689655172,0,"orthodox"
"165071",34,28,174,180,180,168,148,148,40,33,4,0,35,28,"win_A",6,-6,12,0,0,0,0,0,0.909090909090909,1,0.795454545454545,0.848484848484849,0,"orthodox"
"165072",33,26,174,175,180,178,148,148,39,18,4,1,35,9,"win_A",7,-1,2,0,0,0,0,0,0.906976744186046,0.947368421052632,0.813953488372093,0.473684210526316,0,"orthodox"
"165073",32,33,179,174,183,180,154,154,47,39,3,3,25,35,"win_A",-1,5,3,0,0,0,0,0,0.94,0.928571428571429,0.5,0.833333333333333,0,"southpaw"
"165074",32,32,179,174,183,180,154,154,46,39,3,2,25,35,"win_A",0,5,3,0,0,0,0,0,0.938775510204082,0.951219512195122,0.510204081632653,0.853658536585366,0,"southpaw"
"165075",31,30,183,174,185,180,147,147,34,38,0,1,26,35,"win_A",1,9,5,0,0,0,0,0,1,0.974358974358974,0.764705882352941,0.897435897435897,0,"orthodox"
"165076",31,30,183,174,185,180,146,147,33,38,0,0,26,35,"win_A",1,9,5,-1,0,0,0,0,1,1,0.787878787878788,0.921052631578947,0,"orthodox"
"165077",29,30,174,170,180,180,147,147,37,30,0,3,34,23,"win_A",-1,4,0,0,0,0,0,0,1,0.909090909090909,0.918918918918919,0.696969696969697,0,"orthodox"
"165078",29,28,174,178,180,178,147,147,36,28,0,0,33,18,"win_A",1,-4,2,0,0,0,0,0,1,1,0.916666666666667,0.642857142857143,0,"orthodox"
"165080",28,32,174,177,180,170,148,148,33,24,0,6,31,7,"win_A",-4,-3,10,0,0,0,0,0,1,0.8,0.939393939393939,0.233333333333333,0,"orthodox"
"165081",28,30,174,180,180,183,146,147,32,30,0,3,30,19,"win_A",-2,-6,-3,-1,0,0,0,0,1,0.909090909090909,0.9375,0.575757575757576,0,"orthodox"
"165084",27,32,174,165,180,170,135,135,29,37,0,3,27,15,"win_A",-5,9,10,0,0,0,0,0,1,0.925,0.931034482758621,0.375,0,"orthodox"
"165087",26,33,174,170,180,170,135,135,26,45,0,4,24,30,"win_A",-7,4,10,0,0,0,0,0,1,0.918367346938776,0.923076923076923,0.612244897959184,0,"orthodox"
"165088",26,24,174,170,180,180,135,135,25,20,0,1,23,13,"win_A",2,4,0,0,0,0,0,0,1,0.952380952380952,0.92,0.619047619047619,0,"orthodox"
"165101",22,28,174,165,180,175,136,138,12,34,0,16,11,23,"win_A",-6,9,5,-2,0,0,0,0,1,0.68,0.916666666666667,0.46,0,"orthodox"
"165104",22,21,174,168,180,168,134,135,9,19,0,6,9,10,"win_A",1,6,12,-1,0,0,0,0,1,0.76,1,0.4,0,"orthodox"
"165131",35,27,165,157,173,160,129,132,214,36,8,35,61,11,"win_A",8,8,13,-3,1,0,0,0,0.963963963963964,0.507042253521127,0.274774774774775,0.154929577464789,0,"orthodox"
"165183",29,17,165,175,173,175,130,130,165,26,5,12,52,13,"win_A",12,-10,-2,0,0,0,0,0,0.970588235294118,0.684210526315789,0.305882352941176,0.342105263157895,0,"orthodox"
"165215",26,22,165,174,173,178,126,124,136,92,2,6,45,62,"win_A",4,-9,-5,2,0,0,0,0,0.985507246376812,0.938775510204082,0.326086956521739,0.63265306122449,0,"orthodox"
"165287",20,34,165,165,173,165,128,127,65,90,1,24,23,17,"win_A",-14,0,8,1,0,0,0,0,0.984848484848485,0.789473684210526,0.348484848484849,0.149122807017544,0,"orthodox"
"165361",23,26,168,170,170,178,146,139,48,114,7,21,18,61,"win_A",-3,-2,-8,7,0,0,0,0,0.872727272727273,0.844444444444444,0.327272727272727,0.451851851851852,0,"orthodox"
"165362",23,26,168,170,170,178,142,138,47,113,7,20,18,60,"win_A",-3,-2,-8,4,0,0,0,0,0.87037037037037,0.849624060150376,0.333333333333333,0.451127819548872,0,"orthodox"
"165363",22,25,168,170,170,178,141,138,47,108,6,19,18,58,"win_B",-3,-2,-8,3,0,0,0,0,0.886792452830189,0.850393700787402,0.339622641509434,0.456692913385827,1,"orthodox"
"165369",21,27,168,173,170,178,144,146,41,88,6,17,15,42,"win_A",-6,-5,-8,-2,0,0,0,0,0.872340425531915,0.838095238095238,0.319148936170213,0.4,0,"orthodox"
"165376",20,24,168,170,170,170,135,135,36,107,4,6,12,22,"win_B",-4,-2,0,0,0,0,0,0,0.9,0.946902654867257,0.3,0.194690265486726,1,"orthodox"
"165418",39,31,173,180,180,191,166,164,58,78,18,2,27,32,"win_A",8,-7,-11,2,1,0,0,0,0.763157894736842,0.975,0.355263157894737,0.4,0,"orthodox"
"165422",37,31,173,178,180,188,167,173,55,39,17,2,26,27,"win_A",6,-5,-8,-6,1,0,0,0,0.763888888888889,0.951219512195122,0.361111111111111,0.658536585365854,0,"orthodox"
"165424",37,30,173,178,180,188,167,175,53,39,17,1,25,27,"win_A",7,-5,-8,-8,1,0,0,0,0.757142857142857,0.975,0.357142857142857,0.675,0,"orthodox"
"165427",35,28,173,173,180,183,163,159,50,23,16,7,24,16,"win_A",7,0,-3,4,1,0,0,0,0.757575757575758,0.766666666666667,0.363636363636364,0.533333333333333,0,"orthodox"
"165434",31,33,173,173,175,180,159,160,55,45,4,14,24,21,"win_B",-2,0,-5,-1,0,0,0,0,0.932203389830508,0.76271186440678,0.406779661016949,0.355932203389831,1,"orthodox"
"165510",34,24,183,188,185,203,191,192,89,23,14,3,49,11,"win_B",10,-5,-18,-1,0,0,0,0,0.864077669902913,0.884615384615385,0.475728155339806,0.423076923076923,1,"orthodox"
"165520",26,32,188,183,198,185,190,201,21,83,2,10,16,46,"win_B",-6,5,13,-11,0,0,0,0,0.91304347826087,0.89247311827957,0.695652173913043,0.494623655913978,1,"orthodox"
"165529",31,32,183,182,185,193,185,183,76,82,8,23,42,30,"win_A",-1,1,-8,2,0,0,0,0,0.904761904761905,0.780952380952381,0.5,0.285714285714286,0,"orthodox"
"165531",31,28,183,184,185,175,189,187,74,52,8,11,41,33,"win_A",3,-1,10,2,0,0,0,0,0.902439024390244,0.825396825396825,0.5,0.523809523809524,0,"orthodox"
"165535",30,29,183,185,185,182,189,178,72,77,6,17,40,21,"win_A",1,-2,3,11,0,0,0,0,0.923076923076923,0.819148936170213,0.512820512820513,0.223404255319149,0,"orthodox"
"165537",30,37,183,183,185,188,182,194,71,49,5,16,39,31,"win_B",-7,0,-3,-12,0,1,0,0,0.934210526315789,0.753846153846154,0.513157894736842,0.476923076923077,1,"orthodox"
"165539",29,37,183,183,185,188,186,194,69,49,5,15,39,31,"win_A",-8,0,-3,-8,0,1,0,0,0.932432432432432,0.765625,0.527027027027027,0.484375,0,"orthodox"
"165540",29,34,183,180,185,185,185,193,68,64,5,27,38,29,"win_A",-5,3,0,-8,0,0,0,0,0.931506849315068,0.703296703296703,0.520547945205479,0.318681318681319,0,"orthodox"
"165550",27,28,183,182,185,193,176,178,57,66,5,12,31,25,"win_A",-1,1,-8,-2,0,0,0,0,0.919354838709677,0.846153846153846,0.5,0.320512820512821,0,"orthodox"
"165558",26,33,183,178,185,189,173,168,48,60,5,15,24,30,"win_A",-7,5,-4,5,0,0,0,0,0.905660377358491,0.8,0.452830188679245,0.4,0,"orthodox"
"165565",25,26,183,182,185,193,175,186,41,52,4,7,21,20,"win_A",-1,1,-8,-11,0,0,0,0,0.911111111111111,0.88135593220339,0.466666666666667,0.338983050847458,0,"orthodox"
"165576",21,28,183,178,185,189,168,165,30,38,3,7,15,23,"win_B",-7,5,-4,3,0,0,0,0,0.909090909090909,0.844444444444444,0.454545454545455,0.511111111111111,1,"orthodox"
"165578",21,20,183,185,185,182,166,184,29,21,2,6,15,6,"win_A",1,-2,3,-18,0,0,0,1,0.935483870967742,0.777777777777778,0.483870967741935,0.222222222222222,0,"orthodox"
"165584",24,20,175,183,191,185,160,151,52,23,6,2,32,11,"win_B",4,-8,6,9,0,0,0,0,0.896551724137931,0.92,0.551724137931034,0.44,1,"orthodox"
"165611",35,26,168,180,175,184,147,147,40,33,2,0,17,29,"win_B",9,-12,-9,0,1,0,0,0,0.952380952380952,1,0.404761904761905,0.878787878787879,1,"southpaw"
"165612",33,24,168,182,175,185,147,146,39,20,1,0,16,13,"win_A",9,-14,-10,1,0,0,0,0,0.975,1,0.4,0.65,0,"southpaw"
"165613",32,27,168,180,175,183,147,147,38,23,1,1,16,14,"win_A",5,-12,-8,0,0,0,0,0,0.974358974358974,0.958333333333333,0.41025641025641,0.583333333333333,0,"southpaw"
"165614",32,26,168,180,175,183,147,147,37,23,1,0,16,14,"win_A",6,-12,-8,0,0,0,0,0,0.973684210526316,1,0.421052631578947,0.608695652173913,0,"southpaw"
"165617",30,30,168,169,175,178,147,146,33,64,1,3,15,44,"win_A",0,-1,-3,1,0,0,0,0,0.970588235294118,0.955223880597015,0.441176470588235,0.656716417910448,0,"southpaw"
"165621",28,26,168,183,175,188,140,139,29,28,1,1,14,26,"win_A",2,-15,-13,1,0,0,0,0,0.966666666666667,0.96551724137931,0.466666666666667,0.896551724137931,0,"southpaw"
"165623",28,36,168,175,175,185,141,141,27,78,1,10,13,54,"win_A",-8,-7,-10,0,0,1,0,0,0.964285714285714,0.886363636363636,0.464285714285714,0.613636363636364,0,"southpaw"
"165624",27,25,168,165,175,173,135,135,26,38,1,3,13,27,"win_A",2,3,2,0,0,0,0,0,0.962962962962963,0.926829268292683,0.481481481481481,0.658536585365854,0,"southpaw"
"165626",27,24,168,172,175,175,135,135,24,26,1,2,13,16,"win_A",3,-4,0,0,0,0,0,0,0.96,0.928571428571429,0.52,0.571428571428571,0,"southpaw"
"165651",27,34,170,173,175,183,140,140,29,51,2,6,27,35,"win_A",-7,-3,-8,0,0,0,0,0,0.935483870967742,0.894736842105263,0.870967741935484,0.614035087719298,0,"orthodox"
"165655",28,29,168,173,178,183,134,133,26,48,1,2,16,34,"win_A",-1,-5,-5,1,0,0,0,0,0.962962962962963,0.96,0.592592592592593,0.68,0,"orthodox"
"165657",27,33,173,168,183,168,130,130,46,40,1,3,34,24,"win_A",-6,5,15,0,0,0,0,0,0.978723404255319,0.930232558139535,0.723404255319149,0.558139534883721,0,"orthodox"
"165658",27,31,173,165,183,165,130,130,45,40,1,2,34,28,"win_A",-4,8,18,0,0,0,0,0,0.978260869565217,0.952380952380952,0.739130434782609,0.666666666666667,0,"orthodox"
"165659",27,29,173,175,183,170,130,129,44,37,1,5,33,23,"win_A",-2,-2,13,1,0,0,0,0,0.977777777777778,0.880952380952381,0.733333333333333,0.547619047619048,0,"orthodox"
"165660",26,22,173,168,183,173,126,126,43,24,1,4,32,6,"win_A",4,5,10,0,0,0,0,0,0.977272727272727,0.857142857142857,0.727272727272727,0.214285714285714,0,"orthodox"
"165662",26,32,173,166,183,168,126,126,41,34,1,1,31,12,"win_A",-6,7,15,0,0,0,0,0,0.976190476190476,0.971428571428571,0.738095238095238,0.342857142857143,0,"orthodox"
"165663",28,25,168,173,178,183,126,126,54,41,3,0,39,31,"win_A",3,-5,-5,0,0,0,0,0,0.947368421052632,1,0.684210526315789,0.75609756097561,0,"orthodox"
"165666",24,30,173,161,183,163,130,135,38,24,0,1,30,11,"win_A",-6,12,20,-5,0,0,0,0,1,0.96,0.789473684210526,0.44,0,"orthodox"
"165667",24,33,173,170,183,180,126,126,37,51,0,4,29,34,"win_A",-9,3,3,0,0,0,0,0,1,0.927272727272727,0.783783783783784,0.618181818181818,0,"orthodox"
"165682",19,30,173,170,183,178,120,122,22,33,0,3,18,21,"win_A",-11,3,5,-2,0,0,0,0,1,0.916666666666667,0.818181818181818,0.583333333333333,0,"orthodox"
"165690",18,23,173,168,183,165,122,122,14,27,0,5,12,23,"win_A",-5,5,18,0,0,0,0,0,1,0.84375,0.857142857142857,0.71875,0,"orthodox"
"165725",32,27,185,183,213,180,189,213,33,38,1,2,23,29,"win_A",5,2,33,-24,0,0,0,1,0.970588235294118,0.95,0.676470588235294,0.725,0,"orthodox"
"165729",24,26,183,184,180,183,182,196,35,21,1,0,26,13,"win_B",-2,-1,-3,-14,0,0,0,0,0.972222222222222,1,0.722222222222222,0.619047619047619,1,"orthodox"
"165742",20,25,183,177,180,178,170,170,21,56,1,12,13,27,"win_A",-5,6,2,0,0,0,0,0,0.954545454545455,0.823529411764706,0.590909090909091,0.397058823529412,0,"orthodox"
"165751",19,32,183,185,180,182,168,177,13,80,0,21,8,22,"win_B",-13,-2,-2,-9,0,0,0,0,1,0.792079207920792,0.615384615384615,0.217821782178218,1,"orthodox"
"165755",19,24,183,177,180,178,167,171,9,48,0,6,7,25,"win_A",-5,6,2,-4,0,0,0,0,1,0.888888888888889,0.777777777777778,0.462962962962963,0,"orthodox"
"165900",28,22,183,180,193,188,188,192,74,20,1,7,46,13,"win_A",6,3,5,-4,0,0,0,0,0.986666666666667,0.740740740740741,0.613333333333333,0.481481481481481,0,"orthodox"
"165901",28,35,183,180,193,178,186,189,73,34,1,22,45,13,"win_A",-7,3,15,-3,0,1,0,0,0.986486486486487,0.607142857142857,0.608108108108108,0.232142857142857,0,"orthodox"
"165974",33,28,180,179,185,188,168,167,40,21,0,0,31,17,"win_A",5,1,-3,1,0,0,0,0,1,1,0.775,0.80952380952381,0,"southpaw"
"165979",31,29,180,182,185,180,167,168,35,25,0,2,28,18,"win_A",2,-2,5,-1,0,0,0,0,1,0.925925925925926,0.8,0.666666666666667,0,"southpaw"
"165986",28,23,180,183,185,178,168,167,28,20,0,1,23,13,"win_A",5,-3,7,1,0,0,0,0,1,0.952380952380952,0.821428571428571,0.619047619047619,0,"southpaw"
"166003",23,20,180,173,185,173,170,168,11,7,0,9,10,5,"win_A",3,7,12,2,0,0,0,0,1,0.4375,0.909090909090909,0.3125,0,"southpaw"
"166063",23,24,175,168,183,170,129,130,47,25,7,2,16,10,"win_B",-1,7,13,-1,0,0,0,0,0.87037037037037,0.925925925925926,0.296296296296296,0.37037037037037,1,"orthodox"
"166214",25,27,178,175,188,185,153,153,29,36,1,0,20,18,"win_A",-2,3,3,0,0,0,0,0,0.966666666666667,1,0.666666666666667,0.5,0,"orthodox"
"166218",23,25,178,178,188,185,146,147,24,28,0,5,15,9,"win_A",-2,0,3,-1,0,0,0,0,1,0.848484848484849,0.625,0.272727272727273,0,"orthodox"
"166219",23,27,178,179,188,188,147,147,23,45,0,3,14,28,"win_A",-4,-1,0,0,0,0,0,0,1,0.9375,0.608695652173913,0.583333333333333,0,"orthodox"
"166220",23,25,178,173,188,175,151,153,22,30,0,4,13,21,"win_A",-2,5,13,-2,0,0,0,0,1,0.882352941176471,0.590909090909091,0.617647058823529,0,"orthodox"
"166221",23,24,178,180,188,193,153,160,21,49,0,14,13,30,"win_A",-1,-2,-5,-7,0,0,0,0,1,0.777777777777778,0.619047619047619,0.476190476190476,0,"orthodox"
"166226",22,31,178,168,188,174,149,151,16,44,0,13,9,30,"win_A",-9,10,14,-2,0,0,0,0,1,0.771929824561403,0.5625,0.526315789473684,0,"orthodox"
"166260",34,51,166,165,170,173,139,137,137,13,18,3,93,4,"win_A",-17,1,-3,2,0,1,0,0,0.883870967741936,0.8125,0.6,0.25,0,"orthodox"
"166276",32,26,166,173,170,173,144,143,123,51,15,26,85,35,"win_A",6,-7,-3,1,0,0,0,0,0.891304347826087,0.662337662337662,0.615942028985507,0.454545454545455,0,"orthodox"
"166283",32,28,166,170,170,170,143,145,116,115,15,32,80,55,"win_A",4,-4,0,-2,0,0,0,0,0.885496183206107,0.782312925170068,0.610687022900763,0.374149659863946,0,"orthodox"
"166299",29,29,166,168,170,168,140,146,103,84,12,54,68,40,"win_A",0,-2,2,-6,0,0,0,0,0.895652173913044,0.608695652173913,0.591304347826087,0.289855072463768,0,"orthodox"
"166308",29,28,166,168,170,168,134,147,95,77,11,47,62,36,"win_A",1,-2,2,-13,0,0,0,0,0.89622641509434,0.620967741935484,0.584905660377358,0.290322580645161,0,"orthodox"
"166328",27,30,166,160,170,160,124,126,75,105,11,22,47,25,"win_A",-3,6,10,-2,0,0,0,0,0.872093023255814,0.826771653543307,0.546511627906977,0.196850393700787,0,"orthodox"
"166336",27,33,166,156,170,163,130,134,67,187,11,38,39,70,"win_A",-6,10,7,-4,0,0,0,0,0.858974358974359,0.831111111111111,0.5,0.311111111111111,0,"orthodox"
"166357",26,19,166,165,170,168,128,128,47,44,10,9,22,14,"win_A",7,1,2,0,0,0,0,0,0.824561403508772,0.830188679245283,0.385964912280702,0.264150943396226,0,"orthodox"
"166377",25,21,166,164,170,174,129,130,32,65,5,9,15,14,"win_B",4,2,-4,-1,0,0,0,0,0.864864864864865,0.878378378378378,0.405405405405405,0.189189189189189,1,"orthodox"
"166415",52,35,190,182,206,198,254,334,68,65,6,2,44,50,"win_A",17,8,8,-80,1,1,0,1,0.918918918918919,0.970149253731343,0.594594594594595,0.746268656716418,0,"orthodox"
"166416",51,49,190,185,206,198,255,234,67,41,6,17,43,28,"win_A",2,5,8,21,1,1,1,0,0.917808219178082,0.706896551724138,0.589041095890411,0.482758620689655,0,"orthodox"
"166417",49,46,190,193,206,208,250,275,66,44,6,16,42,32,"win_A",3,-3,-2,-25,1,1,0,1,0.916666666666667,0.733333333333333,0.583333333333333,0.533333333333333,0,"orthodox"
"166418",47,21,190,193,206,203,248,205,65,9,6,8,42,5,"win_A",26,-3,3,43,1,0,1,0,0.915492957746479,0.529411764705882,0.591549295774648,0.294117647058824,0,"orthodox"
"166419",31,47,191,190,196,206,247,248,31,65,0,5,19,42,"win_A",-16,1,-10,-1,0,1,0,0,1,0.928571428571429,0.612903225806452,0.6,0,"orthodox"
"166420",46,27,190,185,206,191,240,226,64,15,5,4,41,11,"win_A",19,5,15,14,1,0,0,0,0.927536231884058,0.789473684210526,0.594202898550725,0.578947368421053,0,"orthodox"
"166424",29,45,188,190,208,206,236,231,25,61,5,4,18,40,"win_A",-16,-2,2,5,0,1,0,0,0.833333333333333,0.938461538461538,0.6,0.615384615384615,0,"orthodox"
"166427",43,30,190,195,206,203,243,237,58,32,4,9,40,23,"win_A",13,-5,3,6,1,0,0,0,0.935483870967742,0.780487804878049,0.645161290322581,0.560975609756098,0,"orthodox"
"166428",43,35,190,180,206,191,232,212,57,31,4,2,39,7,"win_A",8,10,15,20,1,1,1,0,0.934426229508197,0.939393939393939,0.639344262295082,0.212121212121212,0,"orthodox"
"166430",43,28,190,191,206,208,234,240,55,16,4,6,37,15,"win_A",15,-1,-2,-6,1,0,0,0,0.932203389830508,0.727272727272727,0.627118644067797,0.681818181818182,0,"orthodox"
"166431",43,28,190,182,206,183,238,234,54,18,4,15,37,8,"win_A",15,8,23,4,1,0,0,0,0.931034482758621,0.545454545454545,0.637931034482759,0.242424242424242,0,"orthodox"
"166439",36,29,190,189,206,193,223,205,48,28,1,0,34,19,"win_B",7,1,13,18,1,0,1,0,0.979591836734694,1,0.693877551020408,0.678571428571429,1,"orthodox"
"166444",34,23,190,184,206,193,219,200,44,10,0,0,31,6,"win_A",11,6,13,19,0,0,1,0,1,1,0.704545454545455,0.6,0,"orthodox"
"166456",29,34,190,183,206,201,210,211,31,59,0,7,22,57,"win_A",-5,7,5,-1,0,0,0,0,1,0.893939393939394,0.709677419354839,0.863636363636364,0,"orthodox"
"166457",29,28,190,185,206,198,215,202,30,19,0,8,21,13,"win_A",1,5,8,13,0,0,0,0,1,0.703703703703704,0.7,0.481481481481481,0,"orthodox"
"166458",29,23,190,182,206,188,214,207,29,13,0,0,20,9,"win_A",6,8,18,7,0,0,0,0,1,1,0.689655172413793,0.692307692307692,0,"orthodox"
"166460",28,34,190,191,206,203,209,220,27,40,0,4,19,32,"win_A",-6,-1,3,-11,0,0,0,0,1,0.909090909090909,0.703703703703704,0.727272727272727,0,"orthodox"
"166461",28,32,190,183,206,201,210,210,26,54,0,6,19,52,"win_A",-4,7,5,0,0,0,0,0,1,0.9,0.730769230769231,0.866666666666667,0,"orthodox"
"166557",22,24,180,173,185,180,156,163,30,97,11,18,8,11,"win_B",-2,7,5,-7,0,0,0,0,0.731707317073171,0.843478260869565,0.195121951219512,0.0956521739130435,1,"Unknown"
"166558",19,24,179,173,182,180,155,164,44,97,9,17,6,11,"win_A",-5,6,2,-9,0,0,0,0,0.830188679245283,0.850877192982456,0.113207547169811,0.0964912280701754,0,"orthodox"
"166559",19,24,179,173,182,180,155,164,43,97,9,16,6,11,"win_A",-5,6,2,-9,0,0,0,0,0.826923076923077,0.858407079646018,0.115384615384615,0.0973451327433628,0,"orthodox"
"166684",30,26,177,177,180,174,153,154,41,37,2,4,30,23,"win_B",4,0,6,-1,0,0,0,0,0.953488372093023,0.902439024390244,0.697674418604651,0.560975609756098,1,"orthodox"
"166688",26,28,177,180,174,180,154,152,34,20,3,2,20,14,"win_A",-2,-3,-6,2,0,0,0,0,0.918918918918919,0.909090909090909,0.540540540540541,0.636363636363636,0,"orthodox"
"166691",24,25,177,171,174,168,149,149,31,29,3,1,17,15,"win_A",-1,6,6,0,0,0,0,0,0.911764705882353,0.966666666666667,0.5,0.5,0,"orthodox"
"166692",24,21,177,175,174,183,152,152,30,26,3,0,16,17,"win_A",3,2,-9,0,0,0,0,0,0.909090909090909,1,0.484848484848485,0.653846153846154,0,"orthodox"
"166695",23,29,177,177,174,183,151,154,27,33,3,4,14,24,"win_A",-6,0,-9,-3,0,0,0,0,0.9,0.891891891891892,0.466666666666667,0.648648648648649,0,"orthodox"
"166704",23,21,178,177,183,174,151,154,16,18,8,2,4,11,"win_B",2,1,9,-3,0,0,0,0,0.666666666666667,0.9,0.166666666666667,0.55,1,"orthodox"
"166706",25,21,177,177,185,174,154,155,10,16,0,2,9,11,"win_B",4,0,11,-1,0,0,0,0,1,0.888888888888889,0.9,0.611111111111111,1,"southpaw"
"166708",20,23,177,178,174,178,152,154,14,14,2,2,9,10,"win_A",-3,-1,-4,-2,0,0,0,0,0.875,0.875,0.5625,0.625,0,"orthodox"
"166725",36,32,168,172,178,178,141,138,65,26,7,4,43,21,"win_A",4,-4,0,3,1,0,0,0,0.902777777777778,0.866666666666667,0.597222222222222,0.7,0,"orthodox"
"166729",32,26,168,165,178,175,130,129,62,25,4,2,42,18,"win_A",6,3,3,1,0,0,0,0,0.939393939393939,0.925925925925926,0.636363636363636,0.666666666666667,0,"orthodox"
"166731",31,31,168,173,178,175,130,130,60,25,4,2,42,14,"win_A",0,-5,3,0,0,0,0,0,0.9375,0.925925925925926,0.65625,0.518518518518518,0,"orthodox"
"166733",29,35,168,170,178,180,126,126,56,54,3,5,39,36,"win_A",-6,-2,-2,0,0,1,0,0,0.949152542372881,0.915254237288136,0.661016949152542,0.610169491525424,0,"orthodox"
"166734",28,35,168,168,178,165,126,126,55,52,3,2,39,28,"win_A",-7,0,13,0,0,1,0,0,0.948275862068966,0.962962962962963,0.672413793103448,0.518518518518518,0,"orthodox"
"166735",27,29,168,173,178,175,126,125,53,28,3,1,38,21,"win_A",-2,-5,3,1,0,0,0,0,0.946428571428571,0.96551724137931,0.678571428571429,0.724137931034483,0,"orthodox"
"166737",26,37,168,168,178,165,122,122,51,62,3,9,37,37,"win_A",-11,0,13,0,0,1,0,0,0.944444444444444,0.873239436619718,0.685185185185185,0.52112676056338,0,"orthodox"
"166740",25,30,168,160,178,165,122,122,48,42,2,1,36,23,"win_A",-5,8,13,0,0,0,0,0,0.96,0.976744186046512,0.72,0.534883720930233,0,"orthodox"
"166742",24,31,168,173,178,178,122,121,46,22,2,3,34,9,"win_A",-7,-5,0,1,0,0,0,0,0.958333333333333,0.88,0.708333333333333,0.36,0,"orthodox"
"166743",24,27,168,165,178,157,124,122,45,31,2,12,33,8,"win_A",-3,3,21,2,0,0,0,0,0.957446808510638,0.720930232558139,0.702127659574468,0.186046511627907,0,"orthodox"
"166746",26,23,173,168,180,178,122,121,43,43,2,1,26,31,"win_A",3,5,2,1,0,0,0,0,0.955555555555556,0.977272727272727,0.577777777777778,0.704545454545455,0,"orthodox"
"166747",25,22,173,168,180,178,122,122,42,43,2,0,26,31,"win_A",3,5,2,0,0,0,0,0,0.954545454545455,1,0.590909090909091,0.720930232558139,0,"orthodox"
"166748",22,23,168,170,178,170,122,122,42,18,0,3,30,8,"win_A",-1,-2,8,0,0,0,0,0,1,0.857142857142857,0.714285714285714,0.380952380952381,0,"orthodox"
"166751",30,22,170,168,173,178,121,122,28,39,1,0,17,27,"win_B",8,2,-5,-1,0,0,0,0,0.96551724137931,1,0.586206896551724,0.692307692307692,1,"orthodox"
"166795",35,27,196,178,213,178,249,245,37,37,1,1,29,32,"win_A",8,18,35,4,1,0,0,0,0.973684210526316,0.973684210526316,0.763157894736842,0.842105263157895,0,"orthodox"
"166796",34,31,196,188,213,188,250,237,36,40,1,2,28,25,"win_A",3,8,25,13,0,0,0,0,0.972972972972973,0.952380952380952,0.756756756756757,0.595238095238095,0,"orthodox"
"166798",26,32,193,196,203,213,243,228,30,32,1,1,24,26,"win_B",-6,-3,-10,15,0,0,1,0,0.967741935483871,0.96969696969697,0.774193548387097,0.787878787878788,1,"orthodox"
"166799",32,29,196,193,213,201,244,244,31,28,1,2,25,25,"win_A",3,3,12,0,0,0,0,0,0.96875,0.933333333333333,0.78125,0.833333333333333,0,"orthodox"
"166801",31,31,196,188,213,208,251,237,29,28,1,6,24,20,"win_A",0,8,5,14,0,0,0,0,0.966666666666667,0.823529411764706,0.8,0.588235294117647,0,"orthodox"
"166802",35,30,185,196,196,213,247,238,23,28,3,1,16,24,"win_B",5,-11,-17,9,1,0,0,0,0.884615384615385,0.96551724137931,0.615384615384615,0.827586206896552,1,"orthodox"
"166803",26,30,188,196,193,213,241,227,45,27,2,1,39,23,"win_B",-4,-8,-20,14,0,0,0,0,0.957446808510638,0.964285714285714,0.829787234042553,0.821428571428571,1,"orthodox"
"166805",29,27,196,180,213,183,248,261,25,22,1,10,21,17,"win_A",2,16,30,-13,0,0,0,0,0.961538461538462,0.6875,0.807692307692308,0.53125,0,"orthodox"
"166807",28,29,196,185,213,201,235,218,24,30,0,1,20,27,"win_A",-1,11,12,17,0,0,1,0,1,0.967741935483871,0.833333333333333,0.870967741935484,0,"orthodox"
"166808",28,31,196,191,213,208,229,238,23,36,0,3,19,35,"win_A",-3,5,5,-9,0,0,0,0,1,0.923076923076923,0.826086956521739,0.897435897435897,0,"orthodox"
"166809",27,34,196,196,213,208,235,235,22,48,0,1,19,39,"win_A",-7,0,5,0,0,0,0,0,1,0.979591836734694,0.863636363636364,0.795918367346939,0,"orthodox"
"166813",26,31,196,183,213,191,225,228,18,16,0,5,16,9,"win_A",-5,13,22,-3,0,0,0,0,1,0.761904761904762,0.888888888888889,0.428571428571429,0,"orthodox"
"166816",25,40,196,185,213,198,221,215,15,35,0,15,13,25,"win_A",-15,11,15,6,0,1,0,0,1,0.7,0.866666666666667,0.5,0,"orthodox"
"166820",24,34,196,182,213,188,224,229,11,22,0,9,10,11,"win_A",-10,14,25,-5,0,0,0,0,1,0.709677419354839,0.909090909090909,0.354838709677419,0,"orthodox"
"166869",41,26,173,173,178,178,148,150,213,54,48,24,30,5,"win_A",15,0,0,-2,1,0,0,0,0.816091954022989,0.692307692307692,0.114942528735632,0.0641025641025641,0,"orthodox"
"166898",35,27,173,171,178,175,145,145,190,204,40,33,29,62,"win_A",8,2,3,0,1,0,0,0,0.826086956521739,0.860759493670886,0.126086956521739,0.261603375527426,0,"orthodox"
"166910",34,25,173,173,178,178,146,158,180,78,38,10,28,36,"win_B",9,0,0,-12,0,0,0,0,0.825688073394495,0.886363636363636,0.128440366972477,0.409090909090909,1,"orthodox"
"166924",33,24,173,173,178,178,146,155,166,58,38,8,27,25,"win_A",9,0,0,-9,0,0,0,0,0.813725490196078,0.878787878787879,0.132352941176471,0.378787878787879,0,"orthodox"
"166960",32,28,173,179,178,182,145,145,133,86,34,7,22,18,"win_A",4,-6,-4,0,0,0,0,0,0.796407185628742,0.924731182795699,0.131736526946108,0.193548387096774,0,"orthodox"
"166967",23,31,171,173,175,178,142,142,169,128,23,31,48,22,"win_A",-8,-2,-3,0,0,0,0,0,0.880208333333333,0.805031446540881,0.25,0.138364779874214,0,"Unknown"
"166972",23,31,171,173,175,178,145,144,159,128,23,26,45,22,"win_A",-8,-2,-3,1,0,0,0,0,0.873626373626374,0.831168831168831,0.247252747252747,0.142857142857143,0,"Unknown"
"166987",22,30,171,173,175,178,145,145,150,115,20,24,42,22,"win_B",-8,-2,-3,0,0,0,0,0,0.882352941176471,0.827338129496403,0.247058823529412,0.158273381294964,1,"Unknown"
"166989",30,28,173,166,178,183,133,145,113,83,24,17,22,27,"win_A",2,7,-5,-12,0,0,0,0,0.824817518248175,0.83,0.160583941605839,0.27,0,"orthodox"
"166997",21,29,171,173,175,178,144,134,138,108,15,21,40,22,"win_A",-8,-2,-3,10,0,0,0,0,0.901960784313726,0.837209302325581,0.261437908496732,0.170542635658915,0,"Unknown"
"167005",29,22,173,170,178,173,139,142,100,38,21,19,22,7,"win_A",7,3,5,-3,0,0,0,0,0.826446280991736,0.666666666666667,0.181818181818182,0.12280701754386,0,"orthodox"
"167030",27,24,173,179,178,182,135,134,79,39,17,2,18,12,"win_B",3,-6,-4,1,0,0,0,0,0.822916666666667,0.951219512195122,0.1875,0.292682926829268,1,"orthodox"
"167180",27,24,159,165,168,168,108,116,128,86,1,17,94,10,"win_A",3,-6,0,-8,0,0,0,0,0.992248062015504,0.83495145631068,0.728682170542636,0.0970873786407767,0,"orthodox"
"167310",33,32,179,180,183,184,160,160,48,42,3,1,25,35,"win_A",1,-1,-1,0,0,0,0,0,0.941176470588235,0.976744186046512,0.490196078431373,0.813953488372093,0,"southpaw"
"167314",27,22,180,178,184,178,154,154,38,20,0,0,31,18,"win_A",5,2,6,0,0,0,0,0,1,1,0.815789473684211,0.9,0,"orthodox"
"167317",26,28,180,185,184,191,147,147,34,36,0,1,29,27,"win_A",-2,-5,-7,0,0,0,0,0,1,0.972972972972973,0.852941176470588,0.72972972972973,0,"orthodox"
"167318",25,32,180,178,184,173,147,147,32,17,0,2,28,7,"win_A",-7,2,11,0,0,0,0,0,1,0.894736842105263,0.875,0.368421052631579,0,"orthodox"
"167319",24,32,180,180,184,180,153,153,31,27,0,4,27,19,"win_A",-8,0,4,0,0,0,0,0,1,0.870967741935484,0.870967741935484,0.612903225806452,0,"orthodox"
"167322",23,33,180,173,184,183,147,147,28,40,0,20,24,28,"win_A",-10,7,1,0,0,0,0,0,1,0.666666666666667,0.857142857142857,0.466666666666667,0,"orthodox"
"167328",31,21,169,180,175,184,147,147,43,22,2,0,20,19,"win_B",10,-11,-9,0,0,0,0,0,0.955555555555556,1,0.444444444444444,0.863636363636364,1,"southpaw"
"167329",20,28,180,173,184,180,147,145,21,19,0,5,18,11,"win_A",-8,7,4,2,0,0,0,0,1,0.791666666666667,0.857142857142857,0.458333333333333,0,"orthodox"
"167525",27,24,185,189,193,206,189,203,45,38,5,7,31,28,"win_B",3,-4,-13,-14,0,0,0,0,0.9,0.844444444444444,0.62,0.622222222222222,1,"orthodox"
"167526",26,29,185,183,193,193,188,205,44,35,4,9,30,12,"win_B",-3,2,0,-17,0,0,0,1,0.916666666666667,0.795454545454545,0.625,0.272727272727273,1,"orthodox"
"167528",24,27,185,183,193,193,188,197,42,34,4,8,29,12,"win_A",-3,2,0,-9,0,0,0,0,0.91304347826087,0.80952380952381,0.630434782608696,0.285714285714286,0,"orthodox"
"167530",23,26,185,180,193,188,185,190,40,50,4,23,28,15,"win_A",-3,5,5,-5,0,0,0,0,0.909090909090909,0.684931506849315,0.636363636363636,0.205479452054795,0,"orthodox"
"167578",33,29,163,161,164,160,124,124,91,63,21,21,49,40,"win_A",4,2,4,0,0,0,0,0,0.8125,0.75,0.4375,0.476190476190476,0,"orthodox"
"167694",24,30,192,156,201,165,148,205,24,84,7,11,11,51,"win_A",-6,36,36,-57,0,0,0,1,0.774193548387097,0.884210526315789,0.354838709677419,0.536842105263158,0,"orthodox"
"167715",28,24,156,182,165,197,148,158,66,28,7,1,43,23,"win_A",4,-26,-32,-10,0,0,0,0,0.904109589041096,0.96551724137931,0.589041095890411,0.793103448275862,0,"orthodox"
"167912",37,21,180,189,178,185,189,191,194,18,51,1,29,11,"win_B",16,-9,-7,-2,1,0,0,0,0.791836734693877,0.947368421052632,0.118367346938776,0.578947368421053,1,"orthodox"
"167926",36,29,180,191,178,211,183,200,184,14,47,7,29,8,"win_B",7,-11,-33,-17,1,0,0,1,0.796536796536797,0.666666666666667,0.125541125541126,0.380952380952381,1,"orthodox"
"167977",23,27,185,180,196,178,175,185,46,144,4,31,34,22,"win_A",-4,5,18,-10,0,0,0,0,0.92,0.822857142857143,0.68,0.125714285714286,0,"orthodox"
"167991",26,26,180,180,178,178,179,176,132,15,27,3,21,8,"win_A",0,0,0,3,0,0,0,0,0.830188679245283,0.833333333333333,0.132075471698113,0.444444444444444,0,"orthodox"
"168003",22,25,184,180,193,178,180,173,22,124,4,23,12,21,"win_A",-3,4,15,7,0,0,0,0,0.846153846153846,0.843537414965986,0.461538461538462,0.142857142857143,0,"orthodox"
"168012",25,24,171,180,183,178,174,168,154,116,8,22,53,21,"win_A",1,-9,5,6,0,0,0,0,0.950617283950617,0.840579710144927,0.327160493827161,0.152173913043478,0,"orthodox"
"168014",25,24,171,180,183,178,177,169,152,115,8,21,53,20,"win_A",1,-9,5,8,0,0,0,0,0.95,0.845588235294118,0.33125,0.147058823529412,0,"orthodox"
"168029",24,36,180,179,178,175,172,192,101,60,20,30,17,42,"win_A",-12,1,3,-20,0,1,0,1,0.834710743801653,0.666666666666667,0.140495867768595,0.466666666666667,0,"orthodox"
"168032",24,23,180,192,178,211,179,213,98,33,20,4,17,29,"win_A",1,-12,-33,-34,0,0,0,1,0.830508474576271,0.891891891891892,0.144067796610169,0.783783783783784,0,"orthodox"
"168035",24,28,180,179,178,185,180,183,95,21,20,15,17,19,"win_A",-4,1,-7,-3,0,0,0,0,0.826086956521739,0.583333333333333,0.147826086956522,0.527777777777778,0,"orthodox"
"168049",27,23,188,180,183,178,171,179,52,82,12,19,37,17,"win_A",4,8,5,-8,0,0,0,0,0.8125,0.811881188118812,0.578125,0.168316831683168,0,"orthodox"
"168074",22,30,180,197,178,208,175,208,62,4,14,10,15,3,"win_A",-8,-17,-30,-33,0,0,0,1,0.815789473684211,0.285714285714286,0.197368421052632,0.214285714285714,0,"orthodox"
"168077",22,27,180,179,178,185,171,200,59,20,14,8,15,19,"win_A",-5,1,-7,-29,0,0,0,1,0.808219178082192,0.714285714285714,0.205479452054795,0.678571428571429,0,"orthodox"
"168157",30,33,180,184,185,188,177,174,89,89,12,4,58,42,"win_B",-3,-4,-3,3,0,0,0,0,0.881188118811881,0.956989247311828,0.574257425742574,0.451612903225806,1,"orthodox"
"168169",28,31,184,184,193,188,176,187,70,79,12,2,31,33,"win_A",-3,0,5,-11,0,0,0,0,0.853658536585366,0.975308641975309,0.378048780487805,0.407407407407407,0,"orthodox"
"168199",29,26,184,180,188,196,170,192,48,11,0,8,10,5,"win_A",3,4,-8,-22,0,0,0,1,1,0.578947368421053,0.208333333333333,0.263157894736842,0,"orthodox"
"168204",28,27,184,174,188,180,162,162,43,35,0,24,9,18,"win_A",1,10,8,0,0,0,0,0,1,0.593220338983051,0.209302325581395,0.305084745762712,0,"orthodox"
"168228",24,21,184,184,188,193,163,163,17,14,0,2,8,6,"win_A",3,0,-5,0,0,0,0,0,1,0.875,0.470588235294118,0.375,0,"orthodox"
"168234",23,20,184,184,188,193,158,158,11,3,0,0,5,2,"win_A",3,0,-5,0,0,0,0,0,1,1,0.454545454545455,0.666666666666667,0,"orthodox"
"168237",22,25,184,166,188,183,159,156,8,53,0,14,4,23,"win_A",-3,18,5,3,0,0,0,0,1,0.791044776119403,0.5,0.343283582089552,0,"orthodox"
"168247",25,31,188,179,191,182,190,202,16,221,0,44,9,18,"win_B",-6,9,9,-12,0,0,0,0,1,0.833962264150943,0.5625,0.0679245283018868,1,"orthodox"
"168255",30,24,179,183,182,198,190,182,214,40,43,11,17,23,"win_A",6,-4,-16,8,0,0,0,0,0.832684824902724,0.784313725490196,0.066147859922179,0.450980392156863,0,"orthodox"
"168267",29,21,179,180,182,192,186,178,203,49,42,6,16,29,"win_A",8,-1,-10,8,0,0,0,0,0.828571428571429,0.890909090909091,0.0653061224489796,0.527272727272727,0,"orthodox"
"168274",28,21,179,180,182,192,182,180,199,48,39,4,16,29,"win_A",7,-1,-10,2,0,0,0,0,0.836134453781513,0.923076923076923,0.0672268907563025,0.557692307692308,0,"orthodox"
"168275",28,22,179,180,182,185,184,181,198,28,39,3,16,11,"win_A",6,-1,-3,3,0,0,0,0,0.835443037974684,0.903225806451613,0.0675105485232067,0.354838709677419,0,"orthodox"
"168285",28,23,179,182,182,187,181,172,188,87,39,13,14,30,"win_A",5,-3,-5,9,0,0,0,0,0.828193832599119,0.87,0.0616740088105727,0.3,0,"orthodox"
"168306",27,22,179,182,182,187,178,177,172,81,33,9,13,28,"win_B",5,-3,-5,1,0,0,0,0,0.839024390243902,0.9,0.0634146341463415,0.311111111111111,1,"orthodox"
"168313",26,21,179,185,182,193,178,184,166,25,31,4,13,19,"win_A",5,-6,-11,-6,0,0,0,0,0.842639593908629,0.862068965517241,0.065989847715736,0.655172413793103,0,"orthodox"
"168316",19,26,180,179,192,182,178,178,29,164,3,30,17,12,"win_A",-7,1,10,0,0,0,0,0,0.90625,0.845360824742268,0.53125,0.0618556701030928,0,"orthodox"
"168317",26,19,179,180,182,192,180,179,164,28,29,3,12,17,"win_B",7,-1,-10,1,0,0,0,0,0.849740932642487,0.903225806451613,0.0621761658031088,0.548387096774194,1,"orthodox"
"168321",26,31,179,180,182,185,176,182,160,75,29,29,12,26,"win_A",-5,-1,-3,-6,0,0,0,0,0.846560846560847,0.721153846153846,0.0634920634920635,0.25,0,"orthodox"
"168355",25,22,179,182,182,187,179,177,129,52,26,11,11,34,"win_B",3,-3,-5,2,0,0,0,0,0.832258064516129,0.825396825396825,0.0709677419354839,0.53968253968254,1,"orthodox"
"168375",24,23,179,189,182,185,182,202,113,28,22,11,10,13,"win_A",1,-10,-3,-20,0,0,0,1,0.837037037037037,0.717948717948718,0.0740740740740741,0.333333333333333,0,"orthodox"
"168379",24,18,179,187,182,222,180,178,109,23,22,9,9,8,"win_A",6,-8,-40,2,0,0,0,0,0.83206106870229,0.71875,0.0687022900763359,0.25,0,"orthodox"
"168387",23,24,179,174,182,173,172,165,101,65,22,16,8,24,"win_A",-1,5,9,7,0,0,0,0,0.821138211382114,0.802469135802469,0.0650406504065041,0.296296296296296,0,"orthodox"
"168392",23,24,179,189,182,191,173,182,97,35,21,7,8,21,"win_A",-1,-10,-9,-9,0,0,0,0,0.822033898305085,0.833333333333333,0.0677966101694915,0.5,0,"orthodox"
"168428",21,25,179,171,182,173,166,171,65,83,17,22,7,24,"win_B",-4,8,9,-5,0,0,0,0,0.792682926829268,0.79047619047619,0.0853658536585366,0.228571428571429,1,"orthodox"
"168434",21,25,179,171,182,173,165,164,60,83,16,21,7,24,"win_A",-4,8,9,1,0,0,0,0,0.789473684210526,0.798076923076923,0.0921052631578947,0.230769230769231,0,"orthodox"
"168441",20,23,179,178,182,180,168,168,57,46,12,5,7,14,"win_B",-3,1,2,0,0,0,0,0,0.826086956521739,0.901960784313726,0.101449275362319,0.274509803921569,1,"orthodox"
"168445",20,26,179,187,182,193,168,172,55,54,10,12,7,21,"win_B",-6,-8,-11,-4,0,0,0,0,0.846153846153846,0.818181818181818,0.107692307692308,0.318181818181818,1,"orthodox"
"168459",19,26,179,180,182,187,167,171,41,57,8,7,6,31,"win_B",-7,-1,-5,-4,0,0,0,0,0.836734693877551,0.890625,0.122448979591837,0.484375,1,"orthodox"
"168509",25,33,165,164,173,175,140,140,27,114,8,2,7,26,"win_A",-8,1,-2,0,0,0,0,0,0.771428571428571,0.982758620689655,0.2,0.224137931034483,0,"orthodox"
"168730",20,25,160,168,165,173,123,128,49,26,2,2,34,13,"win_A",-5,-8,-8,-5,0,0,0,0,0.96078431372549,0.928571428571429,0.666666666666667,0.464285714285714,0,"orthodox"
"168793",23,32,185,171,189,175,159,159,51,223,21,43,17,71,"win_A",-9,14,14,0,0,0,0,0,0.708333333333333,0.838345864661654,0.236111111111111,0.266917293233083,0,"Unknown"
"168813",28,28,180,171,185,175,157,175,85,210,11,36,54,66,"win_A",0,9,10,-18,0,0,0,1,0.885416666666667,0.853658536585366,0.5625,0.268292682926829,0,"orthodox"
"168824",26,25,171,173,175,178,155,158,202,83,32,10,61,38,"win_B",1,-2,-3,-3,0,0,0,0,0.863247863247863,0.89247311827957,0.260683760683761,0.408602150537634,1,"Unknown"
"168837",25,24,171,173,175,178,145,154,190,58,31,9,50,25,"win_B",1,-2,-3,-9,0,0,0,0,0.85972850678733,0.865671641791045,0.226244343891403,0.373134328358209,1,"Unknown"
"168844",24,24,171,171,175,178,142,142,183,51,28,12,50,10,"win_A",0,0,-3,0,0,0,0,0,0.867298578199052,0.80952380952381,0.23696682464455,0.158730158730159,0,"Unknown"
"168862",23,22,171,173,175,178,145,155,166,42,23,5,48,18,"win_A",1,-2,-3,-10,0,0,0,0,0.878306878306878,0.893617021276596,0.253968253968254,0.382978723404255,0,"Unknown"
"168879",22,26,171,171,175,176,142,139,148,60,20,29,42,5,"win_A",-4,0,-1,3,0,0,0,0,0.880952380952381,0.674157303370786,0.25,0.0561797752808989,0,"Unknown"
"168881",22,26,171,179,175,182,141,142,147,67,19,5,41,14,"win_B",-4,-8,-7,-1,0,0,0,0,0.885542168674699,0.930555555555556,0.246987951807229,0.194444444444444,1,"Unknown"
"168897",21,22,171,170,175,173,140,145,131,42,15,21,40,7,"win_A",-1,1,2,-5,0,0,0,0,0.897260273972603,0.666666666666667,0.273972602739726,0.111111111111111,0,"Unknown"
"168906",20,22,171,163,175,165,129,130,123,32,13,12,40,14,"win_B",-2,8,10,-1,0,0,0,0,0.904411764705882,0.727272727272727,0.294117647058824,0.318181818181818,1,"Unknown"
"169043",32,38,198,178,203,180,233,271,32,50,4,5,27,44,"win_A",-6,20,23,-38,0,1,0,1,0.888888888888889,0.909090909090909,0.75,0.8,0,"orthodox"
"169049",30,29,178,187,180,198,219,229,44,33,1,3,38,29,"win_A",1,-9,-18,-10,0,0,0,0,0.977777777777778,0.916666666666667,0.844444444444444,0.805555555555556,0,"orthodox"
"169050",29,34,178,191,180,208,220,247,43,40,1,4,37,38,"win_A",-5,-13,-28,-27,0,0,0,1,0.977272727272727,0.909090909090909,0.840909090909091,0.863636363636364,0,"orthodox"
"169051",29,25,178,183,180,191,219,224,42,20,1,0,36,6,"win_A",4,-5,-11,-5,0,0,0,0,0.976744186046512,1,0.837209302325581,0.3,0,"orthodox"
"169052",29,26,178,188,180,196,220,224,41,36,1,1,36,30,"win_A",3,-10,-16,-4,0,0,0,0,0.976190476190476,0.972972972972973,0.857142857142857,0.810810810810811,0,"orthodox"
"169053",24,27,178,191,180,208,216,238,40,25,1,2,36,18,"win_A",-3,-13,-28,-22,0,0,0,1,0.975609756097561,0.925925925925926,0.878048780487805,0.666666666666667,0,"orthodox"
"169054",24,27,178,191,180,208,217,228,39,25,1,1,35,18,"win_A",-3,-13,-28,-11,0,0,0,0,0.975,0.961538461538462,0.875,0.692307692307692,0,"orthodox"
"169056",23,29,178,191,180,197,217,215,37,20,1,4,33,14,"win_A",-6,-13,-17,2,0,0,0,0,0.973684210526316,0.833333333333333,0.868421052631579,0.583333333333333,0,"orthodox"
"169059",22,27,178,191,180,208,218,228,35,32,0,2,31,31,"win_A",-5,-13,-28,-10,0,0,0,0,1,0.941176470588235,0.885714285714286,0.911764705882353,0,"orthodox"
"169063",21,28,178,196,180,208,221,221,30,34,0,0,27,29,"win_A",-7,-18,-28,0,0,0,0,0,1,1,0.9,0.852941176470588,0,"orthodox"
"169065",20,33,178,193,180,208,219,233,28,19,0,5,26,14,"win_A",-13,-15,-28,-14,0,0,0,0,1,0.791666666666667,0.928571428571429,0.583333333333333,0,"orthodox"
"169072",19,24,178,191,180,198,217,218,21,18,0,4,19,13,"win_A",-5,-13,-18,-1,0,0,0,0,1,0.818181818181818,0.904761904761905,0.590909090909091,0,"orthodox"
"169102",36,28,178,178,188,191,176,172,70,56,9,18,31,37,"win_A",8,0,-3,4,1,0,0,0,0.886075949367089,0.756756756756757,0.392405063291139,0.5,0,"orthodox"
"169108",33,28,178,183,188,191,181,193,65,37,8,3,30,21,"win_A",5,-5,-3,-12,0,0,0,0,0.89041095890411,0.925,0.410958904109589,0.525,0,"orthodox"
"169112",32,25,178,180,188,193,175,174,61,19,8,8,27,7,"win_A",7,-2,-5,1,0,0,0,0,0.884057971014493,0.703703703703704,0.391304347826087,0.259259259259259,0,"orthodox"
"169146",36,22,183,178,188,188,180,197,45,29,14,1,28,15,"win_A",14,5,0,-17,1,0,0,1,0.76271186440678,0.966666666666667,0.474576271186441,0.5,0,"orthodox"
"169225",36,31,184,185,196,183,189,190,45,42,3,1,21,28,"win_A",5,-1,13,-1,1,0,0,0,0.9375,0.976744186046512,0.4375,0.651162790697674,0,"orthodox"
"169226",35,36,184,175,196,180,193,183,44,27,3,5,21,15,"win_A",-1,9,16,10,1,1,0,0,0.936170212765957,0.84375,0.446808510638298,0.46875,0,"orthodox"
"169235",22,29,180,184,183,196,175,175,21,36,3,1,20,19,"win_B",-7,-4,-13,0,0,0,0,0,0.875,0.972972972972973,0.833333333333333,0.513513513513513,1,"orthodox"
"169237",29,23,184,185,196,183,174,174,34,25,1,0,19,15,"win_A",6,-1,13,0,0,0,0,0,0.971428571428571,1,0.542857142857143,0.6,0,"orthodox"
"169238",29,25,184,182,196,193,175,175,33,19,1,1,19,13,"win_A",4,2,3,0,0,0,0,0,0.970588235294118,0.95,0.558823529411765,0.65,0,"orthodox"
"169239",28,28,184,183,196,183,175,175,32,30,1,2,19,17,"win_A",0,1,13,0,0,0,0,0,0.96969696969697,0.9375,0.575757575757576,0.53125,0,"orthodox"
"169255",23,32,184,180,196,193,175,173,16,68,0,23,11,49,"win_A",-9,4,3,2,0,0,0,0,1,0.747252747252747,0.6875,0.538461538461538,0,"orthodox"
"169285",26,30,178,182,185,193,173,168,42,66,1,6,27,51,"win_A",-4,-4,-8,5,0,0,0,0,0.976744186046512,0.916666666666667,0.627906976744186,0.708333333333333,0,"orthodox"
"169296",27,30,182,182,193,188,163,172,57,121,4,6,45,93,"win_A",-3,0,5,-9,0,0,0,0,0.934426229508197,0.952755905511811,0.737704918032787,0.732283464566929,0,"Unknown"
"169307",25,26,173,182,179,193,158,172,28,48,3,2,25,37,"win_A",-1,-9,-14,-14,0,0,0,0,0.903225806451613,0.96,0.806451612903226,0.74,0,"orthodox"
"169309",25,26,182,188,193,199,157,180,46,13,2,2,37,5,"win_A",-1,-6,-6,-23,0,0,0,1,0.958333333333333,0.866666666666667,0.770833333333333,0.333333333333333,0,"Unknown"
"169374",32,26,191,182,201,185,188,209,41,25,4,0,35,22,"win_B",6,9,16,-21,0,0,0,1,0.911111111111111,1,0.777777777777778,0.88,1,"orthodox"
"169383",30,34,191,180,201,187,177,177,32,34,4,6,26,18,"win_A",-4,11,14,0,0,0,0,0,0.888888888888889,0.85,0.722222222222222,0.45,0,"orthodox"
"169395",27,30,191,178,201,191,170,174,20,57,3,20,16,37,"win_A",-3,13,10,-4,0,0,0,0,0.869565217391304,0.74025974025974,0.695652173913043,0.480519480519481,0,"orthodox"
"169406",25,29,191,182,201,188,176,180,11,45,1,2,7,23,"win_B",-4,9,13,-4,0,0,0,0,0.916666666666667,0.957446808510638,0.583333333333333,0.48936170212766,1,"orthodox"
"169427",25,27,166,168,169,157,122,122,36,52,1,5,36,34,"win_A",-2,-2,12,0,0,0,0,0,0.972972972972973,0.912280701754386,0.972972972972973,0.596491228070175,0,"orthodox"
"169432",22,24,168,166,173,169,126,126,40,32,1,0,30,32,"win_A",-2,2,4,0,0,0,0,0,0.975609756097561,1,0.731707317073171,1,0,"orthodox"
"169443",21,27,166,173,169,170,122,122,21,52,0,0,21,51,"win_A",-6,-7,-1,0,0,0,0,0,1,1,1,0.980769230769231,0,"orthodox"
"169600",24,32,183,178,180,180,171,171,16,22,0,4,11,19,"win_A",-8,5,0,0,0,0,0,0,1,0.846153846153846,0.6875,0.730769230769231,0,"orthodox"
"169611",21,28,183,173,180,183,160,159,3,4,0,3,1,4,"win_A",-7,10,-3,1,0,0,0,0,1,0.571428571428571,0.333333333333333,0.571428571428571,0,"orthodox"
"169613",20,25,183,178,180,178,164,167,1,8,0,0,1,5,"win_A",-5,5,2,-3,0,0,0,0,1,1,1,0.625,0,"orthodox"
"169622",19,33,178,185,183,182,183,176,29,82,4,22,8,22,"win_A",-14,-7,1,7,0,0,0,0,0.878787878787879,0.788461538461538,0.242424242424242,0.211538461538462,0,"orthodox"
"169623",33,26,185,179,182,178,175,169,82,68,21,6,22,34,"win_B",7,6,4,6,0,0,0,0,0.796116504854369,0.918918918918919,0.213592233009709,0.459459459459459,1,"orthodox"
"169659",32,24,183,185,188,182,181,191,41,47,11,12,27,10,"win_A",8,-2,6,-10,0,0,0,0,0.788461538461538,0.796610169491525,0.519230769230769,0.169491525423729,0,"orthodox"
"169665",32,24,183,185,188,182,180,192,41,41,9,12,27,8,"win_B",8,-2,6,-12,0,0,0,0,0.82,0.773584905660377,0.54,0.150943396226415,1,"orthodox"
"169678",30,22,178,185,189,182,187,166,50,32,11,8,27,7,"win_A",8,-7,7,21,0,0,1,0,0.819672131147541,0.8,0.442622950819672,0.175,0,"orthodox"
"169698",20,22,185,182,182,193,178,176,15,26,3,5,5,10,"win_B",-2,3,-11,2,0,0,0,0,0.833333333333333,0.838709677419355,0.277777777777778,0.32258064516129,1,"orthodox"
"169775",31,22,171,173,173,173,134,134,86,70,19,8,38,13,"win_A",9,-2,0,0,0,0,0,0,0.819047619047619,0.897435897435897,0.361904761904762,0.166666666666667,0,"orthodox"
"169783",30,32,171,169,173,173,134,134,78,31,19,17,33,18,"win_A",-2,2,0,0,0,0,0,0,0.804123711340206,0.645833333333333,0.34020618556701,0.375,0,"orthodox"
"169858",20,20,174,171,178,173,136,131,63,16,4,6,41,4,"win_A",0,3,5,5,0,0,0,0,0.940298507462687,0.727272727272727,0.611940298507463,0.181818181818182,0,"orthodox"
"169886",31,21,180,175,191,175,160,158,78,17,3,0,32,8,"win_A",10,5,16,2,0,0,0,0,0.962962962962963,1,0.395061728395062,0.470588235294118,0,"orthodox"
"169967",38,25,170,165,173,165,122,122,51,12,7,2,26,10,"win_A",13,5,8,0,1,0,0,0,0.879310344827586,0.857142857142857,0.448275862068966,0.714285714285714,0,"southpaw"
"169968",37,29,170,170,173,178,122,122,50,32,7,2,26,20,"win_A",8,0,-5,0,1,0,0,0,0.87719298245614,0.941176470588235,0.456140350877193,0.588235294117647,0,"southpaw"
"169970",36,23,170,163,173,168,126,126,48,16,7,6,25,11,"win_A",13,7,5,0,1,0,0,0,0.872727272727273,0.727272727272727,0.454545454545455,0.5,0,"southpaw"
"169975",28,35,166,170,171,173,122,122,47,44,2,6,34,22,"win_A",-7,-4,-2,0,0,1,0,0,0.959183673469388,0.88,0.693877551020408,0.44,0,"orthodox"
"169977",33,27,170,164,173,165,122,122,43,21,5,5,22,11,"win_A",6,6,8,0,0,0,0,0,0.895833333333333,0.807692307692308,0.458333333333333,0.423076923076923,0,"southpaw"
"169981",32,26,170,164,173,165,122,122,40,18,4,4,22,9,"win_B",6,6,8,0,0,0,0,0,0.909090909090909,0.818181818181818,0.5,0.409090909090909,1,"southpaw"
"169995",27,24,170,168,173,160,118,118,28,23,2,0,15,13,"win_B",3,2,13,0,0,0,0,0,0.933333333333333,1,0.5,0.565217391304348,1,"southpaw"
"170031",39,28,160,170,165,180,118,118,60,17,3,2,41,10,"win_B",11,-10,-15,0,1,0,0,0,0.952380952380952,0.894736842105263,0.650793650793651,0.526315789473684,1,"orthodox"
"170044",36,25,160,173,165,174,120,120,48,23,2,6,32,7,"win_A",11,-13,-9,0,1,0,0,0,0.96,0.793103448275862,0.64,0.241379310344828,0,"orthodox"
"170047",24,36,168,160,171,165,118,118,17,46,2,1,5,31,"win_A",-12,8,6,0,0,1,0,0,0.894736842105263,0.978723404255319,0.263157894736842,0.659574468085106,0,"southpaw"
"170050",35,24,160,160,165,163,118,118,41,22,1,15,27,9,"win_A",11,0,2,0,1,0,0,0,0.976190476190476,0.594594594594595,0.642857142857143,0.243243243243243,0,"orthodox"
"170051",35,27,160,169,165,174,118,118,40,23,1,3,27,14,"win_A",8,-9,-9,0,1,0,0,0,0.975609756097561,0.884615384615385,0.658536585365854,0.538461538461538,0,"orthodox"
"170061",32,28,160,170,165,168,119,119,30,21,1,13,21,9,"win_A",4,-10,-3,0,0,0,0,0,0.967741935483871,0.617647058823529,0.67741935483871,0.264705882352941,0,"orthodox"
"170064",31,23,160,169,165,174,117,118,26,20,1,2,19,12,"win_A",8,-9,-9,-1,0,0,0,0,0.962962962962963,0.909090909090909,0.703703703703704,0.545454545454545,0,"orthodox"
"170068",30,29,160,165,165,165,118,118,22,17,1,5,16,12,"win_A",1,-5,0,0,0,0,0,0,0.956521739130435,0.772727272727273,0.695652173913043,0.545454545454545,0,"orthodox"
"170070",30,28,160,165,165,165,118,118,20,17,1,4,14,12,"win_A",2,-5,0,0,0,0,0,0,0.952380952380952,0.80952380952381,0.666666666666667,0.571428571428571,0,"orthodox"
"170087",31,27,172,160,173,165,117,118,35,4,2,0,28,3,"win_A",4,12,8,-1,0,0,0,0,0.945945945945946,1,0.756756756756757,0.75,0,"orthodox"
"170099",34,32,188,170,191,178,175,175,20,44,1,3,17,29,"win_A",2,18,13,0,0,0,0,0,0.952380952380952,0.936170212765957,0.80952380952381,0.617021276595745,0,"southpaw"
"170104",27,31,185,188,196,191,175,175,18,16,0,0,6,14,"win_A",-4,-3,5,0,0,0,0,0,1,1,0.333333333333333,0.875,0,"southpaw"
"170110",29,28,188,185,191,191,176,178,10,29,0,8,8,22,"win_A",1,3,0,-2,0,0,0,0,1,0.783783783783784,0.8,0.594594594594595,0,"southpaw"
"170123",38,30,185,187,196,203,185,193,55,18,4,7,36,15,"win_A",8,-2,-7,-8,1,0,0,0,0.932203389830508,0.72,0.610169491525424,0.6,0,"southpaw"
"170125",36,32,185,185,196,188,173,172,53,24,4,1,34,21,"win_A",4,0,8,1,1,0,0,0,0.929824561403509,0.96,0.596491228070175,0.84,0,"southpaw"
"170126",35,35,185,175,196,180,196,191,52,26,4,4,34,14,"win_A",0,10,16,5,1,1,0,0,0.928571428571429,0.866666666666667,0.607142857142857,0.466666666666667,0,"southpaw"
"170127",34,34,185,185,189,196,175,175,39,52,4,3,19,34,"win_A",0,0,-7,0,0,0,0,0,0.906976744186046,0.945454545454545,0.441860465116279,0.618181818181818,0,"southpaw"
"170134",32,29,185,180,196,191,179,176,45,9,3,4,29,6,"win_A",3,5,5,3,0,0,0,0,0.9375,0.692307692307692,0.604166666666667,0.461538461538462,0,"southpaw"
"170137",31,29,185,189,196,196,168,167,43,25,2,1,28,16,"win_B",2,-4,0,1,0,0,0,0,0.955555555555556,0.961538461538462,0.622222222222222,0.615384615384615,1,"southpaw"
"170138",31,25,185,188,196,183,195,205,42,19,2,5,27,16,"win_A",6,-3,13,-10,0,0,0,0,0.954545454545455,0.791666666666667,0.613636363636364,0.666666666666667,0,"southpaw"
"170139",28,30,178,185,183,196,167,168,21,42,13,1,5,27,"win_A",-2,-7,-13,-1,0,0,0,0,0.617647058823529,0.976744186046512,0.147058823529412,0.627906976744186,0,"orthodox"
"170143",29,30,185,185,196,195,168,168,38,19,1,3,25,15,"win_A",-1,0,1,0,0,0,0,0,0.974358974358974,0.863636363636364,0.641025641025641,0.681818181818182,0,"southpaw"
"170144",29,30,185,185,196,195,168,168,37,19,1,2,25,15,"win_A",-1,0,1,0,0,0,0,0,0.973684210526316,0.904761904761905,0.657894736842105,0.714285714285714,0,"southpaw"
"170145",28,28,185,179,196,177,168,168,36,23,1,1,24,17,"win_A",0,6,19,0,0,0,0,0,0.972972972972973,0.958333333333333,0.648648648648649,0.708333333333333,0,"southpaw"
"170147",27,30,185,173,196,185,160,158,34,45,0,4,23,27,"win_A",-3,12,11,2,0,0,0,0,1,0.918367346938776,0.676470588235294,0.551020408163265,0,"southpaw"
"170148",26,29,185,185,196,188,159,160,33,25,0,5,23,16,"win_A",-3,0,8,-1,0,0,0,0,1,0.833333333333333,0.696969696969697,0.533333333333333,0,"southpaw"
"170149",25,32,185,175,196,183,160,159,32,46,0,3,22,26,"win_A",-7,10,13,1,0,0,0,0,1,0.938775510204082,0.6875,0.530612244897959,0,"southpaw"
"170151",25,23,185,183,196,183,160,160,30,23,0,0,20,13,"win_A",2,2,13,0,0,0,0,0,1,1,0.666666666666667,0.565217391304348,0,"southpaw"
"170174",22,30,185,180,196,193,162,165,7,67,0,20,7,48,"win_A",-8,5,3,-3,0,0,0,0,1,0.770114942528736,1,0.551724137931034,0,"southpaw"
"170187",33,26,182,202,185,213,187,239,119,9,31,5,13,7,"win_A",7,-20,-28,-52,0,0,0,1,0.793333333333333,0.642857142857143,0.0866666666666667,0.5,0,"orthodox"
"170191",33,22,182,185,185,198,191,191,118,59,28,25,13,14,"win_B",11,-3,-13,0,0,0,0,0,0.808219178082192,0.702380952380952,0.089041095890411,0.166666666666667,1,"orthodox"
"170192",32,22,182,187,185,188,186,188,117,15,28,2,13,12,"win_A",10,-5,-3,-2,0,0,0,0,0.806896551724138,0.882352941176471,0.0896551724137931,0.705882352941177,0,"orthodox"
"170194",32,25,182,202,185,213,188,254,115,7,28,4,13,7,"win_A",7,-20,-28,-66,0,0,0,1,0.804195804195804,0.636363636363636,0.0909090909090909,0.636363636363636,0,"orthodox"
"170198",32,22,182,184,185,188,186,183,112,35,27,3,12,20,"win_A",10,-2,-3,3,0,0,0,0,0.805755395683453,0.921052631578947,0.0863309352517986,0.526315789473684,0,"orthodox"
"170202",31,27,182,197,185,216,186,270,112,77,23,6,12,62,"win_B",4,-15,-31,-84,0,0,0,1,0.82962962962963,0.927710843373494,0.0888888888888889,0.746987951807229,1,"orthodox"
"170204",30,30,182,183,185,193,183,202,110,36,23,11,12,12,"win_A",0,-1,-8,-19,0,0,0,1,0.827067669172932,0.765957446808511,0.0902255639097744,0.25531914893617,0,"orthodox"
"170207",30,26,182,185,185,224,185,189,108,35,22,21,12,31,"win_A",4,-3,-39,-4,0,0,0,0,0.830769230769231,0.625,0.0923076923076923,0.553571428571429,0,"orthodox"
"170217",28,24,182,183,185,193,185,177,103,72,17,25,12,21,"win_B",4,-1,-8,8,0,0,0,0,0.858333333333333,0.742268041237113,0.1,0.216494845360825,1,"orthodox"
"170227",27,21,182,188,185,191,189,200,94,29,16,9,12,8,"win_B",6,-6,-6,-11,0,0,0,0,0.854545454545454,0.763157894736842,0.109090909090909,0.210526315789474,1,"orthodox"
"170228",27,21,182,188,185,191,189,200,94,28,15,9,12,8,"win_B",6,-6,-6,-11,0,0,0,0,0.862385321100917,0.756756756756757,0.110091743119266,0.216216216216216,1,"orthodox"
"170232",26,24,182,189,185,191,174,170,91,35,14,5,12,21,"win_A",2,-7,-6,4,0,0,0,0,0.866666666666667,0.875,0.114285714285714,0.525,0,"orthodox"
"170241",25,21,182,183,185,193,178,180,81,54,14,9,12,19,"win_A",4,-1,-8,-2,0,0,0,0,0.852631578947368,0.857142857142857,0.126315789473684,0.301587301587302,0,"orthodox"
"170251",24,24,182,180,185,188,179,190,71,28,14,16,12,13,"win_A",0,2,-3,-11,0,0,0,0,0.835294117647059,0.636363636363636,0.141176470588235,0.295454545454545,0,"orthodox"
"170257",23,26,182,187,185,193,176,177,65,52,14,9,11,20,"win_A",-3,-5,-8,-1,0,0,0,0,0.822784810126582,0.852459016393443,0.139240506329114,0.327868852459016,0,"orthodox"
"170273",22,28,182,191,185,202,175,170,50,42,13,20,10,14,"win_A",-6,-9,-17,5,0,0,0,0,0.793650793650794,0.67741935483871,0.158730158730159,0.225806451612903,0,"orthodox"
"170274",22,20,182,185,185,189,170,173,50,109,12,8,10,40,"win_B",2,-3,-4,-3,0,0,0,0,0.806451612903226,0.931623931623932,0.161290322580645,0.341880341880342,1,"orthodox"
"170283",21,23,182,180,185,187,168,162,43,36,10,3,8,18,"win_B",-2,2,-2,6,0,0,0,0,0.811320754716981,0.923076923076923,0.150943396226415,0.461538461538462,1,"orthodox"
"170288",20,30,182,175,185,183,166,163,38,86,8,25,7,40,"win_B",-10,7,2,3,0,0,0,0,0.826086956521739,0.774774774774775,0.152173913043478,0.36036036036036,1,"orthodox"
"170300",19,25,182,169,185,180,163,160,28,73,3,17,7,22,"win_A",-6,13,5,3,0,0,0,0,0.903225806451613,0.811111111111111,0.225806451612903,0.244444444444444,0,"orthodox"
"170464",20,31,173,164,178,160,129,131,69,191,4,60,7,16,"win_A",-11,9,18,-2,0,0,0,0,0.945205479452055,0.760956175298805,0.0958904109589041,0.0637450199203187,0,"orthodox"
"170471",30,20,164,170,160,170,129,133,191,56,53,3,16,14,"win_B",10,-6,-10,-4,0,0,0,0,0.782786885245902,0.949152542372881,0.0655737704918033,0.23728813559322,1,"orthodox"
"170502",28,21,164,163,160,166,129,131,171,57,42,8,15,6,"win_A",7,1,-6,-2,0,0,0,0,0.802816901408451,0.876923076923077,0.0704225352112676,0.0923076923076923,0,"orthodox"
"170507",28,30,164,168,160,173,128,137,167,110,41,29,15,52,"win_B",-2,-4,-13,-9,0,0,0,0,0.802884615384615,0.79136690647482,0.0721153846153846,0.37410071942446,1,"orthodox"
"170518",27,28,164,156,160,165,134,134,156,112,41,25,14,63,"win_A",-1,8,-5,0,0,0,0,0,0.791878172588833,0.817518248175182,0.0710659898477157,0.45985401459854,0,"orthodox"
"170572",23,19,164,168,160,178,130,130,115,30,24,4,11,2,"win_B",4,-4,-18,0,0,0,0,0,0.827338129496403,0.882352941176471,0.079136690647482,0.0588235294117647,1,"orthodox"
"170588",23,18,164,168,160,178,130,126,101,28,22,4,10,2,"win_B",5,-4,-18,4,0,0,0,0,0.821138211382114,0.875,0.0813008130081301,0.0625,1,"orthodox"
"170603",22,22,164,168,160,174,130,132,87,36,20,9,9,9,"win_A",0,-4,-14,-2,0,0,0,0,0.813084112149533,0.8,0.0841121495327103,0.2,0,"orthodox"
"170617",23,21,164,164,174,160,130,139,26,74,9,19,13,9,"win_B",2,0,14,-9,0,0,0,0,0.742857142857143,0.795698924731183,0.371428571428571,0.0967741935483871,1,"Unknown"
"170618",21,29,164,170,160,170,130,136,73,80,19,33,9,20,"win_A",-8,-6,-10,-6,0,0,0,0,0.793478260869565,0.707964601769911,0.0978260869565217,0.176991150442478,0,"orthodox"
"170626",22,21,164,164,174,160,128,136,23,66,7,17,13,8,"win_B",1,0,14,-8,0,0,0,0,0.766666666666667,0.795180722891566,0.433333333333333,0.0963855421686747,1,"Unknown"
"170660",23,18,165,164,173,160,122,122,38,37,5,12,6,5,"win_A",5,1,13,0,0,0,0,0,0.883720930232558,0.755102040816326,0.13953488372093,0.102040816326531,0,"Unknown"
"170913",29,23,182,193,185,208,208,221,29,43,1,5,25,27,"win_A",6,-11,-23,-13,0,0,0,0,0.966666666666667,0.895833333333333,0.833333333333333,0.5625,0,"orthodox"
"170917",26,29,182,185,185,193,205,201,24,27,0,5,21,12,"win_A",-3,-3,-8,4,0,0,0,0,1,0.84375,0.875,0.375,0,"orthodox"
"170920",24,26,182,179,185,185,203,207,21,38,0,4,19,29,"win_A",-2,3,0,-4,0,0,0,0,1,0.904761904761905,0.904761904761905,0.69047619047619,0,"orthodox"
"170929",22,34,182,183,185,191,205,192,12,50,0,8,11,29,"win_A",-12,-1,-6,13,0,0,0,0,1,0.862068965517241,0.916666666666667,0.5,0,"orthodox"
"170942",34,35,164,163,168,168,126,126,63,41,7,9,48,27,"win_A",-1,1,0,0,0,1,0,0,0.9,0.82,0.685714285714286,0.54,0,"orthodox"
"170946",31,26,164,166,168,168,122,122,56,20,6,0,43,17,"win_A",5,-2,0,0,0,0,0,0,0.903225806451613,1,0.693548387096774,0.85,0,"orthodox"
"170948",31,33,164,168,168,170,120,120,54,35,6,3,41,18,"win_A",-2,-4,-2,0,0,0,0,0,0.9,0.921052631578947,0.683333333333333,0.473684210526316,0,"orthodox"
"170951",29,32,164,160,168,168,115,115,50,25,4,5,38,8,"win_A",-3,4,0,0,0,0,0,0,0.925925925925926,0.833333333333333,0.703703703703704,0.266666666666667,0,"orthodox"
"170956",26,35,164,165,168,165,111,115,43,37,3,2,33,24,"win_A",-9,-1,3,-4,0,1,0,0,0.934782608695652,0.948717948717949,0.717391304347826,0.615384615384615,0,"orthodox"
"170960",26,31,164,173,168,170,112,112,39,30,3,2,29,20,"win_A",-5,-9,-2,0,0,0,0,0,0.928571428571429,0.9375,0.69047619047619,0.625,0,"orthodox"
"170971",22,28,164,165,168,165,113,112,28,14,3,5,20,9,"win_A",-6,-1,3,1,0,0,0,0,0.903225806451613,0.736842105263158,0.645161290322581,0.473684210526316,0,"orthodox"
"170980",31,20,166,164,160,168,108,108,48,20,4,2,32,15,"win_A",11,2,-8,0,0,0,0,0,0.923076923076923,0.909090909090909,0.615384615384615,0.681818181818182,0,"orthodox"
"170985",18,27,164,165,168,170,117,119,15,39,2,14,11,30,"win_A",-9,-1,-2,-2,0,0,0,0,0.882352941176471,0.735849056603774,0.647058823529412,0.566037735849057,0,"orthodox"
"170986",18,26,164,165,168,170,108,108,14,39,2,13,11,30,"win_A",-8,-1,-2,0,0,0,0,0,0.875,0.75,0.6875,0.576923076923077,0,"orthodox"
"170987",18,23,164,156,168,152,108,108,14,22,1,8,11,11,"win_B",-5,8,16,0,0,0,0,0,0.933333333333333,0.733333333333333,0.733333333333333,0.366666666666667,1,"orthodox"
"170988",18,22,164,159,168,157,108,108,13,14,1,5,11,8,"win_A",-4,5,11,0,0,0,0,0,0.928571428571429,0.736842105263158,0.785714285714286,0.421052631578947,0,"orthodox"
"170997",16,20,164,160,168,164,109,107,4,4,0,0,4,1,"win_B",-4,4,4,2,0,0,0,0,1,1,1,0.25,1,"orthodox"
"171018",30,23,163,160,168,163,118,116,47,42,1,3,37,17,"win_B",7,3,5,2,0,0,0,0,0.979166666666667,0.933333333333333,0.770833333333333,0.377777777777778,1,"orthodox"
"171069",26,21,175,171,173,172,135,135,62,16,6,5,36,10,"win_A",5,4,1,0,0,0,0,0,0.911764705882353,0.761904761904762,0.529411764705882,0.476190476190476,0,"orthodox"
"171092",30,22,167,175,173,173,134,135,78,41,19,3,29,27,"win_A",8,-8,0,-1,0,0,0,0,0.804123711340206,0.931818181818182,0.298969072164948,0.613636363636364,0,"southpaw"
"171139",29,24,183,197,193,216,202,261,34,48,9,3,12,40,"win_A",5,-14,-23,-59,0,0,0,1,0.790697674418605,0.941176470588235,0.27906976744186,0.784313725490196,0,"orthodox"
"171140",27,30,183,192,193,208,197,205,33,65,8,10,11,29,"win_A",-3,-9,-15,-8,0,0,0,0,0.804878048780488,0.866666666666667,0.268292682926829,0.386666666666667,0,"orthodox"
"171141",24,26,185,183,189,193,192,182,214,31,10,8,108,10,"win_B",-2,2,-4,10,0,0,0,0,0.955357142857143,0.794871794871795,0.482142857142857,0.256410256410256,1,"orthodox"
"171145",25,28,183,180,193,187,192,178,27,71,8,10,8,39,"win_A",-3,3,6,14,0,0,0,0,0.771428571428571,0.876543209876543,0.228571428571429,0.481481481481481,0,"orthodox"
"171151",23,29,183,187,193,202,187,220,22,30,6,10,5,22,"win_A",-6,-4,-9,-33,0,0,0,1,0.785714285714286,0.75,0.178571428571429,0.55,0,"orthodox"
"171159",22,22,183,180,193,188,192,192,14,19,6,6,3,13,"win_A",0,3,5,0,0,0,0,0,0.7,0.76,0.15,0.52,0,"orthodox"
"171209",25,23,163,162,168,164,118,118,41,25,0,0,31,13,"win_A",2,1,4,0,0,0,0,0,1,1,0.75609756097561,0.52,0,"orthodox"
"171216",24,25,163,163,168,165,118,118,34,25,0,12,24,6,"win_A",-1,0,3,0,0,0,0,0,1,0.675675675675676,0.705882352941177,0.162162162162162,0,"orthodox"
"171266",24,28,168,170,175,170,136,132,21,17,0,8,19,3,"win_A",-4,-2,5,4,0,0,0,0,1,0.68,0.904761904761905,0.12,0,"orthodox"
"171464",31,26,179,180,173,180,189,205,47,66,0,11,41,38,"win_A",5,-1,-7,-16,0,0,0,1,1,0.857142857142857,0.872340425531915,0.493506493506494,0,"orthodox"
"171511",29,20,174,167,178,173,126,125,143,30,15,9,102,11,"win_A",9,7,5,1,0,0,0,0,0.905063291139241,0.769230769230769,0.645569620253165,0.282051282051282,0,"orthodox"
"171530",25,23,174,168,178,178,130,136,129,60,9,5,90,7,"win_B",2,6,0,-6,0,0,0,0,0.934782608695652,0.923076923076923,0.652173913043478,0.107692307692308,1,"orthodox"
"171549",23,21,174,168,178,171,130,130,110,38,7,15,76,16,"win_A",2,6,7,0,0,0,0,0,0.94017094017094,0.716981132075472,0.64957264957265,0.30188679245283,0,"orthodox"
"171569",22,27,174,168,178,165,128,136,90,63,6,17,60,21,"win_A",-5,6,13,-8,0,0,0,0,0.9375,0.7875,0.625,0.2625,0,"orthodox"
"171676",30,30,165,164,173,171,125,124,102,131,12,22,21,27,"win_A",0,1,2,1,0,0,0,0,0.894736842105263,0.856209150326797,0.184210526315789,0.176470588235294,0,"Unknown"
"171685",31,28,170,165,174,173,130,139,117,94,25,10,31,19,"win_B",3,5,1,-9,0,0,0,0,0.823943661971831,0.903846153846154,0.21830985915493,0.182692307692308,1,"Unknown"
"171694",27,22,165,168,173,174,130,130,86,37,9,11,17,9,"win_A",5,-3,-1,0,0,0,0,0,0.905263157894737,0.770833333333333,0.178947368421053,0.1875,0,"Unknown"
"171730",24,16,165,168,173,175,133,122,53,10,5,0,11,0,"win_A",8,-3,-2,11,0,0,0,0,0.913793103448276,1,0.189655172413793,0,0,"Unknown"
"171761",21,27,165,163,173,168,120,126,23,92,3,9,5,33,"win_B",-6,2,5,-6,0,0,0,0,0.884615384615385,0.910891089108911,0.192307692307692,0.326732673267327,1,"Unknown"
"171794",26,34,173,175,178,183,158,160,90,106,13,11,39,36,"win_B",-8,-2,-5,-2,0,0,0,0,0.87378640776699,0.905982905982906,0.378640776699029,0.307692307692308,1,"orthodox"
"171802",34,30,175,174,183,180,155,150,99,91,10,24,35,33,"win_A",4,1,3,5,0,0,0,0,0.908256880733945,0.791304347826087,0.321100917431193,0.28695652173913,0,"orthodox"
"171806",33,31,175,178,183,185,156,166,95,90,10,23,33,43,"win_A",2,-3,-2,-10,0,0,0,0,0.904761904761905,0.79646017699115,0.314285714285714,0.380530973451327,0,"orthodox"
"171815",24,32,173,175,178,183,158,158,65,88,9,8,28,30,"win_A",-8,-2,-5,0,0,0,0,0,0.878378378378378,0.916666666666667,0.378378378378378,0.3125,0,"orthodox"
"171835",28,26,175,170,183,175,152,153,68,105,5,1,26,50,"win_B",2,5,8,-1,0,0,0,0,0.931506849315068,0.990566037735849,0.356164383561644,0.471698113207547,1,"orthodox"
"171840",27,26,175,166,183,183,159,156,64,67,4,15,26,23,"win_A",1,9,0,3,0,0,0,0,0.941176470588235,0.817073170731707,0.382352941176471,0.280487804878049,0,"orthodox"
"171881",24,27,175,173,183,177,145,145,25,84,2,17,12,37,"win_A",-3,2,6,0,0,0,0,0,0.925925925925926,0.831683168316832,0.444444444444444,0.366336633663366,0,"orthodox"
"171969",29,26,175,161,184,171,117,117,81,80,9,2,37,23,"win_A",3,14,13,0,0,0,0,0,0.9,0.975609756097561,0.411111111111111,0.280487804878049,0,"orthodox"
"172024",23,23,175,163,184,175,115,112,32,20,3,9,14,3,"win_A",0,12,9,3,0,0,0,0,0.914285714285714,0.689655172413793,0.4,0.103448275862069,0,"orthodox"
"172066",28,34,185,178,201,185,159,157,37,44,1,1,27,24,"win_A",-6,7,16,2,0,0,0,0,0.973684210526316,0.977777777777778,0.710526315789474,0.533333333333333,0,"southpaw"
"172069",32,28,178,180,185,180,155,162,41,14,1,10,22,8,"win_A",4,-2,5,-7,0,0,0,0,0.976190476190476,0.583333333333333,0.523809523809524,0.333333333333333,0,"southpaw"
"172112",35,36,169,166,174,173,121,122,38,40,4,6,24,36,"win_A",-1,3,1,-1,1,1,0,0,0.904761904761905,0.869565217391304,0.571428571428571,0.782608695652174,0,"southpaw"
"172116",34,37,166,165,173,178,126,126,37,21,5,2,33,17,"win_A",-3,1,-5,0,0,1,0,0,0.880952380952381,0.91304347826087,0.785714285714286,0.739130434782609,0,"orthodox"
"172118",29,32,164,166,169,173,121,121,41,37,4,3,30,33,"win_A",-3,-2,-4,0,0,0,0,0,0.911111111111111,0.925,0.666666666666667,0.825,0,"orthodox"
"172121",30,28,166,168,173,178,118,118,34,18,3,0,30,15,"win_A",2,-2,-5,0,0,0,0,0,0.918918918918919,1,0.810810810810811,0.833333333333333,0,"orthodox"
"172123",29,31,166,165,173,169,118,117,32,31,3,4,29,20,"win_A",-2,1,4,1,0,0,0,0,0.914285714285714,0.885714285714286,0.828571428571429,0.571428571428571,0,"orthodox"
"172127",27,31,166,166,173,180,118,118,28,25,3,0,26,22,"win_A",-4,0,-7,0,0,0,0,0,0.903225806451613,1,0.838709677419355,0.88,0,"orthodox"
"172131",26,20,166,170,173,173,117,117,24,20,3,1,23,19,"win_A",6,-4,0,0,0,0,0,0,0.888888888888889,0.952380952380952,0.851851851851852,0.904761904761905,0,"orthodox"
"172135",23,25,164,166,168,173,118,119,22,21,3,2,13,20,"win_A",-2,-2,-5,-1,0,0,0,0,0.88,0.91304347826087,0.52,0.869565217391304,0,"orthodox"
"172367",26,18,160,164,168,174,123,125,59,39,10,3,11,9,"win_B",8,-4,-6,-2,0,0,0,0,0.855072463768116,0.928571428571429,0.159420289855072,0.214285714285714,1,"orthodox"
"172384",25,20,160,168,168,165,124,123,45,57,7,1,8,31,"win_A",5,-8,3,1,0,0,0,0,0.865384615384615,0.982758620689655,0.153846153846154,0.53448275862069,0,"orthodox"
"172387",24,21,160,163,168,161,124,124,42,38,7,2,8,14,"win_A",3,-3,7,0,0,0,0,0,0.857142857142857,0.95,0.163265306122449,0.35,0,"orthodox"
"172436",26,22,164,165,163,157,126,126,34,26,0,1,30,23,"win_A",4,-1,6,0,0,0,0,0,1,0.962962962962963,0.882352941176471,0.851851851851852,0,"southpaw"
"172438",25,28,164,168,163,171,126,126,32,54,0,7,29,40,"win_A",-3,-4,-8,0,0,0,0,0,1,0.885245901639344,0.90625,0.655737704918033,0,"southpaw"
"172440",28,24,170,164,168,163,125,124,22,30,1,0,14,28,"win_B",4,6,5,1,0,0,0,0,0.956521739130435,1,0.608695652173913,0.933333333333333,1,"orthodox"
"172443",23,27,164,165,163,173,126,125,27,20,0,1,25,15,"win_A",-4,-1,-10,1,0,0,0,0,1,0.952380952380952,0.925925925925926,0.714285714285714,0,"southpaw"
"172486",31,23,185,180,224,192,186,209,59,85,31,9,54,48,"win_A",8,5,32,-23,0,0,0,1,0.655555555555556,0.904255319148936,0.6,0.51063829787234,0,"orthodox"
"172521",21,28,180,182,192,191,178,178,52,65,7,12,31,43,"win_A",-7,-2,1,0,0,0,0,0,0.88135593220339,0.844155844155844,0.525423728813559,0.558441558441558,0,"orthodox"
"172531",20,26,180,178,192,183,179,176,43,47,4,14,26,19,"win_A",-6,2,9,3,0,0,0,0,0.914893617021277,0.770491803278688,0.553191489361702,0.311475409836066,0,"orthodox"
"172538",29,20,189,180,191,192,176,187,47,37,25,3,26,22,"win_A",9,9,-1,-11,0,0,0,0,0.652777777777778,0.925,0.361111111111111,0.55,0,"orthodox"
"172551",27,18,189,180,191,192,172,184,41,22,18,2,24,14,"win_B",9,9,-1,-12,0,0,0,0,0.694915254237288,0.916666666666667,0.406779661016949,0.583333333333333,1,"orthodox"
"172583",27,29,173,175,175,175,159,153,46,58,4,33,20,28,"win_A",-2,-2,0,6,0,0,0,0,0.92,0.637362637362637,0.4,0.307692307692308,0,"orthodox"
"172585",26,22,173,173,175,168,160,156,44,28,4,10,20,15,"win_A",4,0,7,4,0,0,0,0,0.916666666666667,0.736842105263158,0.416666666666667,0.394736842105263,0,"orthodox"
"172586",26,33,173,177,175,180,159,160,43,42,4,39,20,21,"win_A",-7,-4,-5,-1,0,0,0,0,0.914893617021277,0.518518518518518,0.425531914893617,0.259259259259259,0,"orthodox"
"172634",24,28,157,160,163,163,116,116,50,50,3,8,17,19,"win_A",-4,-3,0,0,0,0,0,0,0.943396226415094,0.862068965517241,0.320754716981132,0.327586206896552,0,"orthodox"
"172691",35,34,170,170,170,183,140,140,30,55,1,3,24,30,"win_A",1,0,-13,0,1,0,0,0,0.967741935483871,0.948275862068966,0.774193548387097,0.517241379310345,0,"orthodox"
"172692",33,36,170,165,170,170,140,139,29,43,1,5,23,17,"win_A",-3,5,0,1,0,1,0,0,0.966666666666667,0.895833333333333,0.766666666666667,0.354166666666667,0,"orthodox"
"172699",28,27,170,180,170,180,140,140,20,52,1,3,16,41,"win_A",1,-10,-10,0,0,0,0,0,0.952380952380952,0.945454545454545,0.761904761904762,0.745454545454545,0,"orthodox"
"172702",33,27,171,170,178,170,140,140,35,18,3,0,24,14,"win_A",6,1,8,0,0,0,0,0,0.921052631578947,1,0.631578947368421,0.777777777777778,0,"orthodox"
"172711",23,32,170,173,170,188,140,143,9,34,0,11,8,22,"win_A",-9,-3,-18,-3,0,0,0,0,1,0.755555555555556,0.888888888888889,0.488888888888889,0,"orthodox"
"172713",23,27,170,179,170,173,141,140,7,16,0,0,6,9,"win_A",-4,-9,-3,1,0,0,0,0,1,1,0.857142857142857,0.5625,0,"orthodox"
"172760",31,28,174,180,180,196,162,185,106,34,27,27,40,16,"win_A",3,-6,-16,-23,0,0,0,1,0.796992481203007,0.557377049180328,0.300751879699248,0.262295081967213,0,"Unknown"
"172774",29,30,175,174,183,180,165,159,78,93,22,25,36,34,"win_A",-1,1,3,6,0,0,0,0,0.78,0.788135593220339,0.36,0.288135593220339,0,"orthodox"
"172833",19,24,168,174,180,180,159,159,28,41,4,10,17,16,"win_A",-5,-6,0,0,0,0,0,0,0.875,0.803921568627451,0.53125,0.313725490196078,0,"orthodox"
"172836",23,19,174,168,180,180,160,155,38,24,10,3,16,15,"win_A",4,6,0,5,0,0,0,0,0.791666666666667,0.888888888888889,0.333333333333333,0.555555555555556,0,"Unknown"
"172884",27,37,185,179,201,183,159,157,36,51,1,4,27,25,"win_A",-10,6,18,2,0,1,0,0,0.972972972972973,0.927272727272727,0.72972972972973,0.454545454545455,0,"southpaw"
"172886",31,28,179,173,183,183,154,154,45,26,3,4,25,16,"win_A",3,6,0,0,0,0,0,0,0.9375,0.866666666666667,0.520833333333333,0.533333333333333,0,"southpaw"
"172891",29,32,179,176,183,189,153,154,40,16,3,6,24,11,"win_A",-3,3,-6,-1,0,0,0,0,0.930232558139535,0.727272727272727,0.558139534883721,0.5,0,"southpaw"
"172892",28,29,179,183,183,183,153,152,39,42,3,2,24,29,"win_A",-1,-4,0,1,0,0,0,0,0.928571428571429,0.954545454545455,0.571428571428571,0.659090909090909,0,"southpaw"
"172893",28,21,179,178,183,178,154,154,39,17,2,0,24,17,"win_B",7,1,5,0,0,0,0,0,0.951219512195122,1,0.585365853658537,1,1,"southpaw"
"172899",24,25,179,183,183,183,152,154,34,28,1,1,21,20,"win_A",-1,-4,0,-2,0,0,0,0,0.971428571428571,0.96551724137931,0.6,0.689655172413793,0,"southpaw"
"172900",24,29,179,177,183,185,154,154,33,25,1,3,21,17,"win_A",-5,2,-2,0,0,0,0,0,0.970588235294118,0.892857142857143,0.617647058823529,0.607142857142857,0,"southpaw"
"172907",24,23,183,179,191,183,154,154,17,26,4,1,4,19,"win_B",1,4,8,0,0,0,0,0,0.80952380952381,0.962962962962963,0.19047619047619,0.703703703703704,1,"orthodox"
"172908",22,28,179,175,183,170,157,157,25,25,1,6,18,7,"win_A",-6,4,13,0,0,0,0,0,0.961538461538462,0.806451612903226,0.692307692307692,0.225806451612903,0,"southpaw"
"172916",21,29,179,168,183,165,153,153,18,9,0,14,12,0,"win_A",-8,11,18,0,0,0,0,0,1,0.391304347826087,0.666666666666667,0,0,"southpaw"
"172959",26,34,182,182,185,188,182,190,7,129,1,15,5,97,"win_A",-8,0,-3,-8,0,0,0,0,0.875,0.895833333333333,0.625,0.673611111111111,0,"Unknown"
"172980",29,40,182,183,188,185,180,190,114,33,6,7,89,30,"win_A",-11,-1,3,-10,0,1,0,0,0.95,0.825,0.741666666666667,0.75,0,"orthodox"
"172981",40,29,183,182,185,188,171,180,32,114,7,5,29,89,"win_A",11,1,-3,-9,1,0,0,0,0.82051282051282,0.957983193277311,0.743589743589744,0.747899159663866,0,"orthodox"
"173046",35,23,183,182,185,188,175,187,23,50,1,3,20,36,"win_A",12,1,-3,-12,1,0,0,0,0.958333333333333,0.943396226415094,0.833333333333333,0.679245283018868,0,"orthodox"
"173100",30,38,170,175,170,175,154,154,35,29,2,7,28,23,"win_A",-8,-5,-5,0,0,1,0,0,0.945945945945946,0.805555555555556,0.756756756756757,0.638888888888889,0,"orthodox"
"173102",28,31,170,173,170,178,146,147,33,35,1,2,27,21,"win_A",-3,-3,-8,-1,0,0,0,0,0.970588235294118,0.945945945945946,0.794117647058823,0.567567567567568,0,"orthodox"
"173106",26,30,170,177,170,183,146,147,27,23,0,0,22,18,"win_A",-4,-7,-13,-1,0,0,0,0,1,1,0.814814814814815,0.782608695652174,0,"orthodox"
"173113",23,32,170,173,170,173,140,138,19,38,0,6,16,24,"win_A",-9,-3,-3,2,0,0,0,0,1,0.863636363636364,0.842105263157895,0.545454545454545,0,"orthodox"
"173115",23,32,170,179,170,185,140,139,17,17,0,0,14,16,"win_A",-9,-9,-15,1,0,0,0,0,1,1,0.823529411764706,0.941176470588235,0,"orthodox"
"173116",22,30,170,170,170,180,140,140,16,26,0,4,13,18,"win_A",-8,0,-10,0,0,0,0,0,1,0.866666666666667,0.8125,0.6,0,"orthodox"
"173118",22,31,170,171,170,169,140,140,14,34,0,5,11,20,"win_A",-9,-1,1,0,0,0,0,0,1,0.871794871794872,0.785714285714286,0.512820512820513,0,"orthodox"
"173119",22,28,170,180,170,191,140,139,13,39,0,5,10,27,"win_A",-6,-10,-21,1,0,0,0,0,1,0.886363636363636,0.769230769230769,0.613636363636364,0,"orthodox"
"173123",21,29,170,171,170,183,138,137,9,36,0,6,7,26,"win_A",-8,-1,-13,1,0,0,0,0,1,0.857142857142857,0.777777777777778,0.619047619047619,0,"orthodox"
"173133",29,27,183,182,194,185,224,215,18,10,0,1,15,7,"win_A",2,1,9,9,0,0,0,0,1,0.909090909090909,0.833333333333333,0.636363636363636,0,"orthodox"
"173134",36,28,185,183,185,194,210,183,11,17,3,0,5,14,"win_B",8,2,-9,27,1,0,1,0,0.785714285714286,1,0.357142857142857,0.823529411764706,1,"orthodox"
"173135",26,29,183,188,194,199,218,200,15,27,0,6,12,15,"win_A",-3,-5,-5,18,0,0,1,0,1,0.818181818181818,0.8,0.454545454545455,0,"orthodox"
"173137",33,25,185,183,185,194,218,188,10,13,2,0,4,10,"win_B",8,2,-9,30,0,0,1,0,0.833333333333333,1,0.333333333333333,0.769230769230769,1,"orthodox"
"173139",24,25,183,173,194,179,210,183,11,30,0,3,9,27,"win_A",-1,10,15,27,0,0,1,0,1,0.909090909090909,0.818181818181818,0.818181818181818,0,"orthodox"
"173140",23,24,183,193,194,201,212,187,9,11,0,5,8,9,"win_A",-1,-10,-7,25,0,0,1,0,1,0.6875,0.888888888888889,0.5625,0,"orthodox"
"173143",22,36,183,187,194,196,218,195,6,51,0,3,6,29,"win_A",-14,-4,-2,23,0,1,1,0,1,0.944444444444444,1,0.537037037037037,0,"orthodox"
"173144",22,40,183,183,194,185,201,194,5,32,0,6,5,29,"win_A",-18,0,9,7,0,1,0,0,1,0.842105263157895,1,0.763157894736842,0,"orthodox"
"173154",37,30,182,179,189,177,175,174,45,29,2,2,34,23,"win_A",7,3,12,1,1,0,0,0,0.957446808510638,0.935483870967742,0.723404255319149,0.741935483870968,0,"orthodox"
"173157",35,32,182,185,189,186,167,167,42,12,1,6,34,9,"win_A",3,-3,3,0,1,0,0,0,0.976744186046512,0.666666666666667,0.790697674418605,0.5,0,"orthodox"
"173163",33,25,182,183,189,180,159,160,36,16,1,0,31,6,"win_A",8,-1,9,-1,0,0,0,0,0.972972972972973,1,0.837837837837838,0.375,0,"orthodox"
"173202",36,34,179,180,191,201,211,184,77,126,18,35,61,68,"win_A",2,-1,-10,27,1,0,1,0,0.810526315789474,0.782608695652174,0.642105263157895,0.422360248447205,0,"orthodox"
"173222",29,30,179,180,191,185,206,191,56,32,10,6,51,23,"win_A",-1,-1,6,15,0,0,1,0,0.848484848484849,0.842105263157895,0.772727272727273,0.605263157894737,0,"orthodox"
"173224",28,29,179,180,191,185,212,198,54,28,10,5,49,19,"win_A",-1,-1,6,14,0,0,0,0,0.84375,0.848484848484849,0.765625,0.575757575757576,0,"orthodox"
"173227",27,28,179,185,191,194,197,191,50,24,6,10,47,20,"win_A",-1,-6,-3,6,0,0,0,0,0.892857142857143,0.705882352941177,0.839285714285714,0.588235294117647,0,"orthodox"
"173267",27,22,178,179,188,191,208,185,12,12,10,4,6,12,"win_A",5,-1,-3,23,0,0,1,0,0.545454545454545,0.75,0.272727272727273,0.75,0,"orthodox"
"173281",32,34,175,168,173,174,154,146,127,91,24,23,60,44,"win_A",-2,7,-1,8,0,0,0,0,0.841059602649007,0.798245614035088,0.397350993377483,0.385964912280702,0,"orthodox"
"173296",27,27,175,168,173,173,135,133,120,50,16,11,57,19,"win_B",0,7,0,2,0,0,0,0,0.882352941176471,0.819672131147541,0.419117647058824,0.311475409836066,1,"orthodox"
"173298",27,29,175,168,173,174,142,146,118,88,16,20,57,44,"win_A",-2,7,-1,-4,0,0,0,0,0.880597014925373,0.814814814814815,0.425373134328358,0.407407407407407,0,"orthodox"
"173303",27,25,175,169,173,178,144,138,114,40,15,7,54,8,"win_A",2,6,-5,6,0,0,0,0,0.883720930232558,0.851063829787234,0.418604651162791,0.170212765957447,0,"orthodox"
"173315",26,25,175,168,173,174,135,134,105,70,12,7,51,28,"win_A",1,7,-1,1,0,0,0,0,0.897435897435897,0.909090909090909,0.435897435897436,0.363636363636364,0,"orthodox"
"173320",25,24,175,173,173,185,135,133,100,66,12,8,50,39,"win_A",1,2,-12,2,0,0,0,0,0.892857142857143,0.891891891891892,0.446428571428571,0.527027027027027,0,"orthodox"
"173329",24,27,175,168,173,174,134,134,93,73,10,12,45,38,"win_A",-3,7,-1,0,0,0,0,0,0.902912621359223,0.858823529411765,0.436893203883495,0.447058823529412,0,"orthodox"
"173330",24,23,175,173,173,185,135,134,92,57,10,7,45,34,"win_A",1,2,-12,1,0,0,0,0,0.901960784313726,0.890625,0.441176470588235,0.53125,0,"orthodox"
"173334",24,23,175,168,173,174,136,137,88,54,10,5,45,22,"win_A",1,7,-1,-1,0,0,0,0,0.897959183673469,0.915254237288136,0.459183673469388,0.372881355932203,0,"orthodox"
"173356",22,30,175,171,173,178,136,140,68,75,8,22,33,12,"win_B",-8,4,-5,-4,0,0,0,0,0.894736842105263,0.77319587628866,0.434210526315789,0.123711340206186,1,"orthodox"
"173361",21,27,175,165,173,168,131,133,64,130,7,22,32,47,"win_A",-6,10,5,-2,0,0,0,0,0.901408450704225,0.855263157894737,0.450704225352113,0.309210526315789,0,"orthodox"
"173540",30,26,170,189,180,193,173,174,19,22,1,0,12,16,"win_B",4,-19,-13,-1,0,0,0,0,0.95,1,0.6,0.727272727272727,1,"orthodox"
"173560",20,24,189,183,193,178,167,178,2,20,0,9,1,4,"win_A",-4,6,15,-11,0,0,0,0,1,0.689655172413793,0.5,0.137931034482759,0,"orthodox"
"173661",22,26,170,160,175,170,126,134,66,71,1,9,39,26,"win_A",-4,10,5,-8,0,0,0,0,0.985074626865672,0.8875,0.582089552238806,0.325,0,"Unknown"
"173672",25,27,160,163,170,168,129,122,62,84,7,8,23,31,"win_B",-2,-3,2,7,0,0,0,0,0.898550724637681,0.91304347826087,0.333333333333333,0.33695652173913,1,"Unknown"
"173687",20,23,164,160,166,170,132,118,33,49,1,5,18,23,"win_B",-3,4,-4,14,0,0,0,0,0.970588235294118,0.907407407407407,0.529411764705882,0.425925925925926,1,"Unknown"
"173702",20,19,160,163,170,170,117,117,34,31,5,6,12,16,"win_A",1,-3,0,0,0,0,0,0,0.871794871794872,0.837837837837838,0.307692307692308,0.432432432432432,0,"Unknown"
"173743",35,24,179,183,178,189,176,176,92,29,13,5,45,18,"win_A",11,-4,-11,0,1,0,0,0,0.876190476190476,0.852941176470588,0.428571428571429,0.529411764705882,0,"orthodox"
"173768",27,24,179,177,178,175,166,161,70,41,7,3,34,24,"win_A",3,2,3,5,0,0,0,0,0.909090909090909,0.931818181818182,0.441558441558442,0.545454545454545,0,"orthodox"
"173796",22,36,179,178,178,189,167,168,42,70,4,23,23,36,"win_A",-14,1,-11,-1,0,1,0,0,0.91304347826087,0.752688172043011,0.5,0.387096774193548,0,"orthodox"
"173803",21,27,179,173,178,182,152,158,36,48,2,19,22,26,"win_A",-6,6,-4,-6,0,0,0,0,0.947368421052632,0.716417910447761,0.578947368421053,0.388059701492537,0,"orthodox"
"173806",21,24,179,177,178,180,162,155,33,22,2,14,21,14,"win_A",-3,2,-2,7,0,0,0,0,0.942857142857143,0.611111111111111,0.6,0.388888888888889,0,"orthodox"
"173866",33,23,165,169,173,170,145,146,55,21,14,0,14,12,"win_A",10,-4,3,-1,0,0,0,0,0.797101449275362,1,0.202898550724638,0.571428571428571,0,"orthodox"
"173869",23,32,172,165,176,173,145,143,26,53,0,13,18,14,"win_A",-9,7,3,2,0,0,0,0,1,0.803030303030303,0.692307692307692,0.212121212121212,0,"orthodox"
"173892",26,32,165,170,173,173,143,144,32,24,9,12,8,8,"win_A",-6,-5,0,-1,0,0,0,0,0.780487804878049,0.666666666666667,0.195121951219512,0.222222222222222,0,"orthodox"
"174125",25,32,188,182,198,193,184,200,18,80,1,22,14,29,"win_B",-7,6,5,-16,0,0,0,1,0.947368421052632,0.784313725490196,0.736842105263158,0.284313725490196,1,"orthodox"
"174130",31,23,182,189,193,188,179,202,77,31,19,14,28,17,"win_A",8,-7,5,-23,0,0,0,1,0.802083333333333,0.688888888888889,0.291666666666667,0.377777777777778,0,"orthodox"
"174132",31,23,182,189,193,188,184,200,75,31,19,13,28,17,"win_A",8,-7,5,-16,0,0,0,1,0.797872340425532,0.704545454545455,0.297872340425532,0.386363636363636,0,"orthodox"
"174141",29,21,182,189,193,188,186,204,68,17,15,7,25,11,"win_A",8,-7,5,-18,0,0,0,1,0.819277108433735,0.708333333333333,0.301204819277108,0.458333333333333,0,"orthodox"
"174146",28,28,174,182,185,193,185,222,47,63,8,11,34,24,"win_B",0,-8,-8,-37,0,0,0,1,0.854545454545454,0.851351351351351,0.618181818181818,0.324324324324324,1,"orthodox"
"174160",32,26,183,182,188,193,192,196,37,52,9,5,25,20,"win_A",6,1,-5,-4,0,0,0,0,0.804347826086957,0.912280701754386,0.543478260869565,0.350877192982456,0,"orthodox"
"174189",21,25,182,171,193,185,180,206,23,29,2,12,10,9,"win_B",-4,11,8,-26,0,0,0,1,0.92,0.707317073170732,0.4,0.219512195121951,1,"orthodox"
"174196",20,23,182,173,193,183,161,163,18,40,0,8,9,8,"win_A",-3,9,10,-2,0,0,0,0,1,0.833333333333333,0.5,0.166666666666667,0,"orthodox"
"174218",21,30,171,174,187,180,130,130,14,47,0,4,8,16,"win_A",-9,-3,7,0,0,0,0,0,1,0.92156862745098,0.571428571428571,0.313725490196078,0,"orthodox"
"174227",26,27,174,170,180,170,130,130,39,16,3,7,12,3,"win_A",-1,4,10,0,0,0,0,0,0.928571428571429,0.695652173913043,0.285714285714286,0.130434782608696,0,"orthodox"
"174273",30,29,169,165,175,175,126,126,42,28,0,4,22,20,"win_A",1,4,0,0,0,0,0,0,1,0.875,0.523809523809524,0.625,0,"orthodox"
"174281",24,29,169,168,175,180,126,126,32,24,0,3,19,16,"win_A",-5,1,-5,0,0,0,0,0,1,0.888888888888889,0.59375,0.592592592592593,0,"orthodox"
"174401",28,23,164,173,169,175,122,122,39,21,3,1,28,13,"win_A",5,-9,-6,0,0,0,0,0,0.928571428571429,0.954545454545455,0.666666666666667,0.590909090909091,0,"orthodox"
"174406",25,26,164,168,169,168,123,122,34,19,3,6,24,14,"win_A",-1,-4,1,1,0,0,0,0,0.918918918918919,0.76,0.648648648648649,0.56,0,"orthodox"
"174410",24,28,164,160,169,163,123,123,31,27,2,14,23,24,"win_A",-4,4,6,0,0,0,0,0,0.939393939393939,0.658536585365854,0.696969696969697,0.585365853658537,0,"orthodox"
"174419",21,22,164,169,169,173,126,127,21,10,2,0,16,6,"win_A",-1,-5,-4,-1,0,0,0,0,0.91304347826087,1,0.695652173913043,0.6,0,"orthodox"
"174421",24,21,168,164,170,169,121,122,13,20,1,1,5,15,"win_A",3,4,1,-1,0,0,0,0,0.928571428571429,0.952380952380952,0.357142857142857,0.714285714285714,0,"orthodox"
"174469",23,26,189,171,191,173,171,173,30,90,4,25,17,24,"win_A",-3,18,18,-2,0,0,0,0,0.882352941176471,0.782608695652174,0.5,0.208695652173913,0,"orthodox"
"174479",34,25,178,171,193,173,164,168,131,82,17,19,53,23,"win_A",9,7,20,-4,0,0,0,0,0.885135135135135,0.811881188118812,0.358108108108108,0.227722772277228,0,"southpaw"
"174635",34,31,171,170,172,174,135,132,69,116,32,23,40,31,"win_B",3,1,-2,3,0,0,0,0,0.683168316831683,0.834532374100719,0.396039603960396,0.223021582733813,1,"Unknown"
"174662",29,24,170,171,174,170,135,135,96,27,14,9,28,7,"win_B",5,-1,4,0,0,0,0,0,0.872727272727273,0.75,0.254545454545455,0.194444444444444,1,"Unknown"
"174663",28,23,170,168,174,173,135,134,95,60,14,10,28,26,"win_A",5,2,1,1,0,0,0,0,0.871559633027523,0.857142857142857,0.256880733944954,0.371428571428571,0,"Unknown"
"174672",28,23,170,168,174,173,141,135,90,58,10,8,28,25,"win_A",5,2,1,6,0,0,0,0,0.9,0.878787878787879,0.28,0.378787878787879,0,"Unknown"
"174753",20,26,170,171,174,178,132,132,12,23,6,9,3,14,"win_A",-6,-1,-4,0,0,0,0,0,0.666666666666667,0.71875,0.166666666666667,0.4375,0,"Unknown"
"174847",24,31,165,166,168,174,118,118,23,35,1,3,15,27,"win_A",-7,-1,-6,0,0,0,0,0,0.958333333333333,0.921052631578947,0.625,0.710526315789474,0,"southpaw"
"174849",30,37,166,170,174,175,120,120,33,25,3,10,27,12,"win_A",-7,-4,-1,0,0,1,0,0,0.916666666666667,0.714285714285714,0.75,0.342857142857143,0,"orthodox"
"174850",28,33,166,165,174,165,115,115,31,32,2,6,27,21,"win_A",-5,1,9,0,0,0,0,0,0.939393939393939,0.842105263157895,0.818181818181818,0.552631578947368,0,"orthodox"
"174857",25,27,166,168,174,170,115,115,25,26,0,1,24,16,"win_B",-2,-2,4,0,0,0,0,0,1,0.962962962962963,0.96,0.592592592592593,1,"orthodox"
"174859",24,28,166,170,174,171,115,115,23,26,0,2,23,14,"win_A",-4,-4,3,0,0,0,0,0,1,0.928571428571429,1,0.5,0,"orthodox"
"174894",25,25,178,178,178,180,152,156,46,13,3,1,28,10,"win_B",0,0,-2,-4,0,0,0,0,0.938775510204082,0.928571428571429,0.571428571428571,0.714285714285714,1,"orthodox"
"174958",30,28,185,183,213,191,211,196,30,34,1,2,21,20,"win_A",2,2,22,15,0,0,1,0,0.967741935483871,0.944444444444444,0.67741935483871,0.555555555555556,0,"orthodox"
"174964",29,34,185,191,213,198,211,211,24,47,1,17,15,35,"win_A",-5,-6,15,0,0,0,0,0,0.96,0.734375,0.6,0.546875,0,"orthodox"
"174990",48,25,192,193,199,203,260,227,76,29,4,1,68,24,"win_B",23,-1,-4,33,1,0,1,0,0.95,0.966666666666667,0.85,0.8,1,"orthodox"
"174991",31,48,195,192,203,199,253,230,36,75,0,4,30,68,"win_B",-17,3,4,23,0,1,1,0,1,0.949367088607595,0.833333333333333,0.860759493670886,1,"orthodox"
"174992",47,29,192,188,199,196,253,235,74,20,4,0,68,18,"win_A",18,4,3,18,1,0,1,0,0.948717948717949,1,0.871794871794872,0.9,0,"orthodox"
"174993",46,26,192,191,199,193,256,221,73,21,4,1,68,10,"win_A",20,1,6,35,1,0,1,0,0.948051948051948,0.954545454545455,0.883116883116883,0.454545454545455,0,"orthodox"
"174994",26,45,188,192,198,199,250,222,35,72,0,4,30,67,"win_B",-19,-4,-1,28,0,1,1,0,1,0.947368421052632,0.857142857142857,0.881578947368421,1,"southpaw"
"174995",24,44,188,192,193,199,256,226,36,72,1,3,32,67,"win_A",-20,-4,-6,30,0,1,1,0,0.972972972972973,0.96,0.864864864864865,0.893333333333333,0,"orthodox"
"175001",41,32,192,186,199,183,263,219,66,36,2,3,62,26,"win_A",9,6,16,44,1,0,1,0,0.970588235294118,0.923076923076923,0.911764705882353,0.666666666666667,0,"orthodox"
"175002",41,35,192,193,199,201,260,233,65,14,2,15,61,4,"win_A",6,-1,-2,27,1,1,1,0,0.970149253731343,0.482758620689655,0.91044776119403,0.137931034482759,0,"orthodox"
"175004",40,25,192,182,199,183,256,228,63,17,2,7,60,8,"win_A",15,10,16,28,1,0,1,0,0.969230769230769,0.708333333333333,0.923076923076923,0.333333333333333,0,"orthodox"
"175008",40,25,192,185,199,183,251,231,59,10,2,13,56,6,"win_A",15,7,16,20,1,0,1,0,0.967213114754098,0.434782608695652,0.918032786885246,0.260869565217391,0,"orthodox"
"175012",39,31,192,178,199,191,255,206,55,21,2,6,52,17,"win_A",8,14,8,49,1,0,1,0,0.964912280701754,0.777777777777778,0.912280701754386,0.62962962962963,0,"orthodox"
"175015",35,39,170,192,180,199,235,222,28,52,5,2,17,49,"win_B",-4,-22,-19,13,1,1,0,0,0.848484848484849,0.962962962962963,0.515151515151515,0.907407407407407,1,"orthodox"
"175018",38,28,192,182,199,178,244,209,49,20,2,7,46,9,"win_A",10,10,21,35,1,0,1,0,0.96078431372549,0.740740740740741,0.901960784313726,0.333333333333333,0,"orthodox"
"175026",27,27,192,187,199,203,229,223,42,18,1,3,39,11,"win_A",0,5,-4,6,0,0,0,0,0.976744186046512,0.857142857142857,0.906976744186046,0.523809523809524,0,"orthodox"
"175027",27,34,192,191,199,193,226,220,40,31,1,3,37,22,"win_A",-7,1,6,6,0,0,0,0,0.975609756097561,0.911764705882353,0.902439024390244,0.647058823529412,0,"orthodox"
"175039",22,36,192,183,199,196,216,196,27,82,0,6,24,44,"win_A",-14,9,3,20,0,1,1,0,1,0.931818181818182,0.888888888888889,0.5,0,"orthodox"
"175051",21,34,192,183,199,196,213,197,15,77,0,5,13,39,"win_A",-13,9,3,16,0,0,1,0,1,0.939024390243902,0.866666666666667,0.475609756097561,0,"orthodox"
"175090",27,23,166,157,170,160,126,125,73,34,4,4,66,24,"win_A",4,9,10,1,0,0,0,0,0.948051948051948,0.894736842105263,0.857142857142857,0.631578947368421,0,"orthodox"
"175092",26,22,166,157,170,160,126,124,72,28,3,4,66,20,"win_B",4,9,10,2,0,0,0,0,0.96,0.875,0.88,0.625,1,"orthodox"
"175114",22,21,166,166,170,171,118,118,52,34,0,2,50,8,"win_A",1,0,-1,0,0,0,0,0,1,0.944444444444444,0.961538461538462,0.222222222222222,0,"orthodox"
"175394",22,29,168,169,165,175,128,132,79,52,5,75,38,11,"win_A",-7,-1,-10,-4,0,0,0,0,0.94047619047619,0.409448818897638,0.452380952380952,0.0866141732283465,0,"orthodox"
"175403",22,29,168,169,165,175,132,132,71,52,4,70,37,11,"win_A",-7,-1,-10,0,0,0,0,0,0.946666666666667,0.426229508196721,0.493333333333333,0.0901639344262295,0,"orthodox"
"175437",19,26,168,169,165,175,125,126,39,40,0,39,22,9,"win_A",-7,-1,-10,-1,0,0,0,0,1,0.506329113924051,0.564102564102564,0.113924050632911,0,"orthodox"
"175457",18,27,168,157,165,165,119,118,18,17,0,21,11,0,"win_A",-9,11,0,1,0,0,0,0,1,0.447368421052632,0.611111111111111,0,0,"orthodox"
"175515",27,24,175,173,183,184,159,161,33,24,10,1,12,16,"win_B",3,2,-1,-2,0,0,0,0,0.767441860465116,0.96,0.27906976744186,0.64,1,"Unknown"
"175623",21,23,187,180,184,183,173,186,47,39,9,7,7,16,"win_A",-2,7,1,-13,0,0,0,0,0.839285714285714,0.847826086956522,0.125,0.347826086956522,0,"orthodox"
"175626",21,26,187,177,184,178,167,161,44,34,9,4,7,18,"win_A",-5,10,6,6,0,0,0,0,0.830188679245283,0.894736842105263,0.132075471698113,0.473684210526316,0,"orthodox"
"175631",20,28,187,178,184,184,168,162,40,92,8,9,6,17,"win_B",-8,9,0,6,0,0,0,0,0.833333333333333,0.910891089108911,0.125,0.168316831683168,1,"orthodox"
"175636",19,27,187,178,184,184,162,161,35,89,7,5,6,17,"win_A",-8,9,0,1,0,0,0,0,0.833333333333333,0.946808510638298,0.142857142857143,0.180851063829787,0,"orthodox"
"175638",19,27,187,178,184,184,161,161,33,89,6,4,5,17,"win_A",-8,9,0,0,0,0,0,0,0.846153846153846,0.956989247311828,0.128205128205128,0.182795698924731,0,"orthodox"
"175688",24,32,182,173,188,175,169,170,12,38,0,11,11,31,"win_A",-8,9,13,-1,0,0,0,0,1,0.775510204081633,0.916666666666667,0.63265306122449,0,"orthodox"
"175720",24,28,173,170,175,178,160,158,10,5,0,2,8,4,"win_A",-4,3,-3,2,0,0,0,0,1,0.714285714285714,0.8,0.571428571428571,0,"Unknown"
"175729",22,22,173,184,175,188,156,158,1,25,0,7,1,16,"win_A",0,-11,-13,-2,0,0,0,0,1,0.78125,1,0.5,0,"Unknown"
"175733",36,32,188,182,198,183,154,154,39,32,3,1,25,21,"win_B",4,6,15,0,1,0,0,0,0.928571428571429,0.96969696969697,0.595238095238095,0.636363636363636,1,"southpaw"
"175745",26,32,188,177,198,185,159,160,28,26,1,3,18,22,"win_A",-6,11,13,-1,0,0,0,0,0.96551724137931,0.896551724137931,0.620689655172414,0.758620689655172,0,"southpaw"
"175746",26,28,188,165,198,175,155,156,27,13,1,6,18,3,"win_A",-2,23,23,-1,0,0,0,0,0.964285714285714,0.684210526315789,0.642857142857143,0.157894736842105,0,"southpaw"
"175747",26,32,188,173,198,175,157,154,26,32,1,11,17,21,"win_A",-6,15,23,3,0,0,0,0,0.962962962962963,0.744186046511628,0.62962962962963,0.488372093023256,0,"southpaw"
"175750",25,27,188,177,198,185,154,154,23,18,1,2,15,11,"win_A",-2,11,13,0,0,0,0,0,0.958333333333333,0.9,0.625,0.55,0,"southpaw"
"175796",25,31,168,171,174,178,143,142,64,78,9,23,34,13,"win_A",-6,-3,-4,1,0,0,0,0,0.876712328767123,0.772277227722772,0.465753424657534,0.128712871287129,0,"orthodox"
"175807",23,27,171,171,180,178,139,137,43,67,4,16,25,12,"win_B",-4,0,2,2,0,0,0,0,0.914893617021277,0.807228915662651,0.531914893617021,0.144578313253012,1,"orthodox"
"175835",23,24,171,170,178,170,135,135,41,52,13,16,6,21,"win_A",-1,1,8,0,0,0,0,0,0.759259259259259,0.764705882352941,0.111111111111111,0.308823529411765,0,"orthodox"
"175837",23,28,171,163,178,170,133,134,39,132,13,20,6,11,"win_A",-5,8,8,-1,0,0,0,0,0.75,0.868421052631579,0.115384615384615,0.0723684210526316,0,"orthodox"
"175844",23,28,171,163,178,170,133,135,33,125,12,18,5,11,"win_A",-5,8,8,-2,0,0,0,0,0.733333333333333,0.874125874125874,0.111111111111111,0.0769230769230769,0,"orthodox"
"175884",26,20,165,171,165,178,127,131,41,5,9,0,7,2,"win_A",6,-6,-13,-4,0,0,0,0,0.82,1,0.14,0.4,0,"Unknown"
"175897",29,27,170,179,170,180,149,139,142,79,22,12,29,20,"win_B",2,-9,-10,10,0,0,0,0,0.865853658536585,0.868131868131868,0.176829268292683,0.21978021978022,1,"Unknown"
"175923",26,22,170,175,170,177,142,138,128,27,10,6,27,17,"win_A",4,-5,-7,4,0,0,0,0,0.927536231884058,0.818181818181818,0.195652173913043,0.515151515151515,0,"Unknown"
"175985",24,21,163,170,166,170,135,134,90,68,24,4,8,15,"win_A",3,-7,-4,1,0,0,0,0,0.789473684210526,0.944444444444444,0.0701754385964912,0.208333333333333,0,"orthodox"
"175990",20,25,170,163,170,163,135,132,63,42,4,9,14,8,"win_A",-5,7,7,3,0,0,0,0,0.940298507462687,0.823529411764706,0.208955223880597,0.156862745098039,0,"Unknown"
"175999",20,24,170,163,170,163,131,133,54,39,3,6,14,8,"win_A",-4,7,7,-2,0,0,0,0,0.947368421052632,0.866666666666667,0.245614035087719,0.177777777777778,0,"Unknown"
"176037",17,27,170,165,170,168,119,119,18,112,0,28,6,11,"win_A",-10,5,2,0,0,0,0,0,1,0.8,0.333333333333333,0.0785714285714286,0,"Unknown"
"176137",24,30,163,159,173,173,112,112,11,40,1,9,8,26,"win_A",-6,4,0,0,0,0,0,0,0.916666666666667,0.816326530612245,0.666666666666667,0.530612244897959,0,"orthodox"
"176297",32,29,173,178,185,182,160,158,55,54,11,26,27,24,"win_A",3,-5,3,2,0,0,0,0,0.833333333333333,0.675,0.409090909090909,0.3,0,"orthodox"
"176320",26,28,173,175,185,183,147,153,34,42,7,14,16,14,"win_A",-2,-2,2,-6,0,0,0,0,0.829268292682927,0.75,0.390243902439024,0.25,0,"orthodox"
"176322",25,24,173,175,185,178,146,145,33,16,6,3,15,9,"win_A",1,-2,7,1,0,0,0,0,0.846153846153846,0.842105263157895,0.384615384615385,0.473684210526316,0,"orthodox"
"176330",25,31,173,170,185,173,146,147,27,21,4,9,11,8,"win_A",-6,3,12,-1,0,0,0,0,0.870967741935484,0.7,0.354838709677419,0.266666666666667,0,"orthodox"
"176337",24,24,173,173,188,185,147,145,39,21,1,3,14,8,"win_B",0,0,3,2,0,0,0,0,0.975,0.875,0.35,0.333333333333333,1,"orthodox"
"176340",23,32,173,175,185,175,147,149,19,60,2,41,8,28,"win_A",-9,-2,10,-2,0,0,0,0,0.904761904761905,0.594059405940594,0.380952380952381,0.277227722772277,0,"orthodox"
"176402",27,25,154,159,160,168,112,111,41,41,4,5,13,24,"win_A",2,-5,-8,1,0,0,0,0,0.911111111111111,0.891304347826087,0.288888888888889,0.521739130434783,0,"orthodox"
"176405",24,27,159,152,168,156,109,110,39,16,4,2,22,6,"win_A",-3,7,12,-1,0,0,0,0,0.906976744186046,0.888888888888889,0.511627906976744,0.333333333333333,0,"orthodox"
"176638",33,27,161,160,168,163,120,122,68,36,25,5,33,8,"win_A",6,1,5,-2,0,0,0,0,0.731182795698925,0.878048780487805,0.354838709677419,0.195121951219512,0,"orthodox"
"176647",32,26,161,160,168,163,119,119,63,28,16,4,30,8,"win_B",6,1,5,0,0,0,0,0,0.79746835443038,0.875,0.379746835443038,0.25,1,"orthodox"
"176667",28,26,161,160,168,160,122,122,52,60,5,5,28,45,"win_A",2,1,8,0,0,0,0,0,0.912280701754386,0.923076923076923,0.491228070175439,0.692307692307692,0,"orthodox"
"176898",19,22,170,170,175,170,132,133,52,25,1,10,36,8,"win_A",-3,0,5,-1,0,0,0,0,0.981132075471698,0.714285714285714,0.679245283018868,0.228571428571429,0,"Unknown"
"176998",26,20,165,170,169,176,136,138,22,17,2,1,10,12,"win_A",6,-5,-7,-2,0,0,0,0,0.916666666666667,0.944444444444444,0.416666666666667,0.666666666666667,0,"southpaw"
"177026",23,29,180,177,187,184,175,173,34,53,4,6,21,32,"win_A",-6,3,3,2,0,0,0,0,0.894736842105263,0.898305084745763,0.552631578947368,0.542372881355932,0,"orthodox"
"177042",26,29,177,178,184,185,174,175,37,41,6,6,26,22,"win_A",-3,-1,-1,-1,0,0,0,0,0.86046511627907,0.872340425531915,0.604651162790698,0.468085106382979,0,"orthodox"
"177090",31,30,185,180,191,189,167,166,24,28,0,2,19,17,"win_A",1,5,2,1,0,0,0,0,1,0.933333333333333,0.791666666666667,0.566666666666667,0,"orthodox"
"177115",31,24,166,168,160,168,113,114,46,22,4,17,31,12,"win_A",7,-2,-8,-1,0,0,0,0,0.92,0.564102564102564,0.62,0.307692307692308,0,"orthodox"
"177120",29,21,166,163,160,163,111,112,43,15,2,4,28,10,"win_A",8,3,-3,-1,0,0,0,0,0.955555555555556,0.789473684210526,0.622222222222222,0.526315789473684,0,"orthodox"
"177133",26,27,166,162,160,168,112,111,30,6,1,13,18,2,"win_A",-1,4,-8,1,0,0,0,0,0.967741935483871,0.315789473684211,0.580645161290323,0.105263157894737,0,"orthodox"
"177140",24,24,166,160,160,157,107,107,22,23,0,3,13,7,"win_A",0,6,3,0,0,0,0,0,1,0.884615384615385,0.590909090909091,0.269230769230769,0,"orthodox"
"177141",24,26,166,160,160,168,109,108,21,15,0,3,13,12,"win_A",-2,6,-8,1,0,0,0,0,1,0.833333333333333,0.619047619047619,0.666666666666667,0,"orthodox"
"177167",31,21,179,175,180,185,146,146,106,43,27,9,28,19,"win_B",10,4,-5,0,0,0,0,0,0.796992481203007,0.826923076923077,0.210526315789474,0.365384615384615,1,"orthodox"
"177222",24,28,179,170,180,173,147,145,64,89,12,5,18,25,"win_A",-4,9,7,2,0,0,0,0,0.842105263157895,0.946808510638298,0.236842105263158,0.265957446808511,0,"orthodox"
"177237",23,28,179,168,180,174,148,140,54,81,7,14,17,40,"win_A",-5,11,6,8,0,0,0,0,0.885245901639344,0.852631578947368,0.278688524590164,0.421052631578947,0,"orthodox"
"177717",23,28,168,165,168,168,119,119,80,131,23,32,28,11,"win_A",-5,3,0,0,0,0,0,0,0.776699029126214,0.803680981595092,0.271844660194175,0.0674846625766871,0,"orthodox"
"177719",18,27,166,165,168,168,116,114,31,130,4,31,15,11,"win_B",-9,1,0,2,0,0,0,0,0.885714285714286,0.807453416149068,0.428571428571429,0.0683229813664596,1,"orthodox"
"177761",21,25,168,165,168,168,116,117,54,97,17,20,16,11,"win_A",-4,3,0,-1,0,0,0,0,0.76056338028169,0.829059829059829,0.225352112676056,0.094017094017094,0,"orthodox"
"177780",23,24,157,165,160,168,119,119,66,81,15,16,8,10,"win_B",-1,-8,-8,0,0,0,0,0,0.814814814814815,0.835051546391753,0.0987654320987654,0.103092783505155,1,"Unknown"
"177805",19,23,168,165,168,168,116,117,27,61,10,11,7,10,"win_A",-4,3,0,-1,0,0,0,0,0.72972972972973,0.847222222222222,0.189189189189189,0.138888888888889,0,"orthodox"
"177957",20,23,169,171,180,178,140,140,25,37,4,4,15,7,"win_A",-3,-2,2,0,0,0,0,0,0.862068965517241,0.902439024390244,0.517241379310345,0.170731707317073,0,"orthodox"
"177999",33,26,173,175,188,175,162,168,99,20,8,3,45,9,"win_A",7,-2,13,-6,0,0,0,0,0.925233644859813,0.869565217391304,0.420560747663551,0.391304347826087,0,"orthodox"
"178016",30,24,173,173,188,180,152,155,83,23,6,4,37,18,"win_A",6,0,8,-3,0,0,0,0,0.932584269662921,0.851851851851852,0.415730337078652,0.666666666666667,0,"orthodox"
"178023",29,24,173,173,188,180,152,155,76,19,6,3,35,14,"win_A",5,0,8,-3,0,0,0,0,0.926829268292683,0.863636363636364,0.426829268292683,0.636363636363636,0,"orthodox"
"178031",28,34,173,170,188,173,149,155,69,25,4,17,29,8,"win_A",-6,3,15,-6,0,0,0,0,0.945205479452055,0.595238095238095,0.397260273972603,0.19047619047619,0,"orthodox"
"178050",25,31,173,177,188,175,150,160,49,65,2,8,21,31,"win_A",-6,-4,13,-10,0,0,0,0,0.96078431372549,0.89041095890411,0.411764705882353,0.424657534246575,0,"orthodox"
"178116",21,32,175,168,178,173,138,138,24,76,4,21,7,31,"win_B",-11,7,5,0,0,0,0,0,0.857142857142857,0.783505154639175,0.25,0.319587628865979,1,"orthodox"
"178118",32,26,168,170,173,173,140,136,75,31,20,2,31,15,"win_B",6,-2,0,4,0,0,0,0,0.789473684210526,0.939393939393939,0.326315789473684,0.454545454545455,1,"orthodox"
"178119",31,31,168,169,173,173,135,135,75,30,19,13,31,18,"win_B",0,-1,0,0,0,0,0,0,0.797872340425532,0.697674418604651,0.329787234042553,0.418604651162791,1,"orthodox"
"178120",31,31,168,169,173,173,134,134,75,29,18,13,31,18,"win_B",0,-1,0,0,0,0,0,0,0.806451612903226,0.69047619047619,0.333333333333333,0.428571428571429,1,"orthodox"
"178127",30,26,168,168,173,178,135,135,70,67,16,11,29,7,"win_B",4,0,-5,0,0,0,0,0,0.813953488372093,0.858974358974359,0.337209302325581,0.0897435897435897,1,"orthodox"
"178138",28,24,168,168,173,171,135,132,62,54,13,24,24,24,"win_A",4,0,2,3,0,0,0,0,0.826666666666667,0.692307692307692,0.32,0.307692307692308,0,"orthodox"
"178140",28,23,168,168,173,171,134,131,61,51,12,24,24,22,"win_B",5,0,2,3,0,0,0,0,0.835616438356164,0.68,0.328767123287671,0.293333333333333,1,"orthodox"
"178141",28,23,168,168,173,171,134,131,60,51,12,23,24,22,"win_A",5,0,2,3,0,0,0,0,0.833333333333333,0.689189189189189,0.333333333333333,0.297297297297297,0,"orthodox"
"178143",28,21,168,171,173,173,136,141,58,19,12,4,24,5,"win_A",7,-3,0,-5,0,0,0,0,0.828571428571429,0.826086956521739,0.342857142857143,0.217391304347826,0,"orthodox"
"178213",19,31,191,189,196,206,223,207,29,66,1,12,26,50,"win_B",-12,2,-10,16,0,0,1,0,0.966666666666667,0.846153846153846,0.866666666666667,0.641025641025641,1,"orthodox"
"178254",22,28,189,180,206,188,204,195,28,63,7,38,24,16,"win_A",-6,9,18,9,0,0,0,0,0.8,0.623762376237624,0.685714285714286,0.158415841584158,0,"orthodox"
"178255",22,28,189,202,206,211,204,244,27,54,7,12,23,35,"win_A",-6,-13,-5,-40,0,0,0,1,0.794117647058823,0.818181818181818,0.676470588235294,0.53030303030303,0,"orthodox"
"178258",22,28,189,180,206,188,204,195,26,60,5,37,22,16,"win_B",-6,9,18,9,0,0,0,0,0.838709677419355,0.618556701030928,0.709677419354839,0.164948453608247,1,"orthodox"
"178260",21,32,189,179,206,183,201,208,24,35,4,15,20,15,"win_A",-11,10,23,-7,0,0,0,0,0.857142857142857,0.7,0.714285714285714,0.3,0,"orthodox"
"178261",21,22,189,188,206,191,200,203,24,30,3,10,20,8,"win_B",-1,1,15,-3,0,0,0,0,0.888888888888889,0.75,0.740740740740741,0.2,1,"orthodox"
"178266",21,20,189,197,206,218,194,205,20,5,2,6,16,2,"win_A",1,-8,-12,-11,0,0,0,0,0.909090909090909,0.454545454545455,0.727272727272727,0.181818181818182,0,"orthodox"
"178306",32,29,163,162,174,161,112,112,30,65,2,2,20,33,"win_A",3,1,13,0,0,0,0,0,0.9375,0.970149253731343,0.625,0.492537313432836,0,"orthodox"
"178312",28,28,162,159,161,161,112,112,59,26,2,12,30,15,"win_A",0,3,0,0,0,0,0,0,0.967213114754098,0.684210526315789,0.491803278688525,0.394736842105263,0,"southpaw"
"178314",28,31,162,163,161,174,112,112,57,27,2,1,30,19,"win_A",-3,-1,-13,0,0,0,0,0,0.966101694915254,0.964285714285714,0.508474576271186,0.678571428571429,0,"southpaw"
"178319",26,22,162,170,161,175,112,112,51,14,2,6,27,5,"win_A",4,-8,-14,0,0,0,0,0,0.962264150943396,0.7,0.509433962264151,0.25,0,"southpaw"
"178326",25,26,162,163,161,168,112,112,44,15,2,2,25,9,"win_A",-1,-1,-7,0,0,0,0,0,0.956521739130435,0.882352941176471,0.543478260869565,0.529411764705882,0,"southpaw"
"178327",24,27,162,163,161,174,112,112,43,19,2,0,24,14,"win_A",-3,-1,-13,0,0,0,0,0,0.955555555555556,1,0.533333333333333,0.736842105263158,0,"southpaw"
"178329",24,31,162,165,161,166,112,112,41,18,2,1,23,14,"win_A",-7,-3,-5,0,0,0,0,0,0.953488372093023,0.947368421052632,0.534883720930233,0.736842105263158,0,"southpaw"
"178332",23,23,162,167,161,170,112,112,38,11,2,0,21,7,"win_A",0,-5,-9,0,0,0,0,0,0.95,1,0.525,0.636363636363636,0,"southpaw"
"178373",28,40,168,170,175,175,140,140,27,38,0,5,11,22,"win_A",-12,-2,0,0,0,1,0,0,1,0.883720930232558,0.407407407407407,0.511627906976744,0,"orthodox"
"178377",23,24,168,173,175,191,142,143,19,18,0,3,11,9,"win_A",-1,-5,-16,-1,0,0,0,0,1,0.857142857142857,0.578947368421053,0.428571428571429,0,"orthodox"
"178379",23,32,168,170,175,175,140,140,17,23,0,6,10,13,"win_A",-9,-2,0,0,0,0,0,0,1,0.793103448275862,0.588235294117647,0.448275862068966,0,"orthodox"
"178383",22,32,168,175,175,183,139,138,13,19,0,12,7,15,"win_A",-10,-7,-8,1,0,0,0,0,1,0.612903225806452,0.538461538461538,0.483870967741935,0,"orthodox"
"178404",29,36,175,171,175,175,144,145,21,60,4,9,10,52,"win_A",-7,4,0,-1,0,1,0,0,0.84,0.869565217391304,0.4,0.753623188405797,0,"orthodox"
"178410",28,33,171,171,165,175,140,140,42,55,0,7,30,47,"win_A",-5,0,-10,0,0,0,0,0,1,0.887096774193548,0.714285714285714,0.758064516129032,0,"orthodox"
"178411",33,27,171,175,175,185,139,140,54,15,7,0,47,9,"win_A",6,-4,-10,-1,0,0,0,0,0.885245901639344,1,0.770491803278688,0.6,0,"orthodox"
"178412",32,27,171,178,175,183,138,138,53,26,7,3,47,16,"win_A",5,-7,-8,0,0,0,0,0,0.883333333333333,0.896551724137931,0.783333333333333,0.551724137931034,0,"orthodox"
"178414",27,31,179,171,178,175,135,135,39,52,2,6,32,46,"win_A",-4,8,3,0,0,0,0,0,0.951219512195122,0.896551724137931,0.780487804878049,0.793103448275862,0,"orthodox"
"178419",29,30,171,175,175,175,146,147,47,34,6,9,43,29,"win_A",-1,-4,0,-1,0,0,0,0,0.886792452830189,0.790697674418605,0.811320754716981,0.674418604651163,0,"orthodox"
"178423",27,29,171,180,175,180,141,141,43,45,4,6,39,33,"win_A",-2,-9,-5,0,0,0,0,0,0.914893617021277,0.882352941176471,0.829787234042553,0.647058823529412,0,"orthodox"
"178426",26,27,171,164,175,174,135,135,40,30,4,1,37,15,"win_A",-1,7,1,0,0,0,0,0,0.909090909090909,0.967741935483871,0.840909090909091,0.483870967741935,0,"orthodox"
"178427",26,28,171,170,175,183,135,134,39,24,4,3,37,11,"win_A",-2,1,-8,1,0,0,0,0,0.906976744186046,0.888888888888889,0.86046511627907,0.407407407407407,0,"orthodox"
"178431",25,30,171,173,175,163,131,130,35,21,4,8,33,12,"win_A",-5,-2,12,1,0,0,0,0,0.897435897435897,0.724137931034483,0.846153846153846,0.413793103448276,0,"orthodox"
"178434",24,26,171,171,175,175,130,129,33,18,3,4,32,14,"win_B",-2,0,0,1,0,0,0,0,0.916666666666667,0.818181818181818,0.888888888888889,0.636363636363636,1,"orthodox"
"178437",23,21,171,173,175,173,126,125,30,11,3,1,29,6,"win_A",2,-2,2,1,0,0,0,0,0.909090909090909,0.916666666666667,0.878787878787879,0.5,0,"orthodox"
"178443",22,22,171,170,175,180,125,125,24,34,2,5,23,27,"win_B",0,1,-5,0,0,0,0,0,0.923076923076923,0.871794871794872,0.884615384615385,0.692307692307692,1,"orthodox"
"178448",20,21,171,170,175,180,126,126,20,29,1,5,19,22,"win_B",-1,1,-5,0,0,0,0,0,0.952380952380952,0.852941176470588,0.904761904761905,0.647058823529412,1,"orthodox"
"178451",21,19,168,171,171,175,126,126,35,18,5,0,28,17,"win_A",2,-3,-4,0,0,0,0,0,0.875,1,0.7,0.944444444444444,0,"orthodox"
"178474",30,25,157,163,160,166,132,134,120,94,24,25,37,9,"win_A",5,-6,-6,-2,0,0,0,0,0.833333333333333,0.789915966386555,0.256944444444444,0.0756302521008403,0,"Unknown"
"178509",25,31,157,179,160,182,135,143,86,97,17,17,28,23,"win_A",-6,-22,-22,-8,0,0,0,0,0.83495145631068,0.850877192982456,0.271844660194175,0.201754385964912,0,"Unknown"
"178525",24,22,157,168,160,175,132,133,71,41,16,9,25,4,"win_A",2,-11,-15,-1,0,0,0,0,0.816091954022989,0.82,0.28735632183908,0.08,0,"Unknown"
"178527",23,20,157,168,160,178,133,133,70,57,15,4,25,8,"win_B",3,-11,-18,0,0,0,0,0,0.823529411764706,0.934426229508197,0.294117647058824,0.131147540983607,1,"Unknown"
"178534",23,28,157,179,160,182,124,142,64,87,14,10,24,19,"win_A",-5,-22,-22,-18,0,0,0,1,0.82051282051282,0.896907216494845,0.307692307692308,0.195876288659794,0,"Unknown"
"178565",27,20,164,157,166,160,128,133,75,37,20,6,35,21,"win_B",7,7,6,-5,0,0,0,0,0.789473684210526,0.86046511627907,0.368421052631579,0.488372093023256,1,"Unknown"
"178660",20,27,164,168,178,178,134,128,37,59,1,20,13,17,"win_A",-7,-4,0,6,0,0,0,0,0.973684210526316,0.746835443037975,0.342105263157895,0.215189873417722,0,"orthodox"
"178732",22,32,160,155,163,160,114,114,46,97,9,23,4,19,"win_A",-10,5,3,0,0,0,0,0,0.836363636363636,0.808333333333333,0.0727272727272727,0.158333333333333,0,"Unknown"
"178763",27,19,155,163,160,161,115,118,75,23,14,1,9,11,"win_B",8,-8,-1,-3,0,0,0,0,0.842696629213483,0.958333333333333,0.101123595505618,0.458333333333333,1,"Unknown"
"178771",26,26,155,157,160,165,114,115,69,16,12,16,8,0,"win_A",0,-2,-5,-1,0,0,0,0,0.851851851851852,0.5,0.0987654320987654,0,0,"Unknown"
"178791",24,22,155,165,160,163,112,118,54,57,6,8,6,21,"win_B",2,-10,-3,-6,0,0,0,0,0.9,0.876923076923077,0.1,0.323076923076923,1,"Unknown"
"178817",19,21,166,155,168,160,112,115,39,27,7,3,18,3,"win_B",-2,11,8,-3,0,0,0,0,0.847826086956522,0.9,0.391304347826087,0.1,1,"orthodox"
"178852",32,24,161,170,171,175,130,128,35,30,6,0,19,14,"win_A",8,-9,-4,2,0,0,0,0,0.853658536585366,1,0.463414634146341,0.466666666666667,0,"Unknown"
"178863",26,24,161,165,171,169,133,138,29,11,0,4,16,10,"win_A",2,-4,2,-5,0,0,0,0,1,0.733333333333333,0.551724137931034,0.666666666666667,0,"Unknown"
"178866",25,23,161,165,171,169,134,134,25,10,0,3,14,9,"win_A",2,-4,2,0,0,0,0,0,1,0.769230769230769,0.56,0.692307692307692,0,"Unknown"
"178983",27,37,173,172,173,175,129,130,24,47,3,11,19,26,"win_A",-10,1,-2,-1,0,1,0,0,0.888888888888889,0.810344827586207,0.703703703703704,0.448275862068966,0,"southpaw"
"178984",35,25,172,175,175,183,131,134,46,16,11,3,25,12,"win_A",10,-3,-8,-3,1,0,0,0,0.807017543859649,0.842105263157895,0.43859649122807,0.631578947368421,0,"orthodox"
"178987",23,33,165,172,157,175,126,126,26,45,2,9,23,24,"win_A",-10,-7,-18,0,0,0,0,0,0.928571428571429,0.833333333333333,0.821428571428571,0.444444444444444,0,"orthodox"
"178990",31,27,172,168,175,171,126,126,44,53,7,7,23,40,"win_B",4,4,4,0,0,0,0,0,0.862745098039216,0.883333333333333,0.450980392156863,0.666666666666667,1,"orthodox"
"178991",31,32,172,170,175,173,125,126,43,33,7,3,22,19,"win_A",-1,2,2,-1,0,0,0,0,0.86,0.916666666666667,0.44,0.527777777777778,0,"orthodox"
"178997",28,22,172,173,175,173,126,126,37,37,7,3,19,26,"win_A",6,-1,2,0,0,0,0,0,0.840909090909091,0.925,0.431818181818182,0.65,0,"orthodox"
"178998",28,24,172,173,175,178,125,126,36,51,7,6,19,24,"win_A",4,-1,-3,-1,0,0,0,0,0.837209302325581,0.894736842105263,0.441860465116279,0.421052631578947,0,"orthodox"
"179003",26,20,172,173,175,173,126,126,32,27,6,2,15,18,"win_B",6,-1,2,0,0,0,0,0,0.842105263157895,0.931034482758621,0.394736842105263,0.620689655172414,1,"orthodox"
"179080",27,21,171,164,172,166,133,128,47,46,14,3,30,23,"win_B",6,7,6,5,0,0,0,0,0.770491803278688,0.938775510204082,0.491803278688525,0.469387755102041,1,"Unknown"
"179082",26,23,171,163,172,168,133,132,45,39,14,15,28,19,"win_A",3,8,4,1,0,0,0,0,0.76271186440678,0.722222222222222,0.474576271186441,0.351851851851852,0,"Unknown"
"179085",25,27,171,166,172,166,133,133,42,11,12,3,25,4,"win_B",-2,5,6,0,0,0,0,0,0.777777777777778,0.785714285714286,0.462962962962963,0.285714285714286,1,"Unknown"
"179142",27,22,170,170,170,170,142,150,69,65,3,12,19,28,"win_A",5,0,0,-8,0,0,0,0,0.958333333333333,0.844155844155844,0.263888888888889,0.363636363636364,0,"orthodox"
"179156",25,27,170,165,170,170,136,137,54,81,3,12,13,24,"win_A",-2,5,0,-1,0,0,0,0,0.947368421052632,0.870967741935484,0.228070175438596,0.258064516129032,0,"orthodox"
"179189",21,23,170,168,170,178,132,132,19,42,1,8,5,13,"win_B",-2,2,-8,0,0,0,0,0,0.95,0.84,0.25,0.26,1,"orthodox"
"179306",30,26,165,163,165,173,108,107,28,27,2,0,19,23,"win_A",4,2,-8,1,0,0,0,0,0.933333333333333,1,0.633333333333333,0.851851851851852,0,"orthodox"
"179310",28,27,165,157,165,168,112,111,24,17,1,9,17,9,"win_A",1,8,-3,1,0,0,0,0,0.96,0.653846153846154,0.68,0.346153846153846,0,"orthodox"
"179314",26,25,165,165,175,165,105,105,27,20,1,0,18,14,"win_B",1,0,10,0,0,0,0,0,0.964285714285714,1,0.642857142857143,0.7,1,"southpaw"
"179520",30,27,171,173,165,180,140,139,44,25,1,1,31,5,"win_A",3,-2,-15,1,0,0,0,0,0.977777777777778,0.961538461538462,0.688888888888889,0.192307692307692,0,"orthodox"
"179522",26,28,170,171,180,165,139,139,17,41,0,0,13,30,"win_B",-2,-1,15,0,0,0,0,0,1,1,0.764705882352941,0.731707317073171,1,"southpaw"
"179523",27,25,171,175,165,183,147,147,40,26,0,1,30,12,"win_A",2,-4,-18,0,0,0,0,0,1,0.962962962962963,0.75,0.444444444444444,0,"orthodox"
"179542",21,29,171,180,165,180,140,140,19,11,0,2,15,9,"win_A",-8,-9,-15,0,0,0,0,0,1,0.846153846153846,0.789473684210526,0.692307692307692,0,"orthodox"
"179549",20,28,171,175,165,180,139,138,12,10,0,3,9,8,"win_A",-8,-4,-15,1,0,0,0,0,1,0.769230769230769,0.75,0.615384615384615,0,"orthodox"
"179566",28,28,164,163,173,157,135,133,53,38,4,3,39,24,"win_A",0,1,16,2,0,0,0,0,0.929824561403509,0.926829268292683,0.684210526315789,0.585365853658537,0,"orthodox"
"179621",40,29,178,180,188,178,200,182,118,20,25,10,69,10,"win_A",11,-2,10,18,1,0,1,0,0.825174825174825,0.666666666666667,0.482517482517482,0.333333333333333,0,"orthodox"
"179622",27,39,192,178,211,188,200,215,48,117,20,24,38,69,"win_B",-12,14,23,-15,0,1,0,1,0.705882352941177,0.829787234042553,0.558823529411765,0.48936170212766,1,"Unknown"
"179625",39,26,178,192,188,211,196,204,114,47,24,18,69,37,"win_A",13,-14,-23,-8,1,0,0,0,0.826086956521739,0.723076923076923,0.5,0.569230769230769,0,"orthodox"
"179629",38,22,178,173,188,188,198,180,112,47,22,15,69,21,"win_B",16,5,0,18,1,0,1,0,0.835820895522388,0.758064516129032,0.514925373134328,0.338709677419355,1,"orthodox"
"179673",33,26,178,180,188,201,192,164,68,81,18,6,46,41,"win_A",7,-2,-13,28,0,0,1,0,0.790697674418605,0.931034482758621,0.534883720930233,0.471264367816092,0,"orthodox"
"179715",30,30,178,192,188,201,198,215,28,36,13,15,18,16,"win_A",0,-14,-13,-17,0,0,0,1,0.682926829268293,0.705882352941177,0.439024390243902,0.313725490196078,0,"orthodox"
"179755",28,24,173,177,170,182,159,159,76,48,14,1,27,14,"win_A",4,-4,-12,0,0,0,0,0,0.844444444444444,0.979591836734694,0.3,0.285714285714286,0,"orthodox"
"179777",24,31,173,179,170,180,162,160,58,141,10,23,17,36,"win_A",-7,-6,-10,2,0,0,0,0,0.852941176470588,0.859756097560976,0.25,0.219512195121951,0,"orthodox"
"179808",20,24,173,179,170,193,161,145,28,47,5,3,5,31,"win_A",-4,-6,-23,16,0,0,1,0,0.848484848484849,0.94,0.151515151515152,0.62,0,"orthodox"
"179889",25,22,171,184,183,193,165,167,153,19,8,3,53,9,"win_A",3,-13,-10,-2,0,0,0,0,0.950310559006211,0.863636363636364,0.329192546583851,0.409090909090909,0,"orthodox"
"179892",25,36,171,179,183,175,171,190,149,60,8,31,52,42,"win_A",-11,-8,8,-19,0,1,0,1,0.949044585987261,0.659340659340659,0.331210191082803,0.461538461538462,0,"orthodox"
"180040",31,45,178,170,183,180,232,210,30,41,13,10,18,25,"win_A",-14,8,3,22,0,1,1,0,0.697674418604651,0.803921568627451,0.418604651162791,0.490196078431373,0,"orthodox"
"180045",39,27,170,188,180,203,196,193,38,15,8,1,23,12,"win_B",12,-18,-23,3,1,0,0,0,0.826086956521739,0.9375,0.5,0.75,1,"orthodox"
"180047",38,35,170,183,180,185,193,190,36,22,8,8,21,16,"win_A",3,-13,-5,3,1,1,0,0,0.818181818181818,0.733333333333333,0.477272727272727,0.533333333333333,0,"orthodox"
"180048",38,34,170,180,180,193,198,196,35,31,8,9,20,18,"win_A",4,-10,-13,2,1,0,0,0,0.813953488372093,0.775,0.465116279069767,0.45,0,"orthodox"
"180054",36,24,170,182,180,183,198,201,31,17,6,6,18,8,"win_A",12,-12,-3,-3,1,0,0,0,0.837837837837838,0.739130434782609,0.486486486486487,0.347826086956522,0,"orthodox"
"180061",33,32,170,185,180,193,189,190,25,17,2,4,14,11,"win_A",1,-15,-13,-1,0,0,0,0,0.925925925925926,0.80952380952381,0.518518518518518,0.523809523809524,0,"orthodox"
"180102",27,19,171,180,180,183,137,137,68,22,10,2,33,8,"win_B",8,-9,-3,0,0,0,0,0,0.871794871794872,0.916666666666667,0.423076923076923,0.333333333333333,1,"orthodox"
"180115",22,25,168,171,174,180,135,134,58,57,8,8,33,30,"win_B",-3,-3,-6,1,0,0,0,0,0.878787878787879,0.876923076923077,0.5,0.461538461538462,1,"orthodox"
"180120",30,24,178,171,180,180,136,144,130,53,36,6,68,28,"win_B",6,7,0,-8,0,0,0,0,0.783132530120482,0.898305084745763,0.409638554216867,0.474576271186441,1,"orthodox"
"180123",22,24,168,171,174,180,134,135,53,50,6,6,31,27,"win_B",-2,-3,-6,-1,0,0,0,0,0.898305084745763,0.892857142857143,0.525423728813559,0.482142857142857,1,"orthodox"
"180149",23,21,173,171,173,180,137,135,45,26,16,1,30,16,"win_A",2,2,-7,2,0,0,0,0,0.737704918032787,0.962962962962963,0.491803278688525,0.592592592592593,0,"orthodox"
"180162",20,25,171,170,180,170,135,139,14,59,0,22,9,24,"win_A",-5,1,10,-4,0,0,0,0,1,0.728395061728395,0.642857142857143,0.296296296296296,0,"orthodox"
"180183",28,23,180,175,185,185,170,189,84,6,11,10,53,2,"win_A",5,5,0,-19,0,0,0,1,0.884210526315789,0.375,0.557894736842105,0.125,0,"orthodox"
"180184",26,27,185,180,196,185,172,188,54,84,4,10,41,53,"win_A",-1,5,11,-16,0,0,0,1,0.931034482758621,0.893617021276596,0.706896551724138,0.563829787234043,0,"orthodox"
"180191",20,27,180,188,185,183,170,182,76,48,10,9,47,35,"win_A",-7,-8,2,-12,0,0,0,0,0.883720930232558,0.842105263157895,0.546511627906977,0.614035087719298,0,"orthodox"
"180197",19,24,180,191,185,201,172,189,70,14,9,4,41,12,"win_A",-5,-11,-16,-17,0,0,0,1,0.886075949367089,0.777777777777778,0.518987341772152,0.666666666666667,0,"orthodox"
"180357",27,25,168,166,174,168,138,147,77,65,13,11,40,38,"win_B",2,2,6,-9,0,0,0,0,0.855555555555556,0.855263157894737,0.444444444444444,0.5,1,"orthodox"
"180379",22,20,168,166,174,170,139,136,56,81,8,7,33,17,"win_A",2,2,4,3,0,0,0,0,0.875,0.920454545454545,0.515625,0.193181818181818,0,"orthodox"
"180497",30,38,177,171,180,175,153,153,36,41,4,10,11,21,"win_B",-8,6,5,0,0,1,0,0,0.9,0.803921568627451,0.275,0.411764705882353,1,"southpaw"
"180500",33,28,182,177,183,180,153,153,34,34,1,3,21,11,"win_B",5,5,3,0,0,0,0,0,0.971428571428571,0.918918918918919,0.6,0.297297297297297,1,"orthodox"
"180502",25,30,177,175,180,175,146,146,31,25,2,3,11,22,"win_A",-5,2,5,0,0,0,0,0,0.939393939393939,0.892857142857143,0.333333333333333,0.785714285714286,0,"southpaw"
"180504",24,36,177,183,180,188,147,147,29,37,2,4,11,31,"win_A",-12,-6,-8,0,0,1,0,0,0.935483870967742,0.902439024390244,0.354838709677419,0.75609756097561,0,"southpaw"
"180507",23,29,177,183,180,185,145,146,27,22,1,4,11,13,"win_A",-6,-6,-5,-1,0,0,0,0,0.964285714285714,0.846153846153846,0.392857142857143,0.5,0,"southpaw"
"180511",22,27,177,177,180,175,148,150,23,18,1,2,10,11,"win_A",-5,0,5,-2,0,0,0,0,0.958333333333333,0.9,0.416666666666667,0.55,0,"southpaw"
"180522",22,20,175,177,178,180,139,140,25,13,2,0,20,5,"win_A",2,-2,-2,-1,0,0,0,0,0.925925925925926,1,0.740740740740741,0.384615384615385,0,"orthodox"
"180534",19,29,177,173,180,173,140,130,1,3,0,10,0,2,"win_A",-10,4,7,10,0,0,0,0,1,0.230769230769231,0,0.153846153846154,0,"southpaw"
"180652",31,29,173,168,173,169,146,145,45,42,2,5,36,37,"win_A",2,5,4,1,0,0,0,0,0.957446808510638,0.893617021276596,0.765957446808511,0.787234042553192,0,"orthodox"
"180658",26,23,168,172,169,175,135,135,38,20,3,1,34,11,"win_A",3,-4,-6,0,0,0,0,0,0.926829268292683,0.952380952380952,0.829268292682927,0.523809523809524,0,"orthodox"
"180668",26,23,173,168,188,169,135,135,24,28,1,2,15,24,"win_B",3,5,19,0,0,0,0,0,0.96,0.933333333333333,0.6,0.8,1,"orthodox"
"180669",24,23,169,168,175,169,134,135,28,28,0,1,15,24,"win_A",1,1,6,-1,0,0,0,0,1,0.96551724137931,0.535714285714286,0.827586206896552,0,"southpaw"
"180674",21,25,168,169,169,163,135,135,24,87,0,5,21,73,"win_B",-4,-1,6,0,0,0,0,0,1,0.945652173913043,0.875,0.793478260869565,1,"orthodox"
"180677",20,24,168,169,169,163,134,134,21,82,0,4,20,69,"win_A",-4,-1,6,0,0,0,0,0,1,0.953488372093023,0.952380952380952,0.802325581395349,0,"orthodox"
"180966",22,24,177,173,183,185,147,147,17,31,0,1,12,20,"win_A",-2,4,-2,0,0,0,0,0,1,0.96875,0.705882352941177,0.625,0,"orthodox"
"181038",22,22,168,170,178,175,136,136,96,36,5,12,21,8,"win_A",0,-2,3,0,0,0,0,0,0.95049504950495,0.75,0.207920792079208,0.166666666666667,0,"southpaw"
"181044",22,27,168,171,178,178,133,142,90,58,5,29,19,10,"win_A",-5,-3,0,-9,0,0,0,0,0.947368421052632,0.666666666666667,0.2,0.114942528735632,0,"southpaw"
"181136",22,36,183,177,178,180,170,170,18,47,1,11,13,34,"win_A",-14,6,-2,0,0,1,0,0,0.947368421052632,0.810344827586207,0.684210526315789,0.586206896551724,0,"orthodox"
"181137",26,36,182,177,196,180,168,169,29,47,1,10,25,34,"win_A",-10,5,16,-1,0,1,0,0,0.966666666666667,0.824561403508772,0.833333333333333,0.596491228070175,0,"southpaw"
"181141",34,23,177,171,180,178,158,158,46,13,6,1,33,10,"win_A",11,6,2,0,0,0,0,0,0.884615384615385,0.928571428571429,0.634615384615385,0.714285714285714,0,"orthodox"
"181146",32,28,177,178,180,188,158,158,43,40,4,4,31,25,"win_B",4,-1,-8,0,0,0,0,0,0.914893617021277,0.909090909090909,0.659574468085106,0.568181818181818,1,"orthodox"
"181150",30,28,177,180,180,180,153,153,40,21,2,3,30,15,"win_A",2,-3,0,0,0,0,0,0,0.952380952380952,0.875,0.714285714285714,0.625,0,"orthodox"
"181156",28,27,177,169,180,178,147,145,34,54,1,2,26,43,"win_B",1,8,2,2,0,0,0,0,0.971428571428571,0.964285714285714,0.742857142857143,0.767857142857143,1,"orthodox"
"181163",25,25,177,177,180,188,146,147,27,19,1,2,20,19,"win_A",0,0,-8,-1,0,0,0,0,0.964285714285714,0.904761904761905,0.714285714285714,0.904761904761905,0,"orthodox"
"181343",31,26,165,161,166,160,111,110,58,38,15,12,36,5,"win_A",5,4,6,1,0,0,0,0,0.794520547945205,0.76,0.493150684931507,0.1,0,"orthodox"
"181478",38,28,201,191,201,193,252,251,37,27,2,0,36,24,"win_A",10,10,8,1,1,0,0,0,0.948717948717949,1,0.923076923076923,0.888888888888889,0,"orthodox"
"181481",32,38,201,193,201,196,245,235,33,39,2,2,32,29,"win_A",-6,8,5,10,0,1,0,0,0.942857142857143,0.951219512195122,0.914285714285714,0.707317073170732,0,"orthodox"
"181482",32,31,201,188,201,206,250,260,32,34,2,1,31,25,"win_A",1,13,-5,-10,0,0,0,0,0.941176470588235,0.971428571428571,0.911764705882353,0.714285714285714,0,"orthodox"
"181499",26,37,201,183,201,191,238,240,16,21,0,16,16,12,"win_A",-11,18,10,-2,0,1,0,0,1,0.567567567567568,1,0.324324324324324,0,"orthodox"
"181507",25,31,201,185,201,185,238,210,8,10,0,5,8,3,"win_A",-6,16,16,28,0,0,1,0,1,0.666666666666667,1,0.2,0,"orthodox"
"181517",36,30,183,191,188,213,201,219,48,18,14,0,31,16,"win_A",6,-8,-25,-18,1,0,0,1,0.774193548387097,1,0.5,0.888888888888889,0,"orthodox"
"181538",26,26,183,193,188,208,192,256,26,24,7,5,19,18,"win_B",0,-10,-20,-64,0,0,0,1,0.787878787878788,0.827586206896552,0.575757575757576,0.620689655172414,1,"orthodox"
"181544",31,24,182,183,191,188,185,184,89,22,14,5,62,18,"win_A",7,-1,3,1,0,0,0,0,0.864077669902913,0.814814814814815,0.601941747572815,0.666666666666667,0,"orthodox"
"181624",25,26,185,184,196,193,188,187,52,53,4,11,39,22,"win_A",-1,1,3,1,0,0,0,0,0.928571428571429,0.828125,0.696428571428571,0.34375,0,"orthodox"
"181625",24,37,185,199,196,211,187,245,51,24,4,5,38,19,"win_A",-13,-14,-15,-58,0,1,0,1,0.927272727272727,0.827586206896552,0.690909090909091,0.655172413793103,0,"orthodox"
"181626",23,31,185,188,196,183,190,178,50,76,4,33,37,38,"win_A",-8,-3,13,12,0,0,0,0,0.925925925925926,0.697247706422018,0.685185185185185,0.348623853211009,0,"orthodox"
"181627",23,34,185,193,196,206,185,220,49,47,4,14,36,32,"win_A",-11,-8,-10,-35,0,0,0,1,0.924528301886792,0.770491803278688,0.679245283018868,0.524590163934426,0,"orthodox"
"181628",23,24,185,184,196,193,185,187,48,46,4,7,36,18,"win_A",-1,1,3,-2,0,0,0,0,0.923076923076923,0.867924528301887,0.692307692307692,0.339622641509434,0,"orthodox"
"181633",23,27,185,194,196,215,188,208,43,41,3,6,31,34,"win_A",-4,-9,-19,-20,0,0,0,1,0.934782608695652,0.872340425531915,0.673913043478261,0.723404255319149,0,"orthodox"
"181643",22,33,185,193,196,206,198,226,33,47,3,13,22,32,"win_A",-11,-8,-10,-28,0,0,0,1,0.916666666666667,0.783333333333333,0.611111111111111,0.533333333333333,0,"orthodox"
"181658",21,26,185,196,196,207,185,205,20,9,1,4,17,5,"win_A",-5,-11,-11,-20,0,0,0,1,0.952380952380952,0.692307692307692,0.80952380952381,0.384615384615385,0,"orthodox"
"181716",30,29,178,179,189,180,155,164,50,118,10,19,27,32,"win_B",1,-1,9,-9,0,0,0,0,0.833333333333333,0.861313868613139,0.45,0.233576642335766,1,"orthodox"
"181717",30,29,178,179,189,180,163,165,49,118,10,18,27,32,"win_A",1,-1,9,-2,0,0,0,0,0.830508474576271,0.867647058823529,0.457627118644068,0.235294117647059,0,"orthodox"
"181723",29,26,179,175,180,185,162,165,113,65,17,5,32,34,"win_B",3,4,-5,-3,0,0,0,0,0.869230769230769,0.928571428571429,0.246153846153846,0.485714285714286,1,"orthodox"
"181729",28,26,179,175,180,185,159,164,107,62,17,4,32,32,"win_A",2,4,-5,-5,0,0,0,0,0.862903225806452,0.939393939393939,0.258064516129032,0.484848484848485,0,"orthodox"
"181732",29,28,178,179,189,180,159,163,42,104,8,17,25,32,"win_B",1,-1,9,-4,0,0,0,0,0.84,0.859504132231405,0.5,0.264462809917355,1,"orthodox"
"181778",25,25,179,174,180,182,150,148,67,33,8,19,26,3,"win_A",0,5,-2,2,0,0,0,0,0.893333333333333,0.634615384615385,0.346666666666667,0.0576923076923077,0,"orthodox"
"181782",22,24,175,179,191,180,148,155,26,64,3,7,15,26,"win_B",-2,-4,11,-7,0,0,0,0,0.896551724137931,0.901408450704225,0.517241379310345,0.366197183098592,1,"orthodox"
"181789",24,24,179,170,180,170,143,146,57,91,7,24,23,44,"win_A",0,9,10,-3,0,0,0,0,0.890625,0.791304347826087,0.359375,0.382608695652174,0,"orthodox"
"181828",20,26,179,163,180,161,133,136,23,78,2,22,15,26,"win_A",-6,16,19,-3,0,0,0,0,0.92,0.78,0.6,0.26,0,"orthodox"
"181854",26,33,187,179,188,184,175,175,23,43,1,5,15,35,"win_A",-7,8,4,0,0,0,0,0,0.958333333333333,0.895833333333333,0.625,0.729166666666667,0,"orthodox"
"181876",24,25,180,179,191,184,175,175,22,22,3,2,15,17,"win_A",-1,1,7,0,0,0,0,0,0.88,0.916666666666667,0.6,0.708333333333333,0,"orthodox"
"181885",23,23,180,179,191,184,175,175,15,15,3,0,9,12,"win_A",0,1,7,0,0,0,0,0,0.833333333333333,1,0.5,0.8,0,"orthodox"
"181939",21,26,168,160,173,156,108,108,10,13,1,2,5,7,"win_A",-5,8,17,0,0,0,0,0,0.909090909090909,0.866666666666667,0.454545454545455,0.466666666666667,0,"southpaw"
"181951",28,39,179,170,183,188,187,184,16,46,7,4,12,34,"win_A",-11,9,-5,3,0,1,0,0,0.695652173913043,0.92,0.521739130434783,0.68,0,"Unknown"
"181955",28,26,170,185,188,194,181,188,42,21,4,5,31,18,"win_A",2,-15,-6,-7,0,0,0,0,0.91304347826087,0.807692307692308,0.673913043478261,0.692307692307692,0,"orthodox"
"181956",27,25,170,185,188,194,174,186,41,16,3,4,30,13,"win_A",2,-15,-6,-12,0,0,0,0,0.931818181818182,0.8,0.681818181818182,0.65,0,"orthodox"
"181957",27,29,170,178,188,191,181,184,40,21,3,5,29,18,"win_A",-2,-8,-3,-3,0,0,0,0,0.930232558139535,0.807692307692308,0.674418604651163,0.692307692307692,0,"orthodox"
"181958",26,28,170,178,188,191,182,187,39,21,3,4,28,18,"win_A",-2,-8,-3,-5,0,0,0,0,0.928571428571429,0.84,0.666666666666667,0.72,0,"orthodox"
"181963",26,28,170,178,188,191,181,180,34,20,3,1,23,17,"win_A",-2,-8,-3,1,0,0,0,0,0.918918918918919,0.952380952380952,0.621621621621622,0.80952380952381,0,"orthodox"
"181964",25,26,170,179,188,175,170,169,32,29,3,7,22,21,"win_A",-1,-9,13,1,0,0,0,0,0.914285714285714,0.805555555555556,0.628571428571429,0.583333333333333,0,"orthodox"
"182006",28,25,154,157,160,160,121,125,91,95,18,29,78,18,"win_B",3,-3,0,-4,0,0,0,0,0.834862385321101,0.766129032258065,0.715596330275229,0.145161290322581,1,"Unknown"
"182031",23,20,157,168,160,168,118,118,72,46,24,13,9,13,"win_A",3,-11,-8,0,0,0,0,0,0.75,0.779661016949153,0.09375,0.220338983050847,0,"Unknown"
"182051",22,29,157,164,160,171,119,120,63,111,12,21,8,24,"win_B",-7,-7,-11,-1,0,0,0,0,0.84,0.840909090909091,0.106666666666667,0.181818181818182,1,"Unknown"
"182193",33,23,169,168,174,170,122,122,35,14,4,0,22,5,"win_A",10,1,4,0,0,0,0,0,0.897435897435897,1,0.564102564102564,0.357142857142857,0,"southpaw"
"182199",30,32,169,168,174,173,124,125,27,31,4,11,15,14,"win_A",-2,1,1,-1,0,0,0,0,0.870967741935484,0.738095238095238,0.483870967741935,0.333333333333333,0,"southpaw"
"182206",24,25,169,166,174,170,120,120,20,21,3,2,12,18,"win_A",-1,3,4,0,0,0,0,0,0.869565217391304,0.91304347826087,0.521739130434783,0.782608695652174,0,"southpaw"
"182231",35,33,172,170,173,178,125,126,39,37,4,6,31,21,"win_A",2,2,-5,-1,1,0,0,0,0.906976744186046,0.86046511627907,0.720930232558139,0.488372093023256,0,"orthodox"
"182239",30,31,172,164,173,165,118,118,32,37,2,13,26,19,"win_A",-1,8,8,0,0,0,0,0,0.941176470588235,0.74,0.764705882352941,0.38,0,"orthodox"
"182273",25,27,159,160,165,169,125,126,36,59,5,12,16,21,"win_A",-2,-1,-4,-1,0,0,0,0,0.878048780487805,0.830985915492958,0.390243902439024,0.295774647887324,0,"orthodox"
"182357",27,27,173,179,175,185,146,147,31,41,0,6,20,36,"win_B",0,-6,-10,-1,0,0,0,0,1,0.872340425531915,0.645161290322581,0.765957446808511,1,"orthodox"
"182458",36,32,196,183,206,180,280,228,41,18,1,5,33,10,"win_A",4,13,26,52,1,0,1,0,0.976190476190476,0.782608695652174,0.785714285714286,0.434782608695652,0,"orthodox"
"182459",36,32,196,188,206,198,263,273,40,29,1,25,32,25,"win_A",4,8,8,-10,1,0,0,0,0.975609756097561,0.537037037037037,0.780487804878049,0.462962962962963,0,"orthodox"
"182460",28,28,196,193,206,201,235,239,39,28,1,1,32,25,"win_A",0,3,5,-4,0,0,0,0,0.975,0.96551724137931,0.8,0.862068965517241,0,"orthodox"
"182461",27,28,196,193,206,201,252,243,38,28,1,0,32,25,"win_A",-1,3,5,9,0,0,0,0,0.974358974358974,1,0.82051282051282,0.892857142857143,0,"orthodox"
"182462",26,30,196,201,206,208,243,237,36,23,1,0,30,22,"win_A",-4,-5,-2,6,0,0,0,0,0.972972972972973,1,0.810810810810811,0.956521739130435,0,"orthodox"
"182463",26,23,196,188,206,191,241,214,35,26,1,0,29,25,"win_A",3,8,15,27,0,0,1,0,0.972222222222222,1,0.805555555555556,0.961538461538462,0,"orthodox"
"182464",26,27,196,191,206,206,241,228,34,16,1,0,29,12,"win_A",-1,5,0,13,0,0,0,0,0.971428571428571,1,0.828571428571429,0.75,0,"orthodox"
"182465",24,36,196,188,206,196,244,224,33,19,0,9,28,13,"win_A",-12,8,10,20,0,1,1,0,1,0.678571428571429,0.848484848484849,0.464285714285714,0,"orthodox"
"182466",24,34,196,191,206,198,243,244,32,50,0,3,27,32,"win_A",-10,5,8,-1,0,0,0,0,1,0.943396226415094,0.84375,0.60377358490566,0,"orthodox"
"182468",23,27,196,182,206,183,235,229,29,17,0,13,25,8,"win_A",-4,14,23,6,0,0,0,0,1,0.566666666666667,0.862068965517241,0.266666666666667,0,"orthodox"
"182472",22,24,196,187,206,198,225,220,25,18,0,1,22,15,"win_A",-2,9,8,5,0,0,0,0,1,0.947368421052632,0.88,0.789473684210526,0,"orthodox"
"182478",22,24,196,181,206,199,230,208,19,22,0,6,17,19,"win_A",-2,15,7,22,0,0,1,0,1,0.785714285714286,0.894736842105263,0.678571428571429,0,"orthodox"
"182479",22,32,196,191,206,196,230,227,18,30,0,4,16,24,"win_A",-10,5,10,3,0,0,0,0,1,0.882352941176471,0.888888888888889,0.705882352941177,0,"orthodox"
"182627",26,26,171,156,180,163,127,128,71,124,17,21,7,49,"win_B",0,15,17,-1,0,0,0,0,0.806818181818182,0.855172413793103,0.0795454545454545,0.337931034482759,1,"orthodox"
"183036",25,24,179,168,182,173,140,135,58,62,4,12,14,27,"win_A",1,11,9,5,0,0,0,0,0.935483870967742,0.837837837837838,0.225806451612903,0.364864864864865,0,"orthodox"
"183038",25,25,179,171,182,176,137,133,56,46,4,28,14,5,"win_A",0,8,6,4,0,0,0,0,0.933333333333333,0.621621621621622,0.233333333333333,0.0675675675675676,0,"orthodox"
"183143",21,33,193,179,203,175,194,205,17,52,3,17,15,35,"win_A",-12,14,28,-11,0,0,0,0,0.85,0.753623188405797,0.75,0.507246376811594,0,"Unknown"
"183144",20,32,193,179,203,175,190,205,15,52,3,16,13,35,"win_A",-12,14,28,-15,0,0,0,1,0.833333333333333,0.764705882352941,0.722222222222222,0.514705882352941,0,"Unknown"
"183149",31,27,179,193,175,206,180,232,47,7,15,0,31,7,"win_A",4,-14,-31,-52,0,0,0,1,0.758064516129032,1,0.5,1,0,"orthodox"
"183153",31,25,179,185,175,193,171,205,43,24,15,2,27,16,"win_A",6,-6,-18,-34,0,0,0,1,0.741379310344828,0.923076923076923,0.46551724137931,0.615384615384615,0,"orthodox"
"183262",24,22,175,175,185,180,139,147,23,30,8,0,9,14,"win_B",2,0,5,-8,0,0,0,0,0.741935483870968,1,0.290322580645161,0.466666666666667,1,"orthodox"
"183271",23,26,175,169,185,173,134,136,14,14,5,4,5,8,"win_A",-3,6,12,-2,0,0,0,0,0.736842105263158,0.777777777777778,0.263157894736842,0.444444444444444,0,"orthodox"
"183292",28,29,182,178,188,185,171,190,26,46,4,2,17,28,"win_A",-1,4,3,-19,0,0,0,1,0.866666666666667,0.958333333333333,0.566666666666667,0.583333333333333,0,"orthodox"
"183295",26,27,182,178,197,185,165,165,36,43,4,1,27,27,"win_A",-1,4,12,0,0,0,0,0,0.9,0.977272727272727,0.675,0.613636363636364,0,"orthodox"
"183298",25,26,182,178,197,185,160,160,30,40,3,0,24,27,"win_A",-1,4,12,0,0,0,0,0,0.909090909090909,1,0.727272727272727,0.675,0,"orthodox"
"183342",28,40,175,169,183,175,161,159,18,75,6,4,7,36,"win_A",-12,6,8,2,0,1,0,0,0.75,0.949367088607595,0.291666666666667,0.455696202531646,0,"Unknown"
"183351",36,25,169,173,175,173,157,158,65,22,4,2,32,8,"win_A",11,-4,2,-1,1,0,0,0,0.942028985507246,0.916666666666667,0.463768115942029,0.333333333333333,0,"southpaw"
"183352",36,25,169,177,175,183,153,154,64,62,4,4,32,36,"win_A",11,-8,-8,-1,1,0,0,0,0.941176470588235,0.939393939393939,0.470588235294118,0.545454545454545,0,"southpaw"
"183353",36,34,169,173,175,175,157,155,63,35,4,16,31,22,"win_A",2,-4,0,2,1,0,0,0,0.940298507462687,0.686274509803922,0.462686567164179,0.431372549019608,0,"southpaw"
"183354",34,29,169,173,175,173,153,152,61,31,3,10,29,13,"win_A",5,-4,2,1,0,0,0,0,0.953125,0.75609756097561,0.453125,0.317073170731707,0,"southpaw"
"183377",30,28,168,169,170,175,140,139,27,38,3,0,13,16,"win_A",2,-1,-5,1,0,0,0,0,0.9,1,0.433333333333333,0.421052631578947,0,"orthodox"
"183378",28,29,169,160,175,165,140,140,37,34,0,3,16,27,"win_A",-1,9,10,0,0,0,0,0,1,0.918918918918919,0.432432432432432,0.72972972972973,0,"southpaw"
"183379",27,27,171,169,179,175,140,138,28,36,3,0,23,16,"win_B",0,2,4,2,0,0,0,0,0.903225806451613,1,0.741935483870968,0.444444444444444,1,"orthodox"
"183382",26,28,169,164,175,165,140,139,33,29,0,3,16,23,"win_A",-2,5,10,1,0,0,0,0,1,0.90625,0.484848484848485,0.71875,0,"southpaw"
"183385",24,31,169,173,175,184,141,141,30,29,0,3,15,12,"win_A",-7,-4,-9,0,0,0,0,0,1,0.90625,0.5,0.375,0,"southpaw"
"183386",24,30,169,174,175,180,135,135,29,44,0,5,15,34,"win_A",-6,-5,-5,0,0,0,0,0,1,0.897959183673469,0.517241379310345,0.693877551020408,0,"southpaw"
"183389",22,23,169,173,175,168,135,134,25,14,0,6,15,9,"win_A",-1,-4,7,1,0,0,0,0,1,0.7,0.6,0.45,0,"southpaw"
"183532",29,26,166,166,175,173,130,130,32,25,2,24,29,20,"win_A",3,0,2,0,0,0,0,0,0.941176470588235,0.510204081632653,0.852941176470588,0.408163265306122,0,"southpaw"
"183533",28,31,166,165,175,173,124,125,30,25,1,2,27,8,"win_A",-3,1,2,-1,0,0,0,0,0.967741935483871,0.925925925925926,0.870967741935484,0.296296296296296,0,"southpaw"
"183536",26,30,166,165,175,183,121,121,26,26,0,12,24,18,"win_A",-4,1,-8,0,0,0,0,0,1,0.684210526315789,0.923076923076923,0.473684210526316,0,"southpaw"
"183541",27,24,165,166,178,175,121,121,34,21,1,0,30,19,"win_B",3,-1,3,0,0,0,0,0,0.971428571428571,1,0.857142857142857,0.904761904761905,1,"southpaw"
"183544",23,37,166,173,175,173,122,122,17,54,0,10,15,44,"win_A",-14,-7,2,0,0,1,0,0,1,0.84375,0.882352941176471,0.6875,0,"southpaw"
"183546",23,29,166,163,175,175,123,122,15,16,0,3,13,8,"win_A",-6,3,0,1,0,0,0,0,1,0.842105263157895,0.866666666666667,0.421052631578947,0,"southpaw"
"183547",23,22,166,166,175,173,123,123,14,15,0,1,12,10,"win_A",1,0,2,0,0,0,0,0,1,0.9375,0.857142857142857,0.625,0,"southpaw"
"183623",28,35,170,171,178,187,147,149,40,56,14,12,31,34,"win_A",-7,-1,-9,-2,0,1,0,0,0.740740740740741,0.823529411764706,0.574074074074074,0.5,0,"orthodox"
"183629",24,33,171,171,168,187,148,147,19,51,0,10,10,30,"win_A",-9,0,-19,1,0,0,0,0,1,0.836065573770492,0.526315789473684,0.491803278688525,0,"orthodox"
"183639",31,32,171,173,187,188,142,142,42,34,8,10,27,22,"win_A",-1,-2,-1,0,0,0,0,0,0.84,0.772727272727273,0.54,0.5,0,"orthodox"
"183641",31,21,171,178,187,180,142,140,41,36,7,2,26,23,"win_B",10,-7,7,2,0,0,0,0,0.854166666666667,0.947368421052632,0.541666666666667,0.605263157894737,1,"orthodox"
"183643",25,30,183,171,188,187,139,140,26,40,1,6,24,25,"win_A",-5,12,1,-1,0,0,0,0,0.962962962962963,0.869565217391304,0.888888888888889,0.543478260869565,0,"Unknown"
"183650",27,25,171,171,187,179,140,140,33,25,5,2,23,20,"win_A",2,0,8,0,0,0,0,0,0.868421052631579,0.925925925925926,0.605263157894737,0.740740740740741,0,"orthodox"
"183652",27,32,171,175,187,185,140,140,31,55,5,7,22,40,"win_A",-5,-4,2,0,0,0,0,0,0.861111111111111,0.887096774193548,0.611111111111111,0.645161290322581,0,"orthodox"
"183668",23,23,171,160,187,165,136,136,17,24,1,2,11,19,"win_B",0,11,22,0,0,0,0,0,0.944444444444444,0.923076923076923,0.611111111111111,0.730769230769231,1,"orthodox"
"183745",22,26,171,171,175,178,148,150,54,85,4,10,20,36,"win_A",-4,0,-3,-2,0,0,0,0,0.931034482758621,0.894736842105263,0.344827586206897,0.378947368421053,0,"Unknown"
"183750",23,21,175,171,191,175,148,148,56,49,12,3,33,18,"win_B",2,4,16,0,0,0,0,0,0.823529411764706,0.942307692307692,0.485294117647059,0.346153846153846,1,"orthodox"
"183770",20,20,171,173,175,180,143,145,29,53,3,3,7,14,"win_A",0,-2,-5,-2,0,0,0,0,0.90625,0.946428571428571,0.21875,0.25,0,"Unknown"
"183771",20,20,171,173,175,180,142,145,28,51,2,2,7,14,"win_A",0,-2,-5,-3,0,0,0,0,0.933333333333333,0.962264150943396,0.233333333333333,0.264150943396226,0,"Unknown"
"183909",20,30,183,179,191,188,147,147,17,56,0,6,17,36,"win_A",-10,4,3,0,0,0,0,0,1,0.903225806451613,1,0.580645161290323,0,"orthodox"
"183931",28,27,173,164,180,170,139,140,25,54,3,4,9,32,"win_B",1,9,10,-1,0,0,0,0,0.892857142857143,0.931034482758621,0.321428571428571,0.551724137931034,1,"Unknown"
"183936",25,24,164,167,170,165,135,135,49,26,3,6,28,18,"win_A",1,-3,5,0,0,0,0,0,0.942307692307692,0.8125,0.538461538461538,0.5625,0,"orthodox"
"183988",27,29,175,178,180,188,133,134,27,22,1,2,18,14,"win_A",-2,-3,-8,-1,0,0,0,0,0.964285714285714,0.916666666666667,0.642857142857143,0.583333333333333,0,"southpaw"
"183990",27,34,175,173,180,183,135,134,25,35,1,15,17,17,"win_A",-7,2,-3,1,0,0,0,0,0.961538461538462,0.7,0.653846153846154,0.34,0,"southpaw"
"183993",24,24,175,178,180,185,126,125,21,23,1,1,14,19,"win_A",0,-3,-5,1,0,0,0,0,0.954545454545455,0.958333333333333,0.636363636363636,0.791666666666667,0,"southpaw"
"183994",24,27,175,179,180,170,126,126,20,24,1,3,13,12,"win_A",-3,-4,10,0,0,0,0,0,0.952380952380952,0.888888888888889,0.619047619047619,0.444444444444444,0,"southpaw"
"183995",28,23,165,175,165,180,126,126,35,19,1,1,10,12,"win_B",5,-10,-15,0,0,0,0,0,0.972222222222222,0.95,0.277777777777778,0.6,1,"orthodox"
"183997",23,32,175,170,180,183,127,128,16,24,1,14,9,20,"win_A",-9,5,-3,-1,0,0,0,0,0.941176470588235,0.631578947368421,0.529411764705882,0.526315789473684,0,"southpaw"
"184000",21,27,175,165,180,178,126,126,13,28,0,4,6,20,"win_A",-6,10,2,0,0,0,0,0,1,0.875,0.461538461538462,0.625,0,"southpaw"
"184001",21,31,175,173,180,175,126,125,12,30,0,2,5,21,"win_A",-10,2,5,1,0,0,0,0,1,0.9375,0.416666666666667,0.65625,0,"southpaw"
"184003",20,26,175,173,180,178,127,126,10,15,0,8,3,10,"win_A",-6,2,2,1,0,0,0,0,1,0.652173913043478,0.3,0.434782608695652,0,"southpaw"
"184013",29,29,179,173,178,178,149,149,40,30,4,2,33,20,"win_B",0,6,0,0,0,0,0,0,0.909090909090909,0.9375,0.75,0.625,1,"orthodox"
"184014",35,29,170,179,175,178,139,135,33,40,3,3,21,33,"win_A",6,-9,-3,4,1,0,0,0,0.916666666666667,0.930232558139535,0.583333333333333,0.767441860465116,0,"southpaw"
"184015",26,32,179,170,178,175,130,130,37,30,2,1,31,19,"win_A",-6,9,3,0,0,0,0,0,0.948717948717949,0.967741935483871,0.794871794871795,0.612903225806452,0,"orthodox"
"184018",25,28,179,170,178,178,131,132,35,12,1,3,29,7,"win_A",-3,9,0,-1,0,0,0,0,0.972222222222222,0.8,0.805555555555556,0.466666666666667,0,"orthodox"
"184023",22,27,179,175,178,183,130,130,30,33,0,4,24,21,"win_A",-5,4,-5,0,0,0,0,0,1,0.891891891891892,0.8,0.567567567567568,0,"orthodox"
"184028",21,23,179,163,178,165,130,130,25,15,0,0,21,7,"win_A",-2,16,13,0,0,0,0,0,1,1,0.84,0.466666666666667,0,"orthodox"
"184046",19,24,179,173,178,178,132,131,7,9,0,5,5,3,"win_A",-5,6,0,1,0,0,0,0,1,0.642857142857143,0.714285714285714,0.214285714285714,0,"orthodox"
"184064",34,28,188,185,196,183,190,190,30,37,4,1,26,24,"win_B",6,3,13,0,0,0,0,0,0.882352941176471,0.973684210526316,0.764705882352941,0.631578947368421,1,"orthodox"
"184101",34,26,182,193,188,206,212,235,32,4,9,0,20,4,"win_B",8,-11,-18,-23,0,0,0,1,0.780487804878049,1,0.48780487804878,1,1,"orthodox"
"184112",27,24,182,192,188,201,185,197,22,27,4,8,17,13,"win_A",3,-10,-13,-12,0,0,0,0,0.846153846153846,0.771428571428571,0.653846153846154,0.371428571428571,0,"orthodox"
"184114",26,26,182,182,188,197,176,168,20,35,3,4,16,27,"win_B",0,0,-9,8,0,0,0,0,0.869565217391304,0.897435897435897,0.695652173913043,0.692307692307692,1,"orthodox"
"184172",20,30,156,163,165,168,124,124,31,109,6,16,18,38,"win_B",-10,-7,-3,0,0,0,0,0,0.837837837837838,0.872,0.486486486486487,0.304,1,"southpaw"
"184173",30,29,163,157,168,165,123,124,108,50,16,16,38,14,"win_A",1,6,3,-1,0,0,0,0,0.870967741935484,0.757575757575758,0.306451612903226,0.212121212121212,0,"Unknown"
"184228",24,24,163,157,168,165,122,116,57,34,6,7,18,12,"win_A",0,6,3,6,0,0,0,0,0.904761904761905,0.829268292682927,0.285714285714286,0.292682926829268,0,"Unknown"
"184232",23,23,163,157,168,165,122,119,54,32,5,5,16,12,"win_A",0,6,3,3,0,0,0,0,0.915254237288136,0.864864864864865,0.271186440677966,0.324324324324324,0,"Unknown"
"184242",23,22,163,157,168,165,120,120,44,31,5,4,14,12,"win_A",1,6,3,0,0,0,0,0,0.897959183673469,0.885714285714286,0.285714285714286,0.342857142857143,0,"Unknown"
"184277",22,18,161,163,165,168,113,116,46,13,6,0,18,9,"win_A",4,-2,-3,-3,0,0,0,0,0.884615384615385,1,0.346153846153846,0.692307692307692,0,"Unknown"
"184564",25,29,189,180,191,189,164,164,32,27,0,1,29,17,"win_A",-4,9,2,0,0,0,0,0,1,0.964285714285714,0.90625,0.607142857142857,0,"orthodox"
"184566",26,24,180,178,189,188,161,162,22,16,0,0,16,9,"win_A",2,2,1,-1,0,0,0,0,1,1,0.727272727272727,0.5625,0,"orthodox"
"184572",24,33,180,175,189,180,159,158,16,22,0,5,12,16,"win_A",-9,5,9,1,0,0,0,0,1,0.814814814814815,0.75,0.592592592592593,0,"orthodox"
"184577",24,32,180,183,189,185,163,163,10,15,0,2,7,8,"win_A",-8,-3,4,0,0,0,0,0,1,0.882352941176471,0.7,0.470588235294118,0,"orthodox"
"184581",23,27,180,175,189,180,159,160,6,23,0,10,4,18,"win_A",-4,5,9,-1,0,0,0,0,1,0.696969696969697,0.666666666666667,0.545454545454545,0,"orthodox"
"184631",22,21,168,168,168,170,114,129,66,23,17,2,21,2,"win_A",1,0,-2,-15,0,0,0,1,0.795180722891566,0.92,0.253012048192771,0.08,0,"orthodox"
"184638",21,27,168,154,168,160,118,118,57,86,17,11,17,73,"win_A",-6,14,8,0,0,0,0,0,0.77027027027027,0.88659793814433,0.22972972972973,0.752577319587629,0,"orthodox"
"184708",31,36,168,159,160,173,119,119,34,43,2,13,16,28,"win_A",-5,9,-13,0,0,1,0,0,0.944444444444444,0.767857142857143,0.444444444444444,0.5,0,"Unknown"
"184710",29,30,168,163,160,165,118,118,33,47,1,7,16,35,"win_B",-1,5,-5,0,0,0,0,0,0.970588235294118,0.87037037037037,0.470588235294118,0.648148148148148,1,"Unknown"
"184716",26,23,168,168,160,161,118,118,28,21,0,3,15,16,"win_A",3,0,-1,0,0,0,0,0,1,0.875,0.535714285714286,0.666666666666667,0,"Unknown"
"184721",24,25,168,170,160,165,118,118,22,21,0,7,12,9,"win_A",-1,-2,-5,0,0,0,0,0,1,0.75,0.545454545454545,0.321428571428571,0,"Unknown"
"184970",27,37,183,183,185,185,154,154,21,40,0,3,5,29,"win_B",-10,0,0,0,0,1,0,0,1,0.930232558139535,0.238095238095238,0.674418604651163,1,"orthodox"
"184972",36,37,183,179,185,181,153,152,39,48,2,3,28,29,"win_A",-1,4,4,1,1,1,0,0,0.951219512195122,0.941176470588235,0.682926829268293,0.568627450980392,0,"orthodox"
"184973",36,36,170,183,173,185,154,154,43,38,10,2,13,28,"win_B",0,-13,-12,0,1,1,0,0,0.811320754716981,0.95,0.245283018867925,0.7,1,"orthodox"
"184974",36,35,171,183,180,185,153,154,37,37,2,2,31,28,"win_B",1,-12,-5,-1,1,1,0,0,0.948717948717949,0.948717948717949,0.794871794871795,0.717948717948718,1,"orthodox"
"184975",34,34,183,180,185,188,154,154,36,18,2,3,27,8,"win_A",0,3,-3,0,0,0,0,0,0.947368421052632,0.857142857142857,0.710526315789474,0.380952380952381,0,"orthodox"
"184977",30,32,175,183,175,185,147,146,24,35,3,1,22,26,"win_A",-2,-8,-10,1,0,0,0,0,0.888888888888889,0.972222222222222,0.814814814814815,0.722222222222222,0,"orthodox"
"184979",30,28,183,177,185,175,150,151,32,18,0,4,25,11,"win_A",2,6,10,-1,0,0,0,0,1,0.818181818181818,0.78125,0.5,0,"orthodox"
"184981",29,36,183,171,185,178,146,146,30,40,0,4,25,29,"win_A",-7,12,7,0,0,1,0,0,1,0.909090909090909,0.833333333333333,0.659090909090909,0,"orthodox"
"184982",28,25,183,180,185,175,147,147,29,27,0,4,24,23,"win_A",3,3,10,0,0,0,0,0,1,0.870967741935484,0.827586206896552,0.741935483870968,0,"orthodox"
"184984",28,27,183,178,185,188,146,146,27,37,0,3,22,23,"win_A",1,5,-3,0,0,0,0,0,1,0.925,0.814814814814815,0.575,0,"orthodox"
"184985",28,38,183,170,185,183,148,144,26,33,0,21,21,14,"win_A",-10,13,2,4,0,1,0,0,1,0.611111111111111,0.807692307692308,0.259259259259259,0,"orthodox"
"184989",26,29,183,180,185,185,145,147,22,30,0,6,18,13,"win_A",-3,3,0,-2,0,0,0,0,1,0.833333333333333,0.818181818181818,0.361111111111111,0,"orthodox"
"184991",26,31,183,170,185,178,143,141,20,23,0,3,17,16,"win_A",-5,13,7,2,0,0,0,0,1,0.884615384615385,0.85,0.615384615384615,0,"orthodox"
"184993",26,31,183,168,185,170,145,144,18,8,0,8,15,2,"win_A",-5,15,15,1,0,0,0,0,1,0.5,0.833333333333333,0.125,0,"orthodox"
"185228",21,24,170,157,178,159,134,133,50,65,8,12,21,15,"win_B",-3,13,19,1,0,0,0,0,0.862068965517241,0.844155844155844,0.362068965517241,0.194805194805195,1,"orthodox"
"185237",24,23,160,157,168,159,126,125,101,56,16,12,29,13,"win_B",1,3,9,1,0,0,0,0,0.863247863247863,0.823529411764706,0.247863247863248,0.191176470588235,1,"southpaw"
"185247",23,21,163,157,166,159,130,131,73,46,17,12,7,11,"win_B",2,6,7,-1,0,0,0,0,0.811111111111111,0.793103448275862,0.0777777777777778,0.189655172413793,1,"orthodox"
"185310",24,27,166,170,165,178,140,140,40,118,13,22,16,64,"win_B",-3,-4,-13,0,0,0,0,0,0.754716981132076,0.842857142857143,0.30188679245283,0.457142857142857,1,"Unknown"
"185311",24,27,166,170,165,178,139,135,40,117,12,22,16,63,"win_B",-3,-4,-13,4,0,0,0,0,0.769230769230769,0.841726618705036,0.307692307692308,0.453237410071942,1,"Unknown"
"185335",24,28,170,163,178,166,137,144,94,111,17,42,48,11,"win_A",-4,7,12,-7,0,0,0,0,0.846846846846847,0.725490196078431,0.432432432432432,0.0718954248366013,0,"orthodox"
"185350",23,23,170,178,178,180,132,135,81,54,15,6,40,7,"win_A",0,-8,-2,-3,0,0,0,0,0.84375,0.9,0.416666666666667,0.116666666666667,0,"orthodox"
"185355",23,23,170,178,178,180,133,135,78,50,13,5,38,5,"win_B",0,-8,-2,-2,0,0,0,0,0.857142857142857,0.909090909090909,0.417582417582418,0.0909090909090909,1,"orthodox"
"185384",21,21,170,173,178,178,135,134,52,81,9,4,21,9,"win_B",0,-3,0,1,0,0,0,0,0.852459016393443,0.952941176470588,0.344262295081967,0.105882352941176,1,"orthodox"
"185589",28,32,159,170,165,173,132,135,54,46,6,11,26,26,"win_A",-4,-11,-8,-3,0,0,0,0,0.9,0.807017543859649,0.433333333333333,0.456140350877193,0,"orthodox"
"185607",21,25,166,159,168,165,128,127,31,34,4,5,31,14,"win_B",-4,7,3,1,0,0,0,0,0.885714285714286,0.871794871794872,0.885714285714286,0.358974358974359,1,"orthodox"
"185610",24,29,159,168,165,171,127,128,31,81,5,49,14,41,"win_A",-5,-9,-6,-1,0,0,0,0,0.861111111111111,0.623076923076923,0.388888888888889,0.315384615384615,0,"orthodox"
"185633",20,31,159,157,165,168,129,130,11,69,2,27,8,39,"win_A",-11,2,-3,-1,0,0,0,0,0.846153846153846,0.71875,0.615384615384615,0.40625,0,"orthodox"
"185721",28,28,166,165,168,165,118,116,25,16,0,4,11,12,"win_B",0,1,3,2,0,0,0,0,1,0.8,0.44,0.6,1,"southpaw"
"185729",23,30,165,164,165,165,117,117,8,36,1,11,7,19,"win_A",-7,1,0,0,0,0,0,0,0.888888888888889,0.765957446808511,0.777777777777778,0.404255319148936,0,"orthodox"
"186045",48,29,174,180,178,183,148,148,31,27,3,3,19,18,"win_B",19,-6,-5,0,1,0,0,0,0.911764705882353,0.9,0.558823529411765,0.6,1,"orthodox"
"186046",48,24,174,175,178,175,147,147,30,8,3,7,18,8,"win_A",24,-1,3,0,1,0,0,0,0.909090909090909,0.533333333333333,0.545454545454545,0.533333333333333,0,"orthodox"
"186050",31,28,168,174,174,178,147,146,44,26,12,1,30,15,"win_B",3,-6,-4,1,0,0,0,0,0.785714285714286,0.962962962962963,0.535714285714286,0.555555555555556,1,"Unknown"
"186067",24,20,174,178,178,185,146,147,10,12,0,1,3,3,"win_B",4,-4,-7,-1,0,0,0,0,1,0.923076923076923,0.3,0.230769230769231,1,"orthodox"
"186083",21,24,168,178,173,185,126,126,36,16,1,0,29,10,"win_A",-3,-10,-12,0,0,0,0,0,0.972972972972973,1,0.783783783783784,0.625,0,"orthodox"
"186084",21,27,168,171,173,180,126,126,35,42,1,4,28,39,"win_A",-6,-3,-7,0,0,0,0,0,0.972222222222222,0.91304347826087,0.777777777777778,0.847826086956522,0,"orthodox"
"186126",29,30,163,166,169,170,115,115,37,35,2,3,28,26,"win_A",-1,-3,-1,0,0,0,0,0,0.948717948717949,0.921052631578947,0.717948717948718,0.684210526315789,0,"orthodox"
"186127",28,31,163,168,169,170,115,115,36,33,2,2,27,17,"win_A",-3,-5,-1,0,0,0,0,0,0.947368421052632,0.942857142857143,0.710526315789474,0.485714285714286,0,"orthodox"
"186128",24,27,164,163,164,169,115,115,26,33,1,2,14,25,"win_B",-3,1,-5,0,0,0,0,0,0.962962962962963,0.942857142857143,0.518518518518518,0.714285714285714,1,"southpaw"
"186135",32,24,160,163,160,169,115,115,41,27,3,0,27,21,"win_A",8,-3,-9,0,0,0,0,0,0.931818181818182,1,0.613636363636364,0.777777777777778,0,"southpaw"
"186150",19,27,163,157,169,168,112,111,12,16,0,8,11,9,"win_A",-8,6,1,1,0,0,0,0,1,0.666666666666667,0.916666666666667,0.375,0,"orthodox"
"186284",35,26,177,173,178,182,159,154,61,44,9,16,31,26,"win_B",9,4,-4,5,1,0,0,0,0.871428571428571,0.733333333333333,0.442857142857143,0.433333333333333,1,"orthodox"
"186332",24,23,178,177,184,178,162,161,61,16,13,1,17,8,"win_B",1,1,6,1,0,0,0,0,0.824324324324324,0.941176470588235,0.22972972972973,0.470588235294118,1,"Unknown"
"186343",22,22,177,178,178,183,157,157,6,93,0,2,5,41,"win_B",0,-1,-5,0,0,0,0,0,1,0.978947368421053,0.833333333333333,0.431578947368421,1,"orthodox"
"186543",24,29,183,185,187,189,159,159,105,92,8,28,52,34,"win_A",-5,-2,-2,0,0,0,0,0,0.929203539823009,0.766666666666667,0.460176991150442,0.283333333333333,0,"Unknown"
"186552",23,23,183,173,187,180,155,159,98,77,6,11,49,16,"win_B",0,10,7,-4,0,0,0,0,0.942307692307692,0.875,0.471153846153846,0.181818181818182,1,"Unknown"
"186717",26,28,189,178,191,178,159,160,34,43,1,4,30,37,"win_A",-2,11,13,-1,0,0,0,0,0.971428571428571,0.914893617021277,0.857142857142857,0.787234042553192,0,"orthodox"
"186726",22,31,189,175,191,175,164,167,22,26,0,9,20,17,"win_A",-9,14,16,-3,0,0,0,0,1,0.742857142857143,0.909090909090909,0.485714285714286,0,"orthodox"
"186740",19,30,189,178,191,185,159,154,8,7,0,1,8,5,"win_A",-11,11,6,5,0,0,0,0,1,0.875,1,0.625,0,"orthodox"
"186750",25,28,180,183,191,193,175,175,24,33,3,3,16,23,"win_A",-3,-3,-2,0,0,0,0,0,0.888888888888889,0.916666666666667,0.592592592592593,0.638888888888889,0,"orthodox"
"186757",25,25,183,188,193,191,174,173,28,31,1,3,21,17,"win_A",0,-5,2,1,0,0,0,0,0.96551724137931,0.911764705882353,0.724137931034483,0.5,0,"Unknown"
"186790",28,31,184,194,193,215,188,207,69,76,12,8,30,62,"win_A",-3,-10,-22,-19,0,0,0,1,0.851851851851852,0.904761904761905,0.37037037037037,0.738095238095238,0,"orthodox"
"186808",25,23,184,173,193,188,180,182,52,55,9,17,21,23,"win_B",2,11,5,-2,0,0,0,0,0.852459016393443,0.763888888888889,0.344262295081967,0.319444444444444,1,"orthodox"
"186816",24,27,184,180,193,178,179,184,43,18,6,8,17,10,"win_A",-3,4,15,-5,0,0,0,0,0.877551020408163,0.692307692307692,0.346938775510204,0.384615384615385,0,"orthodox"
"186817",24,31,184,188,193,183,178,179,42,76,6,32,17,38,"win_A",-7,-4,10,-1,0,0,0,0,0.875,0.703703703703704,0.354166666666667,0.351851851851852,0,"orthodox"
"186821",24,26,184,192,193,211,175,210,38,44,6,16,15,34,"win_A",-2,-8,-18,-35,0,0,0,1,0.863636363636364,0.733333333333333,0.340909090909091,0.566666666666667,0,"orthodox"
"186826",23,33,184,193,193,206,178,228,33,45,5,11,14,30,"win_A",-10,-9,-13,-50,0,0,0,1,0.868421052631579,0.803571428571429,0.368421052631579,0.535714285714286,0,"orthodox"
"187078",30,39,183,175,175,184,169,169,30,39,2,5,11,30,"win_A",-9,8,-9,0,0,1,0,0,0.9375,0.886363636363636,0.34375,0.681818181818182,0,"orthodox"
"187081",35,32,175,175,184,183,176,174,36,44,4,14,27,23,"win_A",3,0,1,2,1,0,0,0,0.9,0.758620689655172,0.675,0.396551724137931,0,"orthodox"
"187085",31,30,175,180,184,188,160,159,32,32,2,0,24,29,"win_A",1,-5,-4,1,0,0,0,0,0.941176470588235,1,0.705882352941177,0.90625,0,"orthodox"
"187089",29,27,175,180,184,203,162,162,28,18,1,2,22,14,"win_A",2,-5,-19,0,0,0,0,0,0.96551724137931,0.9,0.758620689655172,0.7,0,"orthodox"
"187094",26,32,175,183,184,188,159,159,23,35,0,1,19,26,"win_A",-6,-8,-4,0,0,0,0,0,1,0.972222222222222,0.826086956521739,0.722222222222222,0,"orthodox"
"187102",23,27,175,173,184,178,162,159,15,12,0,4,13,2,"win_A",-4,2,6,3,0,0,0,0,1,0.75,0.866666666666667,0.125,0,"orthodox"
"187329",30,24,168,170,174,188,152,152,100,82,14,38,45,59,"win_A",6,-2,-14,0,0,0,0,0,0.87719298245614,0.683333333333333,0.394736842105263,0.491666666666667,0,"orthodox"
"187331",30,27,168,168,174,165,144,142,98,28,14,6,44,15,"win_A",3,0,9,2,0,0,0,0,0.875,0.823529411764706,0.392857142857143,0.441176470588235,0,"orthodox"
"187439",21,33,170,169,183,170,136,136,27,44,0,8,15,36,"win_A",-12,1,13,0,0,0,0,0,1,0.846153846153846,0.555555555555556,0.692307692307692,0,"southpaw"
"187440",20,33,180,169,180,170,135,135,28,44,1,7,22,36,"win_A",-13,11,10,0,0,0,0,0,0.96551724137931,0.862745098039216,0.758620689655172,0.705882352941177,0,"orthodox"
"187467",21,22,165,169,173,170,126,126,17,20,2,1,10,17,"win_A",-1,-4,3,0,0,0,0,0,0.894736842105263,0.952380952380952,0.526315789473684,0.80952380952381,0,"orthodox"
"187554",30,26,178,183,188,189,175,174,36,37,1,7,26,24,"win_A",4,-5,-1,1,0,0,0,0,0.972972972972973,0.840909090909091,0.702702702702703,0.545454545454545,0,"orthodox"
"187568",25,25,175,178,183,188,161,164,19,22,7,0,9,17,"win_B",0,-3,-5,-3,0,0,0,0,0.730769230769231,1,0.346153846153846,0.772727272727273,1,"Unknown"
"187591",26,30,182,173,185,179,182,196,9,37,1,8,7,34,"win_A",-4,9,6,-14,0,0,0,0,0.9,0.822222222222222,0.7,0.755555555555556,0,"Unknown"
"187595",28,26,188,173,199,179,177,196,26,36,5,4,14,33,"win_A",2,15,20,-19,0,0,0,1,0.838709677419355,0.9,0.451612903225806,0.825,0,"orthodox"
"187602",32,24,185,173,185,179,178,183,10,27,1,3,4,25,"win_B",8,12,6,-5,0,0,0,0,0.909090909090909,0.9,0.363636363636364,0.833333333333333,1,"orthodox"
"187603",24,26,173,188,179,199,177,190,26,13,3,3,24,5,"win_A",-2,-15,-20,-13,0,0,0,0,0.896551724137931,0.8125,0.827586206896552,0.3125,0,"orthodox"
"187604",23,39,173,183,179,185,178,193,25,32,2,4,23,29,"win_A",-16,-10,-6,-15,0,1,0,1,0.925925925925926,0.888888888888889,0.851851851851852,0.805555555555556,0,"orthodox"
"187749",26,36,175,170,183,170,134,134,26,52,2,6,19,33,"win_A",-10,5,13,0,0,1,0,0,0.928571428571429,0.896551724137931,0.678571428571429,0.568965517241379,0,"orthodox"
"187751",35,25,170,170,170,173,137,135,50,21,6,15,33,10,"win_A",10,0,-3,2,1,0,0,0,0.892857142857143,0.583333333333333,0.589285714285714,0.277777777777778,0,"orthodox"
"187752",34,26,170,168,170,173,137,137,49,16,6,3,32,6,"win_A",8,2,-3,0,0,0,0,0,0.890909090909091,0.842105263157895,0.581818181818182,0.315789473684211,0,"orthodox"
"187753",34,25,170,170,170,175,138,137,48,19,6,3,32,11,"win_A",9,0,-5,1,0,0,0,0,0.888888888888889,0.863636363636364,0.592592592592593,0.5,0,"orthodox"
"187755",34,29,170,172,170,193,136,137,46,30,6,9,31,19,"win_A",5,-2,-23,-1,0,0,0,0,0.884615384615385,0.769230769230769,0.596153846153846,0.487179487179487,0,"orthodox"
"187763",31,26,170,172,170,193,135,132,39,20,4,5,27,13,"win_A",5,-2,-23,3,0,0,0,0,0.906976744186046,0.8,0.627906976744186,0.52,0,"orthodox"
"187767",29,28,170,173,170,193,130,129,35,39,3,7,25,21,"win_A",1,-3,-23,1,0,0,0,0,0.921052631578947,0.847826086956522,0.657894736842105,0.456521739130435,0,"orthodox"
"187785",24,29,170,165,170,173,130,130,18,34,2,8,12,19,"win_A",-5,5,-3,0,0,0,0,0,0.9,0.80952380952381,0.6,0.452380952380952,0,"orthodox"
"187788",23,30,170,178,170,180,133,133,16,30,1,8,11,20,"win_A",-7,-8,-10,0,0,0,0,0,0.941176470588235,0.789473684210526,0.647058823529412,0.526315789473684,0,"orthodox"
"187903",22,19,165,173,165,173,138,139,25,52,3,6,4,10,"win_B",3,-8,-8,-1,0,0,0,0,0.892857142857143,0.896551724137931,0.142857142857143,0.172413793103448,1,"southpaw"
"188033",33,25,154,159,160,173,111,111,60,26,5,6,15,17,"win_B",8,-5,-13,0,0,0,0,0,0.923076923076923,0.8125,0.230769230769231,0.53125,1,"orthodox"
"188042",29,27,154,162,160,160,112,112,50,24,4,6,15,8,"win_A",2,-8,0,0,0,0,0,0,0.925925925925926,0.8,0.277777777777778,0.266666666666667,0,"orthodox"
"188100",31,36,184,185,178,189,175,175,41,40,0,4,31,19,"win_A",-5,-1,-11,0,0,1,0,0,1,0.909090909090909,0.75609756097561,0.431818181818182,0,"orthodox"
"188101",29,31,170,184,178,178,175,175,38,40,2,0,27,30,"win_B",-2,-14,0,0,0,0,0,0,0.95,1,0.675,0.75,1,"orthodox"
"188136",23,35,184,174,178,183,175,174,4,39,0,12,4,12,"win_A",-12,10,-5,1,0,1,0,0,1,0.764705882352941,1,0.235294117647059,0,"orthodox"
"188586",23,17,171,178,180,178,126,123,28,29,3,0,27,25,"win_A",6,-7,2,3,0,0,0,0,0.903225806451613,1,0.870967741935484,0.862068965517241,0,"orthodox"
"188635",21,26,180,173,188,180,161,162,69,109,16,14,20,25,"win_B",-5,7,8,-1,0,0,0,0,0.811764705882353,0.886178861788618,0.235294117647059,0.203252032520325,1,"Unknown"
"188637",26,24,173,178,180,178,162,162,107,51,14,11,25,21,"win_A",2,-5,2,0,0,0,0,0,0.884297520661157,0.82258064516129,0.206611570247934,0.338709677419355,0,"Unknown"
"188639",26,22,173,170,180,183,160,159,105,75,14,12,25,45,"win_A",4,3,-3,1,0,0,0,0,0.882352941176471,0.862068965517241,0.210084033613445,0.517241379310345,0,"Unknown"
"188641",25,23,173,178,180,184,158,157,105,66,12,1,25,13,"win_B",2,-5,-4,1,0,0,0,0,0.897435897435897,0.985074626865672,0.213675213675214,0.194029850746269,1,"Unknown"
"188651",24,21,173,175,180,178,158,156,95,17,12,5,21,0,"win_A",3,-2,2,2,0,0,0,0,0.88785046728972,0.772727272727273,0.196261682242991,0,0,"Unknown"
"188692",21,22,173,170,180,170,150,152,57,37,4,7,14,20,"win_B",-1,3,10,-2,0,0,0,0,0.934426229508197,0.840909090909091,0.229508196721311,0.454545454545455,1,"Unknown"
"188755",30,27,171,175,180,178,134,132,23,26,0,1,17,21,"win_A",3,-4,2,2,0,0,0,0,1,0.962962962962963,0.739130434782609,0.777777777777778,0,"southpaw"
"188756",29,29,171,166,180,173,135,135,22,12,0,0,16,3,"win_A",0,5,7,0,0,0,0,0,1,1,0.727272727272727,0.25,0,"southpaw"
"188759",28,28,171,168,180,163,134,135,19,36,0,1,14,22,"win_A",0,3,17,-1,0,0,0,0,1,0.972972972972973,0.736842105263158,0.594594594594595,0,"southpaw"
"188896",28,28,185,188,188,198,168,168,38,24,0,0,29,18,"win_A",0,-3,-10,0,0,0,0,0,1,1,0.763157894736842,0.75,0,"orthodox"
"188898",26,34,185,183,188,188,168,167,36,38,0,6,27,14,"win_A",-8,2,0,1,0,0,0,0,1,0.863636363636364,0.75,0.318181818181818,0,"orthodox"
"188899",28,25,185,185,198,188,168,168,18,34,4,0,16,26,"win_B",3,0,10,0,0,0,0,0,0.818181818181818,1,0.727272727272727,0.764705882352941,1,"orthodox"
"189003",28,27,171,179,176,188,149,140,71,34,41,11,8,6,"win_B",1,-8,-12,9,0,0,0,0,0.633928571428571,0.755555555555556,0.0714285714285714,0.133333333333333,1,"orthodox"
"189006",28,27,171,179,176,188,149,142,71,31,40,10,8,5,"win_B",1,-8,-12,7,0,0,0,0,0.63963963963964,0.75609756097561,0.0720720720720721,0.121951219512195,1,"orthodox"
"189008",28,27,171,179,176,188,152,139,70,31,39,8,8,5,"win_A",1,-8,-12,13,0,0,0,0,0.642201834862385,0.794871794871795,0.073394495412844,0.128205128205128,0,"orthodox"
"189009",27,30,179,179,188,187,149,160,30,32,8,17,5,11,"win_A",-3,0,1,-11,0,0,0,0,0.789473684210526,0.653061224489796,0.131578947368421,0.224489795918367,0,"southpaw"
"189011",26,23,179,170,188,173,153,150,30,32,6,13,5,15,"win_B",3,9,15,3,0,0,0,0,0.833333333333333,0.711111111111111,0.138888888888889,0.333333333333333,1,"southpaw"
"189034",24,22,179,163,188,165,136,135,12,37,0,15,2,17,"win_A",2,16,23,1,0,0,0,0,1,0.711538461538462,0.166666666666667,0.326923076923077,0,"southpaw"
"189112",37,27,170,174,173,173,151,158,71,34,29,23,25,16,"win_A",10,-4,0,-7,1,0,0,0,0.71,0.596491228070175,0.25,0.280701754385965,0,"Unknown"
"189114",25,34,174,170,173,173,156,158,27,70,13,28,12,25,"win_A",-9,4,0,-2,0,0,0,0,0.675,0.714285714285714,0.3,0.255102040816327,0,"Unknown"
"189117",23,32,185,170,189,173,154,156,55,70,23,25,19,25,"win_A",-9,15,16,-2,0,0,0,0,0.705128205128205,0.736842105263158,0.243589743589744,0.263157894736842,0,"Unknown"
"189128",21,30,171,170,165,173,148,146,15,63,5,21,5,25,"win_A",-9,1,-8,2,0,0,0,0,0.75,0.75,0.25,0.297619047619048,0,"Unknown"
"189151",32,26,179,170,187,173,151,157,41,47,22,14,16,20,"win_B",6,9,14,-6,0,0,0,0,0.650793650793651,0.770491803278688,0.253968253968254,0.327868852459016,1,"Unknown"
"189161",23,27,170,178,173,185,147,163,31,75,12,12,15,34,"win_A",-4,-8,-12,-16,0,0,0,1,0.720930232558139,0.862068965517241,0.348837209302326,0.390804597701149,0,"Unknown"
"189164",23,24,170,163,173,165,146,138,27,57,10,22,13,26,"win_A",-1,7,8,8,0,0,0,0,0.72972972972973,0.721518987341772,0.351351351351351,0.329113924050633,0,"Unknown"
"189202",28,28,168,158,172,159,105,105,21,24,0,4,15,10,"win_A",0,10,13,0,0,0,0,0,1,0.857142857142857,0.714285714285714,0.357142857142857,0,"southpaw"
"189209",22,29,158,165,159,161,105,105,16,25,2,6,7,10,"win_A",-7,-7,-2,0,0,0,0,0,0.888888888888889,0.806451612903226,0.388888888888889,0.32258064516129,0,"orthodox"
"189433",34,38,169,163,178,165,118,117,41,54,2,7,21,36,"win_A",-4,6,13,1,0,1,0,0,0.953488372093023,0.885245901639344,0.488372093023256,0.590163934426229,0,"orthodox"
"189435",26,35,165,163,178,165,122,122,30,51,1,5,28,34,"win_A",-9,2,13,0,0,1,0,0,0.967741935483871,0.910714285714286,0.903225806451613,0.607142857142857,0,"southpaw"
"189436",35,31,163,168,165,168,119,119,50,31,5,6,33,21,"win_A",4,-5,-3,0,1,0,0,0,0.909090909090909,0.837837837837838,0.6,0.567567567567568,0,"southpaw"
"189444",27,30,170,163,170,165,115,115,24,43,2,3,6,30,"win_A",-3,7,5,0,0,0,0,0,0.923076923076923,0.934782608695652,0.230769230769231,0.652173913043478,0,"orthodox"
"189449",27,25,163,165,165,165,115,114,39,12,2,3,26,9,"win_A",2,-2,0,1,0,0,0,0,0.951219512195122,0.8,0.634146341463415,0.6,0,"southpaw"
"189452",25,28,163,165,165,165,116,116,37,13,1,3,25,5,"win_A",-3,-2,0,0,0,0,0,0,0.973684210526316,0.8125,0.657894736842105,0.3125,0,"southpaw"
"189492",35,23,173,168,174,174,134,132,39,13,5,2,24,11,"win_A",12,5,0,2,1,0,0,0,0.886363636363636,0.866666666666667,0.545454545454545,0.733333333333333,0,"orthodox"
"189535",29,27,160,157,165,165,110,110,31,11,2,2,21,10,"win_A",2,3,0,0,0,0,0,0,0.939393939393939,0.846153846153846,0.636363636363636,0.769230769230769,0,"orthodox"
"189542",25,31,160,160,165,168,108,108,23,34,1,5,17,20,"win_A",-6,0,-3,0,0,0,0,0,0.958333333333333,0.871794871794872,0.708333333333333,0.512820512820513,0,"orthodox"
"189543",25,36,160,163,165,168,107,108,22,18,1,3,16,7,"win_A",-11,-3,-3,-1,0,1,0,0,0.956521739130435,0.857142857142857,0.695652173913043,0.333333333333333,0,"orthodox"
"189544",24,28,160,157,165,173,108,108,21,25,1,5,15,16,"win_A",-4,3,-8,0,0,0,0,0,0.954545454545455,0.833333333333333,0.681818181818182,0.533333333333333,0,"orthodox"
"189545",24,35,160,163,165,168,108,107,20,18,1,2,15,7,"win_A",-11,-3,-3,1,0,1,0,0,0.952380952380952,0.9,0.714285714285714,0.35,0,"orthodox"
"189547",23,29,160,163,165,168,108,112,18,17,1,3,13,11,"win_A",-6,-3,-3,-4,0,0,0,0,0.947368421052632,0.85,0.684210526315789,0.55,0,"orthodox"
"189552",21,32,160,160,165,152,108,108,13,30,0,8,9,20,"win_A",-11,0,13,0,0,0,0,0,1,0.789473684210526,0.692307692307692,0.526315789473684,0,"orthodox"
"189627",19,28,174,175,183,180,150,151,16,55,0,7,4,21,"win_A",-9,-1,3,-1,0,0,0,0,1,0.887096774193548,0.25,0.338709677419355,0,"orthodox"
"189877",33,36,188,187,188,203,200,198,36,28,3,18,30,23,"win_A",-3,1,-15,2,0,1,0,0,0.923076923076923,0.608695652173913,0.769230769230769,0.5,0,"southpaw"
"189880",31,31,188,193,188,206,227,211,33,16,3,5,29,12,"win_A",0,-5,-18,16,0,0,1,0,0.916666666666667,0.761904761904762,0.805555555555556,0.571428571428571,0,"southpaw"
"189881",30,37,188,188,188,198,218,247,33,46,2,4,29,36,"win_B",-7,0,-10,-29,0,1,0,1,0.942857142857143,0.92,0.828571428571429,0.72,1,"southpaw"
"189882",30,29,185,188,201,188,212,227,28,33,0,1,25,29,"win_A",1,-3,13,-15,0,0,0,1,1,0.970588235294118,0.892857142857143,0.852941176470588,0,"orthodox"
"189885",27,34,188,173,188,175,189,187,30,119,0,7,27,83,"win_A",-7,15,13,2,0,0,0,0,1,0.944444444444444,0.9,0.658730158730159,0,"southpaw"
"189887",27,33,188,182,188,193,200,209,28,30,0,8,26,17,"win_A",-6,6,-5,-9,0,0,0,0,1,0.789473684210526,0.928571428571429,0.447368421052632,0,"southpaw"
"189888",26,35,188,185,188,196,190,190,27,19,0,2,25,10,"win_A",-9,3,-8,0,0,1,0,0,1,0.904761904761905,0.925925925925926,0.476190476190476,0,"southpaw"
"189894",25,27,188,185,188,193,188,188,21,19,0,0,19,14,"win_A",-2,3,-5,0,0,0,0,0,1,1,0.904761904761905,0.736842105263158,0,"southpaw"
"189895",25,34,188,188,188,203,188,188,20,30,0,4,18,22,"win_A",-9,0,-15,0,0,0,0,0,1,0.882352941176471,0.9,0.647058823529412,0,"southpaw"
"189899",24,31,188,183,188,180,189,189,16,14,0,18,15,5,"win_A",-7,5,8,0,0,0,0,0,1,0.4375,0.9375,0.15625,0,"southpaw"
"189901",24,28,188,188,188,198,189,190,14,19,0,1,14,15,"win_A",-4,0,-10,-1,0,0,0,0,1,0.95,1,0.75,0,"southpaw"
"189905",23,34,188,180,188,183,190,197,10,33,0,10,10,17,"win_A",-11,8,5,-7,0,0,0,0,1,0.767441860465116,1,0.395348837209302,0,"southpaw"
"189959",24,28,175,178,185,189,161,162,59,33,3,6,30,20,"win_A",-4,-3,-4,-1,0,0,0,0,0.951612903225806,0.846153846153846,0.483870967741935,0.512820512820513,0,"orthodox"
"189963",27,32,178,177,189,180,166,178,29,136,6,42,17,88,"win_A",-5,1,9,-12,0,0,0,0,0.828571428571429,0.764044943820225,0.485714285714286,0.49438202247191,0,"orthodox"
"189974",25,28,178,170,189,183,160,159,20,101,4,29,12,57,"win_A",-3,8,6,1,0,0,0,0,0.833333333333333,0.776923076923077,0.5,0.438461538461538,0,"orthodox"
"189978",27,24,178,178,184,189,166,165,65,16,25,4,18,9,"win_B",3,0,-5,1,0,0,0,0,0.722222222222222,0.8,0.2,0.45,1,"Unknown"
"189981",24,25,178,183,189,198,165,168,15,43,2,20,8,23,"win_A",-1,-5,-9,-3,0,0,0,0,0.882352941176471,0.682539682539683,0.470588235294118,0.365079365079365,0,"orthodox"
"189984",24,28,178,177,189,180,162,163,12,115,2,26,8,73,"win_A",-4,1,9,-1,0,0,0,0,0.857142857142857,0.815602836879433,0.571428571428571,0.517730496453901,0,"orthodox"
"189988",27,23,177,178,180,189,163,166,109,9,26,1,69,6,"win_A",4,-1,-9,-3,0,0,0,0,0.807407407407407,0.9,0.511111111111111,0.6,0,"southpaw"
"190096",27,38,168,163,173,165,126,126,16,40,3,8,12,27,"win_A",-11,5,8,0,0,1,0,0,0.842105263157895,0.833333333333333,0.631578947368421,0.5625,0,"orthodox"
"190099",30,33,168,163,170,165,115,115,18,35,3,6,9,25,"win_A",-3,5,5,0,0,0,0,0,0.857142857142857,0.853658536585366,0.428571428571429,0.609756097560976,0,"orthodox"
"190100",33,24,163,174,165,178,115,115,34,20,6,1,24,18,"win_A",9,-11,-13,0,0,0,0,0,0.85,0.952380952380952,0.6,0.857142857142857,0,"southpaw"
"190103",32,28,163,164,165,166,115,115,30,13,6,1,22,8,"win_A",4,-1,-1,0,0,0,0,0,0.833333333333333,0.928571428571429,0.611111111111111,0.571428571428571,0,"southpaw"
"190107",29,38,163,165,165,175,113,112,26,37,5,7,20,20,"win_A",-9,-2,-10,1,0,1,0,0,0.838709677419355,0.840909090909091,0.645161290322581,0.454545454545455,0,"southpaw"
"190109",29,29,163,168,165,178,108,108,25,23,4,1,19,16,"win_A",0,-5,-13,0,0,0,0,0,0.862068965517241,0.958333333333333,0.655172413793103,0.666666666666667,0,"southpaw"
"190110",28,35,163,163,165,168,108,108,24,24,4,2,18,13,"win_A",-7,0,-3,0,0,1,0,0,0.857142857142857,0.923076923076923,0.642857142857143,0.5,0,"southpaw"
"190111",28,37,163,165,165,170,108,108,23,36,4,8,17,33,"win_A",-9,-2,-5,0,0,1,0,0,0.851851851851852,0.818181818181818,0.62962962962963,0.75,0,"southpaw"
"190112",27,32,163,159,165,163,108,107,21,31,4,5,15,21,"win_A",-5,4,2,1,0,0,0,0,0.84,0.861111111111111,0.6,0.583333333333333,0,"southpaw"
"190115",26,33,163,160,165,152,108,108,18,30,4,10,14,20,"win_A",-7,3,13,0,0,0,0,0,0.818181818181818,0.75,0.636363636363636,0.5,0,"southpaw"
"190116",25,24,163,163,165,168,110,110,16,14,4,6,13,6,"win_A",1,0,-3,0,0,0,0,0,0.8,0.7,0.65,0.3,0,"southpaw"
"190124",22,21,165,163,175,165,111,110,16,10,2,2,13,7,"win_A",1,2,10,1,0,0,0,0,0.888888888888889,0.833333333333333,0.722222222222222,0.583333333333333,0,"orthodox"
"190259",28,39,198,185,196,188,231,222,36,43,2,18,24,27,"win_A",-11,13,8,9,0,1,0,0,0.947368421052632,0.704918032786885,0.631578947368421,0.442622950819672,0,"orthodox"
"190266",38,31,185,178,188,183,220,210,42,29,12,13,26,18,"win_B",7,7,5,10,1,0,0,0,0.777777777777778,0.69047619047619,0.481481481481481,0.428571428571429,1,"orthodox"
"190281",26,33,182,185,193,188,206,205,21,31,2,8,13,19,"win_A",-7,-3,5,1,0,0,0,0,0.91304347826087,0.794871794871795,0.565217391304348,0.487179487179487,0,"orthodox"
"190283",32,33,185,185,188,193,178,177,29,22,7,5,17,12,"win_A",-1,0,-5,1,0,0,0,0,0.805555555555556,0.814814814814815,0.472222222222222,0.444444444444444,0,"orthodox"
"190295",26,27,185,188,188,201,159,158,17,15,3,7,12,10,"win_A",-1,-3,-13,1,0,0,0,0,0.85,0.681818181818182,0.6,0.454545454545455,0,"orthodox"
"190317",28,37,171,182,175,185,149,152,29,55,7,4,14,49,"win_A",-9,-11,-10,-3,0,1,0,0,0.805555555555556,0.932203389830508,0.388888888888889,0.830508474576271,0,"orthodox"
"190321",35,28,182,175,185,201,156,157,51,15,4,1,47,9,"win_A",7,7,-16,-1,1,0,0,0,0.927272727272727,0.9375,0.854545454545454,0.5625,0,"orthodox"
"190325",26,33,183,182,196,185,160,160,30,49,2,2,28,45,"win_A",-7,1,11,0,0,0,0,0,0.9375,0.96078431372549,0.875,0.882352941176471,0,"orthodox"
"190329",25,32,183,182,196,185,159,160,27,46,2,1,25,43,"win_A",-7,1,11,-1,0,0,0,0,0.931034482758621,0.978723404255319,0.862068965517241,0.914893617021277,0,"orthodox"
"190331",26,31,178,182,183,185,159,159,24,44,1,1,19,42,"win_B",-5,-4,-2,0,0,0,0,0,0.96,0.977777777777778,0.76,0.933333333333333,1,"orthodox"
"190335",30,31,182,182,185,196,160,160,40,43,1,2,38,26,"win_A",-1,0,-11,0,0,0,0,0,0.975609756097561,0.955555555555556,0.926829268292683,0.577777777777778,0,"orthodox"
"190340",27,36,182,180,185,188,153,153,34,33,1,10,32,25,"win_A",-9,2,-3,0,0,1,0,0,0.971428571428571,0.767441860465116,0.914285714285714,0.581395348837209,0,"orthodox"
"190343",27,25,182,177,185,183,153,154,31,41,1,1,29,37,"win_A",2,5,2,-1,0,0,0,0,0.96875,0.976190476190476,0.90625,0.880952380952381,0,"orthodox"
"190897",32,32,168,173,183,183,140,140,45,38,5,20,32,26,"win_B",0,-5,0,0,0,0,0,0,0.9,0.655172413793103,0.64,0.448275862068966,1,"orthodox"
"190898",31,33,168,168,183,170,142,142,44,34,4,5,31,18,"win_A",-2,0,13,0,0,0,0,0,0.916666666666667,0.871794871794872,0.645833333333333,0.461538461538462,0,"orthodox"
"190899",30,35,168,173,183,183,139,139,43,21,4,15,30,12,"win_A",-5,-5,0,0,0,1,0,0,0.914893617021277,0.583333333333333,0.638297872340426,0.333333333333333,0,"orthodox"
"190905",29,26,168,165,183,175,135,135,38,33,3,9,26,23,"win_A",3,3,8,0,0,0,0,0,0.926829268292683,0.785714285714286,0.634146341463415,0.547619047619048,0,"orthodox"
"190945",25,28,161,160,157,168,105,105,11,30,0,1,5,19,"win_A",-3,1,-11,0,0,0,0,0,1,0.967741935483871,0.454545454545455,0.612903225806452,0,"orthodox"
"190964",22,35,168,163,177,160,118,118,20,39,1,12,7,13,"win_A",-13,5,17,0,0,1,0,0,0.952380952380952,0.764705882352941,0.333333333333333,0.254901960784314,0,"southpaw"
"190966",21,27,168,170,177,183,118,118,17,15,1,3,6,12,"win_A",-6,-2,-6,0,0,0,0,0,0.944444444444444,0.833333333333333,0.333333333333333,0.666666666666667,0,"southpaw"
"190967",20,33,168,170,177,175,118,118,13,25,1,5,4,12,"win_A",-13,-2,2,0,0,0,0,0,0.928571428571429,0.833333333333333,0.285714285714286,0.4,0,"southpaw"
"191177",35,29,168,176,171,179,122,122,35,36,5,3,15,32,"win_A",6,-8,-8,0,1,0,0,0,0.875,0.923076923076923,0.375,0.82051282051282,0,"southpaw"
"191210",20,29,185,182,193,197,171,183,8,43,1,8,8,30,"win_A",-9,3,-4,-12,0,0,0,0,0.888888888888889,0.843137254901961,0.888888888888889,0.588235294117647,0,"orthodox"
"191254",29,29,165,170,165,170,115,115,25,30,3,2,17,8,"win_A",0,-5,-5,0,0,0,0,0,0.892857142857143,0.9375,0.607142857142857,0.25,0,"orthodox"
"191256",28,28,170,165,170,165,115,115,28,23,2,2,8,16,"win_A",0,5,5,0,0,0,0,0,0.933333333333333,0.92,0.266666666666667,0.64,0,"orthodox"
"191389",33,27,169,182,178,183,146,153,73,14,5,3,48,6,"win_B",6,-13,-5,-7,0,0,0,0,0.935897435897436,0.823529411764706,0.615384615384615,0.352941176470588,1,"orthodox"
"191391",32,29,169,165,178,175,153,154,71,15,5,9,48,4,"win_A",3,4,3,-1,0,0,0,0,0.934210526315789,0.625,0.631578947368421,0.166666666666667,0,"orthodox"
"191394",32,30,169,177,178,185,161,161,68,10,5,2,47,9,"win_A",2,-8,-7,0,0,0,0,0,0.931506849315068,0.833333333333333,0.643835616438356,0.75,0,"orthodox"
"191399",30,29,169,175,178,173,152,155,64,166,4,6,44,116,"win_A",1,-6,5,-3,0,0,0,0,0.941176470588235,0.965116279069767,0.647058823529412,0.674418604651163,0,"orthodox"
"191401",30,29,169,175,178,180,151,152,62,29,3,6,44,12,"win_A",1,-6,-2,-1,0,0,0,0,0.953846153846154,0.828571428571429,0.676923076923077,0.342857142857143,0,"orthodox"
"191402",33,30,173,169,188,178,146,145,36,61,12,3,23,44,"win_B",3,4,10,1,0,0,0,0,0.75,0.953125,0.479166666666667,0.6875,1,"orthodox"
"191404",29,28,169,170,178,175,149,150,59,20,3,2,44,8,"win_A",1,-1,3,-1,0,0,0,0,0.951612903225806,0.909090909090909,0.709677419354839,0.363636363636364,0,"orthodox"
"191465",24,28,157,165,160,173,131,127,40,43,7,11,28,28,"win_A",-4,-8,-13,4,0,0,0,0,0.851063829787234,0.796296296296296,0.595744680851064,0.518518518518518,0,"Unknown"
"191493",21,24,165,169,173,170,127,126,20,9,2,3,14,6,"win_A",-3,-4,3,1,0,0,0,0,0.909090909090909,0.75,0.636363636363636,0.5,0,"orthodox"
"191613",33,25,159,162,161,163,106,108,35,20,20,1,22,12,"win_B",8,-3,-2,-2,0,0,0,0,0.636363636363636,0.952380952380952,0.4,0.571428571428571,1,"orthodox"
"191616",23,38,162,157,163,168,112,112,15,28,1,39,11,16,"win_A",-15,5,-5,0,0,1,0,0,0.9375,0.417910447761194,0.6875,0.238805970149254,0,"orthodox"
"191619",22,30,162,159,163,161,108,108,12,28,0,16,10,16,"win_A",-8,3,2,0,0,0,0,0,1,0.636363636363636,0.833333333333333,0.363636363636364,0,"orthodox"
"191637",32,37,169,160,178,168,120,119,37,27,2,11,19,18,"win_A",-5,9,10,1,0,1,0,0,0.948717948717949,0.710526315789474,0.487179487179487,0.473684210526316,0,"orthodox"
"191640",28,29,168,169,170,178,115,115,27,35,1,1,16,18,"win_A",-1,-1,-8,0,0,0,0,0,0.964285714285714,0.972222222222222,0.571428571428571,0.5,0,"orthodox"
"191641",29,34,169,160,178,152,115,118,34,30,1,12,18,20,"win_A",-5,9,26,-3,0,0,0,0,0.971428571428571,0.714285714285714,0.514285714285714,0.476190476190476,0,"orthodox"
"191642",27,27,169,160,178,168,112,111,32,22,0,2,18,7,"win_A",0,9,10,1,0,0,0,0,1,0.916666666666667,0.5625,0.291666666666667,0,"orthodox"
"191644",26,31,169,165,178,166,113,114,30,18,0,2,17,14,"win_A",-5,4,12,-1,0,0,0,0,1,0.9,0.566666666666667,0.7,0,"orthodox"
"191645",25,23,169,159,178,161,112,112,28,18,0,6,16,12,"win_A",2,10,17,0,0,0,0,0,1,0.75,0.571428571428571,0.5,0,"orthodox"
"191651",23,26,169,157,178,168,115,115,22,19,0,8,16,8,"win_A",-3,12,10,0,0,0,0,0,1,0.703703703703704,0.727272727272727,0.296296296296296,0,"orthodox"
"191677",38,32,168,170,165,183,126,126,55,23,4,13,28,19,"win_B",6,-2,-18,0,1,0,0,0,0.932203389830508,0.638888888888889,0.474576271186441,0.527777777777778,1,"orthodox"
"191680",28,37,169,168,168,165,126,126,22,53,4,3,13,28,"win_A",-9,1,3,0,0,1,0,0,0.846153846153846,0.946428571428571,0.5,0.5,0,"orthodox"
"191681",36,27,168,168,165,173,126,125,52,19,3,7,28,13,"win_A",9,0,-8,1,1,0,0,0,0.945454545454545,0.730769230769231,0.509090909090909,0.5,0,"orthodox"
"191685",34,30,168,159,165,160,124,123,48,48,2,8,25,28,"win_A",4,9,5,1,0,0,0,0,0.96,0.857142857142857,0.5,0.5,0,"orthodox"
"191686",30,33,166,168,168,165,124,123,30,48,1,1,12,25,"win_A",-3,-2,3,1,0,0,0,0,0.967741935483871,0.979591836734694,0.387096774193548,0.510204081632653,0,"southpaw"
"191687",33,28,168,165,165,157,118,118,47,32,1,14,25,8,"win_A",5,3,8,0,0,0,0,0,0.979166666666667,0.695652173913043,0.520833333333333,0.173913043478261,0,"orthodox"
"191689",29,32,166,168,168,165,118,118,27,46,1,0,12,25,"win_A",-3,-2,3,0,0,0,0,0,0.964285714285714,1,0.428571428571429,0.543478260869565,0,"southpaw"
"191692",31,31,168,164,165,163,115,115,42,29,0,11,24,18,"win_A",0,4,2,0,0,0,0,0,1,0.725,0.571428571428571,0.45,0,"orthodox"
"191694",23,30,165,168,173,165,114,114,30,40,1,0,27,24,"win_B",-7,-3,8,0,0,0,0,0,0.967741935483871,1,0.870967741935484,0.6,1,"orthodox"
"191699",29,26,168,170,165,160,115,114,35,12,0,2,21,6,"win_A",3,-2,5,1,0,0,0,0,1,0.857142857142857,0.6,0.428571428571429,0,"orthodox"
"191701",28,25,168,173,165,173,115,115,33,17,0,2,19,12,"win_A",3,-5,-8,0,0,0,0,0,1,0.894736842105263,0.575757575757576,0.631578947368421,0,"orthodox"
"191703",28,30,168,160,165,163,118,115,31,27,0,10,18,15,"win_A",-2,8,2,3,0,0,0,0,1,0.72972972972973,0.580645161290323,0.405405405405405,0,"orthodox"
"191717",23,21,168,173,165,163,115,115,17,19,0,1,10,11,"win_A",2,-5,2,0,0,0,0,0,1,0.95,0.588235294117647,0.55,0,"orthodox"
"191720",23,25,168,160,165,168,112,114,14,9,0,1,8,9,"win_A",-2,8,-3,-2,0,0,0,0,1,0.9,0.571428571428571,0.9,0,"orthodox"
"191727",22,22,168,162,165,168,115,115,7,0,0,3,5,0,"win_A",0,6,-3,0,0,0,0,0,1,0,0.714285714285714,0,0,"orthodox"
"191731",21,17,168,165,165,170,113,110,3,4,0,1,2,3,"win_A",4,3,-5,3,0,0,0,0,1,0.8,0.666666666666667,0.6,0,"orthodox"
"192001",35,28,164,178,174,183,133,134,41,28,4,4,18,18,"win_B",7,-14,-9,-1,1,0,0,0,0.911111111111111,0.875,0.4,0.5625,1,"southpaw"
"192004",33,34,164,170,174,183,136,140,37,32,3,9,17,11,"win_A",-1,-6,-9,-4,0,0,0,0,0.925,0.780487804878049,0.425,0.268292682926829,0,"southpaw"
"192007",28,30,175,164,183,174,135,135,32,35,2,2,24,17,"win_A",-2,11,9,0,0,0,0,0,0.941176470588235,0.945945945945946,0.705882352941177,0.459459459459459,0,"orthodox"
"192010",28,26,164,179,174,183,139,140,32,10,2,2,15,5,"win_A",2,-15,-9,-1,0,0,0,0,0.941176470588235,0.833333333333333,0.441176470588235,0.416666666666667,0,"southpaw"
"192012",28,30,164,168,174,170,136,136,30,29,2,29,15,19,"win_A",-2,-4,4,0,0,0,0,0,0.9375,0.5,0.46875,0.327586206896552,0,"southpaw"
"192015",26,24,164,168,174,180,135,135,27,28,1,3,14,22,"win_A",2,-4,-6,0,0,0,0,0,0.964285714285714,0.903225806451613,0.5,0.709677419354839,0,"southpaw"
"192018",26,25,164,170,174,180,136,136,24,20,1,2,13,13,"win_A",1,-6,-6,0,0,0,0,0,0.96,0.909090909090909,0.52,0.590909090909091,0,"southpaw"
"192021",24,24,164,175,174,175,134,134,22,25,0,2,13,20,"win_A",0,-11,-1,0,0,0,0,0,1,0.925925925925926,0.590909090909091,0.740740740740741,0,"southpaw"
"192032",23,21,170,164,183,174,137,138,31,11,1,0,18,7,"win_B",2,6,9,-1,0,0,0,0,0.96875,1,0.5625,0.636363636363636,1,"southpaw"
"192039",21,22,164,180,174,185,142,142,4,10,0,1,4,8,"win_A",-1,-16,-11,0,0,0,0,0,1,0.909090909090909,1,0.727272727272727,0,"southpaw"
"192362",30,37,175,178,185,191,165,178,39,21,13,10,18,18,"win_A",-7,-3,-6,-13,0,1,0,0,0.75,0.67741935483871,0.346153846153846,0.580645161290323,0,"Unknown"
"192372",28,27,175,179,185,187,162,161,34,21,7,5,16,6,"win_A",1,-4,-2,1,0,0,0,0,0.829268292682927,0.807692307692308,0.390243902439024,0.230769230769231,0,"Unknown"
"192374",27,24,175,178,185,185,160,158,32,64,5,8,15,25,"win_B",3,-3,0,2,0,0,0,0,0.864864864864865,0.888888888888889,0.405405405405405,0.347222222222222,1,"Unknown"
"192377",27,24,175,178,185,185,158,158,30,62,4,7,15,24,"win_B",3,-3,0,0,0,0,0,0,0.882352941176471,0.898550724637681,0.441176470588235,0.347826086956522,1,"Unknown"
"192381",27,39,175,174,185,183,163,160,26,29,4,11,14,24,"win_A",-12,1,2,3,0,1,0,0,0.866666666666667,0.725,0.466666666666667,0.6,0,"Unknown"
"192383",38,26,174,175,183,185,160,168,25,24,10,4,20,12,"win_B",12,-1,-2,-8,1,0,0,0,0.714285714285714,0.857142857142857,0.571428571428571,0.428571428571429,1,"southpaw"
"192389",23,26,178,175,185,185,162,167,52,18,3,2,21,9,"win_A",-3,3,0,-5,0,0,0,0,0.945454545454545,0.9,0.381818181818182,0.45,0,"orthodox"
"192397",24,31,175,175,185,175,159,158,9,34,0,10,7,17,"win_A",-7,0,10,1,0,0,0,0,1,0.772727272727273,0.777777777777778,0.386363636363636,0,"Unknown"
"192399",23,29,175,174,185,173,158,152,7,29,0,16,5,24,"win_A",-6,1,12,6,0,0,0,0,1,0.644444444444444,0.714285714285714,0.533333333333333,0,"Unknown"
"192401",23,38,175,175,185,178,160,164,5,20,0,5,3,19,"win_A",-15,0,7,-4,0,1,0,0,1,0.8,0.6,0.76,0,"Unknown"
"192410",30,28,173,168,180,163,129,129,47,11,5,4,27,5,"win_A",2,5,17,0,0,0,0,0,0.903846153846154,0.733333333333333,0.519230769230769,0.333333333333333,0,"orthodox"
"192414",28,34,173,166,180,177,130,129,44,47,4,5,26,26,"win_A",-6,7,3,1,0,0,0,0,0.916666666666667,0.903846153846154,0.541666666666667,0.5,0,"orthodox"
"192415",31,27,170,173,173,180,122,121,32,44,3,2,18,26,"win_A",4,-3,-7,1,0,0,0,0,0.914285714285714,0.956521739130435,0.514285714285714,0.565217391304348,0,"orthodox"
"192416",25,31,173,170,180,173,126,126,41,21,2,8,25,11,"win_A",-6,3,7,0,0,0,0,0,0.953488372093023,0.724137931034483,0.581395348837209,0.379310344827586,0,"orthodox"
"192418",30,25,163,173,165,180,122,122,42,39,2,2,31,25,"win_B",5,-10,-15,0,0,0,0,0,0.954545454545455,0.951219512195122,0.704545454545455,0.609756097560976,1,"orthodox"
"192424",24,26,173,168,180,168,123,122,33,12,2,7,22,2,"win_A",-2,5,12,1,0,0,0,0,0.942857142857143,0.631578947368421,0.628571428571429,0.105263157894737,0,"orthodox"
"192425",23,27,173,163,180,160,125,127,33,18,1,18,22,11,"win_B",-4,10,20,-2,0,0,0,0,0.970588235294118,0.5,0.647058823529412,0.305555555555556,1,"orthodox"
"192426",23,31,173,163,180,163,123,122,32,19,1,5,22,11,"win_A",-8,10,17,1,0,0,0,0,0.96969696969697,0.791666666666667,0.666666666666667,0.458333333333333,0,"orthodox"
"192427",23,25,173,170,180,175,118,118,32,17,0,4,22,13,"win_B",-2,3,5,0,0,0,0,0,1,0.80952380952381,0.6875,0.619047619047619,1,"orthodox"
"192429",22,24,173,166,180,170,118,118,30,26,0,0,22,22,"win_A",-2,7,10,0,0,0,0,0,1,1,0.733333333333333,0.846153846153846,0,"orthodox"
"192438",21,32,173,170,180,165,119,119,21,34,0,26,14,13,"win_A",-11,3,15,0,0,0,0,0,1,0.566666666666667,0.666666666666667,0.216666666666667,0,"orthodox"
"192457",18,21,173,170,180,175,115,117,2,7,0,2,1,6,"win_A",-3,3,5,-2,0,0,0,0,1,0.777777777777778,0.5,0.666666666666667,0,"orthodox"
"192479",25,21,175,193,178,198,187,211,64,29,11,6,26,21,"win_A",4,-18,-20,-24,0,0,0,1,0.853333333333333,0.828571428571429,0.346666666666667,0.6,0,"southpaw"
"192482",25,25,175,180,178,183,185,190,61,59,11,13,26,17,"win_A",0,-5,-5,-5,0,0,0,0,0.847222222222222,0.819444444444444,0.361111111111111,0.236111111111111,0,"southpaw"
"192570",26,27,180,183,191,188,175,173,29,27,3,5,21,24,"win_A",-1,-3,3,2,0,0,0,0,0.90625,0.84375,0.65625,0.75,0,"orthodox"
"192583",24,22,183,180,185,191,176,175,20,13,2,2,17,8,"win_A",2,3,-6,1,0,0,0,0,0.909090909090909,0.866666666666667,0.772727272727273,0.533333333333333,0,"orthodox"
"192651",26,35,175,171,175,178,147,146,16,40,3,8,7,31,"win_A",-9,4,-3,1,0,1,0,0,0.842105263157895,0.833333333333333,0.368421052631579,0.645833333333333,0,"orthodox"
"192652",35,34,170,171,173,178,147,147,42,40,9,7,12,31,"win_A",1,-1,-5,0,1,0,0,0,0.823529411764706,0.851063829787234,0.235294117647059,0.659574468085106,0,"orthodox"
"192653",33,34,171,174,178,174,147,147,39,37,7,0,30,27,"win_A",-1,-3,4,0,0,0,0,0,0.847826086956522,1,0.652173913043478,0.72972972972973,0,"orthodox"
"192654",32,38,171,165,178,170,140,140,38,47,6,6,29,19,"win_A",-6,6,8,0,0,1,0,0,0.863636363636364,0.886792452830189,0.659090909090909,0.358490566037736,0,"orthodox"
"192657",31,37,171,173,178,178,142,142,35,38,6,12,28,27,"win_A",-6,-2,0,0,0,1,0,0,0.853658536585366,0.76,0.682926829268293,0.54,0,"orthodox"
"192658",30,37,171,173,178,178,142,142,34,38,6,11,28,27,"win_A",-7,-2,0,0,0,1,0,0,0.85,0.775510204081633,0.7,0.551020408163265,0,"orthodox"
"192665",27,26,175,171,178,178,135,133,26,29,2,3,10,24,"win_A",1,4,0,2,0,0,0,0,0.928571428571429,0.90625,0.357142857142857,0.75,0,"orthodox"
"192666",27,26,175,171,178,178,136,135,25,29,2,2,10,24,"win_A",1,4,0,1,0,0,0,0,0.925925925925926,0.935483870967742,0.37037037037037,0.774193548387097,0,"orthodox"
"192667",23,25,168,171,180,178,135,135,22,29,2,1,18,24,"win_A",-2,-3,2,0,0,0,0,0,0.916666666666667,0.966666666666667,0.75,0.8,0,"orthodox"
"192668",27,25,170,171,175,178,130,130,44,28,3,1,23,23,"win_B",2,-1,-3,0,0,0,0,0,0.936170212765957,0.96551724137931,0.48936170212766,0.793103448275862,1,"orthodox"
"192670",32,24,166,171,171,178,130,130,57,26,4,1,40,22,"win_B",8,-5,-7,0,0,0,0,0,0.934426229508197,0.962962962962963,0.655737704918033,0.814814814814815,1,"orthodox"
"192672",23,30,171,173,178,193,130,128,24,44,1,8,20,25,"win_A",-7,-2,-15,2,0,0,0,0,0.96,0.846153846153846,0.8,0.480769230769231,0,"orthodox"
"192678",22,31,171,173,178,165,130,130,18,21,1,10,16,11,"win_A",-9,-2,13,0,0,0,0,0,0.947368421052632,0.67741935483871,0.842105263157895,0.354838709677419,0,"orthodox"
"192803",24,24,173,167,179,165,130,130,34,24,7,5,23,16,"win_A",0,6,14,0,0,0,0,0,0.829268292682927,0.827586206896552,0.560975609756098,0.551724137931034,0,"orthodox"
"192852",32,32,165,169,163,175,129,133,101,57,20,81,34,11,"win_A",0,-4,-12,-4,0,0,0,0,0.834710743801653,0.41304347826087,0.28099173553719,0.0797101449275362,0,"orthodox"
"192860",23,28,163,165,161,163,126,125,55,94,7,19,17,33,"win_A",-5,-2,-2,1,0,0,0,0,0.887096774193548,0.831858407079646,0.274193548387097,0.292035398230089,0,"orthodox"
"193037",27,29,175,172,180,173,162,162,76,66,4,17,38,14,"win_A",-2,3,7,0,0,0,0,0,0.95,0.795180722891566,0.475,0.168674698795181,0,"orthodox"
"193182",19,17,161,165,168,168,125,125,29,26,4,3,23,7,"win_A",2,-4,0,0,0,0,0,0,0.878787878787879,0.896551724137931,0.696969696969697,0.241379310344828,0,"orthodox"
"193593",27,34,178,180,185,187,130,130,27,34,2,2,21,23,"win_A",-7,-2,-2,0,0,0,0,0,0.931034482758621,0.944444444444444,0.724137931034483,0.638888888888889,0,"orthodox"
"193598",31,34,180,165,187,169,122,121,27,34,2,7,18,22,"win_A",-3,15,18,1,0,0,0,0,0.931034482758621,0.829268292682927,0.620689655172414,0.536585365853659,0,"orthodox"
"193610",31,26,170,180,173,187,120,121,18,17,5,0,11,13,"win_A",5,-10,-14,-1,0,0,0,0,0.782608695652174,1,0.478260869565217,0.764705882352941,0,"southpaw"
"193612",26,31,180,168,187,170,122,124,15,30,0,3,11,26,"win_A",-5,12,17,-2,0,0,0,0,1,0.909090909090909,0.733333333333333,0.787878787878788,0,"orthodox"
"193620",23,25,180,173,187,178,122,122,7,12,0,4,5,8,"win_A",-2,7,9,0,0,0,0,0,1,0.75,0.714285714285714,0.5,0,"orthodox"
"193641",37,26,179,182,184,185,175,173,39,20,8,1,24,16,"win_B",11,-3,-1,2,1,0,0,0,0.829787234042553,0.952380952380952,0.51063829787234,0.761904761904762,1,"orthodox"
"193644",36,25,179,182,184,185,174,175,36,17,8,0,22,14,"win_A",11,-3,-1,-1,1,0,0,0,0.818181818181818,1,0.5,0.823529411764706,0,"orthodox"
"193646",35,26,179,180,184,183,177,175,34,12,8,3,21,6,"win_A",9,-1,1,2,1,0,0,0,0.80952380952381,0.8,0.5,0.4,0,"orthodox"
"193653",33,27,179,185,184,193,175,177,28,15,7,3,18,7,"win_A",6,-6,-9,-2,0,0,0,0,0.8,0.833333333333333,0.514285714285714,0.388888888888889,0,"orthodox"
"193695",25,34,175,165,183,170,136,135,23,40,2,4,17,16,"win_A",-9,10,13,1,0,0,0,0,0.92,0.909090909090909,0.68,0.363636363636364,0,"orthodox"
"193703",30,25,165,171,170,169,135,135,31,23,3,0,14,13,"win_A",5,-6,1,0,0,0,0,0,0.911764705882353,1,0.411764705882353,0.565217391304348,0,"orthodox"
"193707",24,28,170,165,175,170,130,130,38,28,2,0,21,13,"win_A",-4,5,5,0,0,0,0,0,0.95,1,0.525,0.464285714285714,0,"orthodox"
"193710",26,23,165,168,170,175,128,128,24,1,0,6,12,0,"win_A",3,-3,-5,0,0,0,0,0,1,0.142857142857143,0.5,0,0,"orthodox"
"193716",24,23,165,163,170,163,125,125,18,15,0,4,10,6,"win_A",1,2,7,0,0,0,0,0,1,0.789473684210526,0.555555555555556,0.315789473684211,0,"orthodox"
"193718",24,30,165,170,170,183,130,129,16,25,0,7,10,13,"win_A",-6,-5,-13,1,0,0,0,0,1,0.78125,0.625,0.40625,0,"orthodox"
"193731",22,16,165,175,170,185,126,128,3,1,0,0,2,1,"win_A",6,-10,-15,-2,0,0,0,0,1,1,0.666666666666667,1,0,"orthodox"
"194089",31,30,170,170,175,178,133,131,28,23,1,0,18,21,"win_A",1,0,-3,2,0,0,0,0,0.96551724137931,1,0.620689655172414,0.91304347826087,0,"southpaw"
"194093",29,30,170,164,175,170,129,128,24,27,0,3,15,7,"win_A",-1,6,5,1,0,0,0,0,1,0.9,0.625,0.233333333333333,0,"southpaw"
"194098",28,28,170,175,175,173,130,129,19,36,0,2,12,24,"win_A",0,-5,2,1,0,0,0,0,1,0.947368421052632,0.631578947368421,0.631578947368421,0,"southpaw"
"194100",27,28,170,165,175,180,129,130,17,50,0,22,11,38,"win_A",-1,5,-5,-1,0,0,0,0,1,0.694444444444444,0.647058823529412,0.527777777777778,0,"southpaw"
"194157",34,30,170,175,183,183,147,147,55,19,4,1,30,12,"win_A",4,-5,0,0,0,0,0,0,0.932203389830508,0.95,0.508474576271186,0.6,0,"southpaw"
"194158",33,36,170,173,183,178,142,142,54,25,3,8,29,22,"win_A",-3,-3,5,0,0,1,0,0,0.947368421052632,0.757575757575758,0.508771929824561,0.666666666666667,0,"southpaw"
"194160",33,32,170,173,183,173,139,137,52,36,3,5,29,22,"win_A",1,-3,10,2,0,0,0,0,0.945454545454545,0.878048780487805,0.527272727272727,0.536585365853659,0,"southpaw"
"194161",32,29,170,175,183,180,140,139,51,24,3,3,29,15,"win_A",3,-5,3,1,0,0,0,0,0.944444444444444,0.888888888888889,0.537037037037037,0.555555555555556,0,"southpaw"
"194162",32,26,170,175,183,180,140,140,50,38,3,2,28,24,"win_A",6,-5,3,0,0,0,0,0,0.943396226415094,0.95,0.528301886792453,0.6,0,"southpaw"
"194163",32,39,170,171,183,178,141,141,49,44,3,6,28,32,"win_A",-7,-1,5,0,0,1,0,0,0.942307692307692,0.88,0.538461538461538,0.64,0,"southpaw"
"194165",31,28,170,165,183,178,147,142,47,21,3,15,28,10,"win_A",3,5,5,5,0,0,0,0,0.94,0.583333333333333,0.56,0.277777777777778,0,"southpaw"
"194168",28,30,170,171,183,176,140,140,44,30,2,2,28,13,"win_A",-2,-1,7,0,0,0,0,0,0.956521739130435,0.9375,0.608695652173913,0.40625,0,"southpaw"
"194169",28,33,170,170,183,178,140,140,43,23,2,4,28,16,"win_A",-5,0,5,0,0,0,0,0,0.955555555555556,0.851851851851852,0.622222222222222,0.592592592592593,0,"southpaw"
"194170",28,32,170,173,183,180,140,140,42,32,2,2,28,14,"win_A",-4,-3,3,0,0,0,0,0,0.954545454545455,0.941176470588235,0.636363636363636,0.411764705882353,0,"southpaw"
"194179",25,27,170,170,183,170,143,140,33,11,2,0,20,8,"win_A",-2,0,13,3,0,0,0,0,0.942857142857143,1,0.571428571428571,0.727272727272727,0,"southpaw"
"194182",24,23,175,170,178,183,134,135,21,31,0,0,17,18,"win_A",1,5,-5,-1,0,0,0,0,1,1,0.80952380952381,0.580645161290323,0,"orthodox"
"194218",39,36,175,185,191,191,174,177,46,39,11,3,31,28,"win_A",3,-10,0,-3,1,1,0,0,0.807017543859649,0.928571428571429,0.543859649122807,0.666666666666667,0,"orthodox"
"194220",38,36,175,170,191,178,173,174,44,48,11,6,29,30,"win_A",2,5,13,-1,1,1,0,0,0.8,0.888888888888889,0.527272727272727,0.555555555555556,0,"orthodox"
"194221",34,37,188,175,193,191,172,175,39,44,3,10,25,29,"win_A",-3,13,2,-3,0,1,0,0,0.928571428571429,0.814814814814815,0.595238095238095,0.537037037037037,0,"orthodox"
"194222",37,34,175,191,191,197,172,175,43,27,10,5,29,25,"win_A",3,-16,-6,-3,1,0,0,0,0.811320754716981,0.84375,0.547169811320755,0.78125,0,"orthodox"
"194223",36,38,175,183,191,198,173,172,42,23,10,2,28,13,"win_A",-2,-8,-7,1,1,1,0,0,0.807692307692308,0.92,0.538461538461538,0.52,0,"orthodox"
"194230",23,31,183,175,178,191,168,169,19,36,1,6,13,25,"win_A",-8,8,-13,-1,0,0,0,0,0.95,0.857142857142857,0.65,0.595238095238095,0,"orthodox"
"194239",32,28,187,175,188,191,166,165,31,32,5,1,26,22,"win_A",4,12,-3,1,0,0,0,0,0.861111111111111,0.96969696969697,0.722222222222222,0.666666666666667,0,"orthodox"
"194273",36,32,178,175,175,193,168,168,32,36,0,3,6,27,"win_A",4,3,-18,0,1,0,0,0,1,0.923076923076923,0.1875,0.692307692307692,0,"orthodox"
"194298",30,38,178,185,175,186,169,170,5,12,0,13,1,9,"win_A",-8,-7,-11,-1,0,1,0,0,1,0.48,0.2,0.36,0,"orthodox"
"194416",23,26,175,169,191,192,153,145,37,32,5,16,21,14,"win_A",-3,6,-1,8,0,0,0,0,0.880952380952381,0.666666666666667,0.5,0.291666666666667,0,"orthodox"
"194437",20,25,175,178,191,180,149,148,17,60,2,18,11,32,"win_A",-5,-3,11,1,0,0,0,0,0.894736842105263,0.769230769230769,0.578947368421053,0.41025641025641,0,"orthodox"
"194597",27,21,163,165,169,166,118,119,50,33,9,7,9,19,"win_B",6,-2,3,-1,0,0,0,0,0.847457627118644,0.825,0.152542372881356,0.475,1,"Unknown"
"194800",22,35,170,166,175,171,130,128,9,63,1,7,3,43,"win_A",-13,4,4,2,0,1,0,0,0.9,0.9,0.3,0.614285714285714,0,"orthodox"
"194803",33,27,166,167,171,171,130,130,61,37,5,6,43,27,"win_B",6,-1,0,0,0,0,0,0,0.924242424242424,0.86046511627907,0.651515151515151,0.627906976744186,1,"orthodox"
"194810",31,35,166,161,171,170,132,131,54,34,4,8,39,16,"win_A",-4,5,1,1,0,1,0,0,0.931034482758621,0.80952380952381,0.672413793103448,0.380952380952381,0,"orthodox"
"194812",30,24,166,163,171,157,129,129,52,26,3,0,37,13,"win_A",6,3,14,0,0,0,0,0,0.945454545454545,1,0.672727272727273,0.5,0,"orthodox"
"194814",29,27,166,163,171,160,127,127,50,19,3,18,36,12,"win_A",2,3,11,0,0,0,0,0,0.943396226415094,0.513513513513513,0.679245283018868,0.324324324324324,0,"orthodox"
"194815",29,28,166,170,171,178,122,122,50,29,2,2,36,20,"win_B",1,-4,-7,0,0,0,0,0,0.961538461538462,0.935483870967742,0.692307692307692,0.645161290322581,1,"orthodox"
"195044",21,27,173,170,183,183,163,158,32,99,8,25,6,57,"win_A",-6,3,0,5,0,0,0,0,0.8,0.798387096774194,0.15,0.459677419354839,0,"Unknown"
"195048",30,26,182,170,191,183,167,175,85,97,14,22,59,55,"win_A",4,12,8,-8,0,0,0,0,0.858585858585859,0.815126050420168,0.595959595959596,0.46218487394958,0,"orthodox"
"195161",35,33,191,183,203,201,225,210,41,57,5,7,33,55,"win_B",2,8,2,15,1,0,1,0,0.891304347826087,0.890625,0.717391304347826,0.859375,1,"orthodox"
"195167",32,31,191,180,203,178,224,229,35,28,3,8,28,20,"win_A",1,11,25,-5,0,0,0,0,0.921052631578947,0.777777777777778,0.736842105263158,0.555555555555556,0,"orthodox"
"195341",27,25,163,165,173,165,125,125,84,31,11,7,41,16,"win_A",2,-2,8,0,0,0,0,0,0.884210526315789,0.815789473684211,0.431578947368421,0.421052631578947,0,"orthodox"
"195343",27,25,163,166,173,170,126,124,82,25,11,8,39,2,"win_A",2,-3,3,2,0,0,0,0,0.881720430107527,0.757575757575758,0.419354838709677,0.0606060606060606,0,"orthodox"
"195647",21,25,173,163,178,163,132,131,77,46,4,12,8,8,"win_A",-4,10,15,1,0,0,0,0,0.950617283950617,0.793103448275862,0.0987654320987654,0.137931034482759,0,"orthodox"
"196006",25,31,163,165,162,165,127,127,63,84,6,16,25,17,"win_A",-6,-2,-3,0,0,0,0,0,0.91304347826087,0.84,0.36231884057971,0.17,0,"Unknown"
"196095",25,23,180,180,187,188,170,189,53,22,7,8,28,13,"win_A",2,0,-1,-19,0,0,0,1,0.883333333333333,0.733333333333333,0.466666666666667,0.433333333333333,0,"orthodox"
"196136",21,18,180,173,187,180,159,154,15,37,1,3,11,8,"win_A",3,7,7,5,0,0,0,0,0.9375,0.925,0.6875,0.2,0,"orthodox"
"196160",25,41,175,182,185,191,185,192,22,134,4,21,9,85,"win_A",-16,-7,-6,-7,0,1,0,0,0.846153846153846,0.864516129032258,0.346153846153846,0.548387096774194,0,"orthodox"
"196170",39,31,182,183,191,183,185,198,126,27,19,36,78,19,"win_A",8,-1,8,-13,1,0,0,0,0.868965517241379,0.428571428571429,0.537931034482759,0.301587301587302,0,"orthodox"
"196186",33,25,182,183,191,183,185,204,112,22,17,24,73,14,"win_A",8,-1,8,-19,0,0,0,1,0.868217054263566,0.478260869565217,0.565891472868217,0.304347826086957,0,"orthodox"
"196226",30,24,182,198,191,202,178,189,72,37,13,3,48,23,"win_A",6,-16,-11,-11,0,0,0,0,0.847058823529412,0.925,0.564705882352941,0.575,0,"orthodox"
"196230",29,28,182,178,191,183,176,181,68,50,13,19,46,21,"win_A",1,4,8,-5,0,0,0,0,0.839506172839506,0.72463768115942,0.567901234567901,0.304347826086957,0,"orthodox"
"196264",24,26,193,182,193,191,180,190,23,39,2,6,18,23,"win_A",-2,11,2,-10,0,0,0,0,0.92,0.866666666666667,0.72,0.511111111111111,0,"orthodox"
"196265",26,24,182,193,191,209,179,200,38,71,6,18,23,32,"win_A",2,-11,-18,-21,0,0,0,1,0.863636363636364,0.797752808988764,0.522727272727273,0.359550561797753,0,"orthodox"
"196269",36,25,187,182,202,191,181,257,89,35,18,5,75,21,"win_A",11,5,11,-76,1,0,0,1,0.831775700934579,0.875,0.700934579439252,0.525,0,"orthodox"
"196299",23,29,182,183,191,193,177,208,7,27,2,11,7,17,"win_A",-6,-1,-2,-31,0,0,0,1,0.777777777777778,0.710526315789474,0.777777777777778,0.447368421052632,0,"orthodox"
"196457",23,28,185,175,201,183,147,148,25,26,0,2,19,7,"win_A",-5,10,18,-1,0,0,0,0,1,0.928571428571429,0.76,0.25,0,"southpaw"
"196463",22,43,185,173,201,175,150,155,19,29,0,29,15,12,"win_A",-21,12,26,-5,0,1,0,0,1,0.5,0.789473684210526,0.206896551724138,0,"southpaw"
"196977",22,25,164,163,171,165,118,118,42,24,16,11,29,5,"win_A",-3,1,6,0,0,0,0,0,0.724137931034483,0.685714285714286,0.5,0.142857142857143,0,"orthodox"
"196979",22,28,164,162,171,162,117,118,40,28,16,15,28,9,"win_A",-6,2,9,-1,0,0,0,0,0.714285714285714,0.651162790697674,0.5,0.209302325581395,0,"orthodox"
"196981",24,21,163,164,165,171,117,118,23,39,9,15,5,27,"win_A",3,-1,-6,-1,0,0,0,0,0.71875,0.722222222222222,0.15625,0.5,0,"Unknown"
"197039",24,29,164,168,166,170,115,115,7,30,0,1,4,16,"win_A",-5,-4,-4,0,0,0,0,0,1,0.967741935483871,0.571428571428571,0.516129032258065,0,"orthodox"
"197048",24,29,168,163,170,160,114,115,19,30,0,8,12,11,"win_A",-5,5,10,-1,0,0,0,0,1,0.789473684210526,0.631578947368421,0.289473684210526,0,"orthodox"
"197051",24,21,168,164,170,168,115,114,16,12,0,0,9,10,"win_A",3,4,2,1,0,0,0,0,1,1,0.5625,0.833333333333333,0,"orthodox"
"197055",27,23,157,168,168,170,115,115,19,12,9,0,8,7,"win_B",4,-11,-2,0,0,0,0,0,0.678571428571429,1,0.285714285714286,0.583333333333333,1,"orthodox"
"197065",21,18,168,165,170,163,116,115,1,2,0,1,0,1,"win_A",3,3,7,1,0,0,0,0,1,0.666666666666667,0,0.333333333333333,0,"orthodox"
"197111",19,29,178,173,188,188,180,179,20,111,8,25,13,47,"win_A",-10,5,0,1,0,0,0,0,0.714285714285714,0.816176470588235,0.464285714285714,0.345588235294118,0,"Unknown"
"197115",28,23,173,179,188,203,177,192,107,56,24,12,44,40,"win_A",5,-6,-15,-15,0,0,0,1,0.816793893129771,0.823529411764706,0.33587786259542,0.588235294117647,0,"orthodox"
"197117",18,28,178,173,188,188,173,171,9,106,8,23,6,43,"win_A",-10,5,0,2,0,0,0,0,0.529411764705882,0.821705426356589,0.352941176470588,0.333333333333333,0,"Unknown"
"197120",26,28,179,173,191,188,174,172,52,101,11,23,25,42,"win_B",-2,6,3,2,0,0,0,0,0.825396825396825,0.814516129032258,0.396825396825397,0.338709677419355,1,"Unknown"
"197122",27,22,173,179,188,203,184,194,99,50,23,7,40,37,"win_A",5,-6,-15,-10,0,0,0,0,0.811475409836066,0.87719298245614,0.327868852459016,0.649122807017544,0,"orthodox"
"197148",25,24,173,198,188,206,182,235,76,19,18,20,31,12,"win_A",1,-25,-18,-53,0,0,0,1,0.808510638297872,0.487179487179487,0.329787234042553,0.307692307692308,0,"orthodox"
"197191",30,21,188,173,183,188,187,178,72,33,24,12,38,18,"win_A",9,15,-5,9,0,0,0,0,0.75,0.733333333333333,0.395833333333333,0.4,0,"orthodox"
"197194",21,25,173,192,188,211,185,207,30,43,12,12,17,34,"win_A",-4,-19,-23,-22,0,0,0,1,0.714285714285714,0.781818181818182,0.404761904761905,0.618181818181818,0,"orthodox"
"197208",28,19,180,173,201,188,174,173,107,17,7,11,59,9,"win_A",9,7,13,1,0,0,0,0,0.93859649122807,0.607142857142857,0.517543859649123,0.321428571428571,0,"orthodox"
"197238",39,20,163,168,168,175,139,133,56,13,12,1,42,9,"win_B",19,-5,-7,6,1,0,0,0,0.823529411764706,0.928571428571429,0.617647058823529,0.642857142857143,1,"orthodox"
"197240",39,22,163,178,168,178,139,140,55,12,11,0,41,5,"win_B",17,-15,-10,-1,1,0,0,0,0.833333333333333,1,0.621212121212121,0.416666666666667,1,"orthodox"
"197245",30,29,163,170,168,175,122,122,53,43,7,5,41,35,"win_A",1,-7,-7,0,0,0,0,0,0.883333333333333,0.895833333333333,0.683333333333333,0.729166666666667,0,"orthodox"
"197308",31,24,166,165,168,173,122,122,35,33,2,2,18,29,"win_A",7,1,-5,0,0,0,0,0,0.945945945945946,0.942857142857143,0.486486486486487,0.828571428571429,0,"Unknown"
"197320",27,28,166,170,168,173,122,122,23,27,2,0,17,16,"win_A",-1,-4,-5,0,0,0,0,0,0.92,1,0.68,0.592592592592593,0,"Unknown"
"197377",31,27,163,174,164,175,123,126,78,45,15,11,41,15,"win_A",4,-11,-11,-3,0,0,0,0,0.838709677419355,0.803571428571429,0.440860215053763,0.267857142857143,0,"orthodox"
"197382",30,24,163,163,164,163,125,126,75,33,12,4,41,10,"win_B",6,0,1,-1,0,0,0,0,0.862068965517241,0.891891891891892,0.471264367816092,0.27027027027027,1,"orthodox"
"197395",28,22,163,163,164,163,123,126,61,24,12,2,34,7,"win_A",6,0,1,-3,0,0,0,0,0.835616438356164,0.923076923076923,0.465753424657534,0.269230769230769,0,"orthodox"
"197396",28,21,163,150,164,155,118,118,60,36,12,14,33,20,"win_A",7,13,9,0,0,0,0,0,0.833333333333333,0.72,0.458333333333333,0.4,0,"orthodox"
"197427",24,18,163,163,164,163,118,119,28,14,10,1,16,4,"win_A",6,0,1,-1,0,0,0,0,0.736842105263158,0.933333333333333,0.421052631578947,0.266666666666667,0,"orthodox"
"197466",37,18,175,182,183,187,178,165,108,23,42,2,52,9,"win_B",19,-7,-4,13,1,0,0,0,0.72,0.92,0.346666666666667,0.36,1,"orthodox"
"197467",23,37,185,175,224,183,183,174,23,108,10,41,21,52,"win_A",-14,10,41,9,0,1,0,0,0.696969696969697,0.724832214765101,0.636363636363636,0.348993288590604,0,"orthodox"
"197486",34,25,175,178,183,183,169,177,98,32,29,3,46,26,"win_A",9,-3,0,-8,0,0,0,0,0.771653543307087,0.914285714285714,0.362204724409449,0.742857142857143,0,"orthodox"
"197491",33,23,175,180,183,188,170,185,93,24,29,11,43,13,"win_A",10,-5,-5,-15,0,0,0,1,0.762295081967213,0.685714285714286,0.352459016393443,0.371428571428571,0,"orthodox"
"197707",32,32,183,177,180,185,168,167,33,42,3,4,18,35,"win_A",0,6,-5,1,0,0,0,0,0.916666666666667,0.91304347826087,0.5,0.760869565217391,0,"orthodox"
"197720",28,36,183,175,180,183,159,159,21,55,2,5,10,32,"win_B",-8,8,-3,0,0,1,0,0,0.91304347826087,0.916666666666667,0.434782608695652,0.533333333333333,1,"orthodox"
"197721",27,25,183,178,180,183,160,159,21,30,1,2,10,20,"win_B",2,5,-3,1,0,0,0,0,0.954545454545455,0.9375,0.454545454545455,0.625,1,"orthodox"
"197722",27,30,183,183,180,192,166,168,20,39,1,1,9,28,"win_A",-3,0,-12,-2,0,0,0,0,0.952380952380952,0.975,0.428571428571429,0.7,0,"orthodox"
"197726",26,31,183,185,180,186,163,164,16,11,1,4,6,8,"win_A",-5,-2,-6,-1,0,0,0,0,0.941176470588235,0.733333333333333,0.352941176470588,0.533333333333333,0,"orthodox"
"197744",27,36,188,188,192,196,202,206,18,31,0,7,8,27,"win_A",-9,0,-4,-4,0,1,0,0,1,0.815789473684211,0.444444444444444,0.710526315789474,0,"southpaw"
"197745",35,35,188,183,196,180,200,203,30,9,7,36,26,5,"win_A",0,5,16,-3,1,1,0,0,0.810810810810811,0.2,0.702702702702703,0.111111111111111,0,"orthodox"
"197747",33,25,188,197,196,199,188,190,29,18,4,1,25,13,"win_A",8,-9,-3,-2,0,0,0,0,0.878787878787879,0.947368421052632,0.757575757575758,0.684210526315789,0,"orthodox"
"197754",30,30,188,193,196,203,190,188,23,24,3,1,19,12,"win_B",0,-5,-7,2,0,0,0,0,0.884615384615385,0.96,0.730769230769231,0.48,1,"orthodox"
"197759",27,27,193,188,203,196,187,189,16,18,1,2,8,15,"win_A",0,5,7,-2,0,0,0,0,0.941176470588235,0.9,0.470588235294118,0.75,0,"orthodox"
"197765",25,23,188,181,196,199,198,194,13,20,1,3,11,17,"win_A",2,7,-3,4,0,0,0,0,0.928571428571429,0.869565217391304,0.785714285714286,0.739130434782609,0,"orthodox"
"197781",39,36,191,183,197,191,197,191,29,26,8,3,27,24,"win_A",3,8,6,6,1,1,0,0,0.783783783783784,0.896551724137931,0.72972972972973,0.827586206896552,0,"southpaw"
"197784",29,36,183,185,191,196,199,200,22,27,1,6,21,24,"win_A",-7,-2,-5,-1,0,1,0,0,0.956521739130435,0.818181818181818,0.91304347826087,0.727272727272727,0,"orthodox"
"197790",26,36,183,188,191,203,188,190,16,34,1,5,15,24,"win_A",-10,-5,-12,-2,0,1,0,0,0.941176470588235,0.871794871794872,0.882352941176471,0.615384615384615,0,"orthodox"
"197792",26,34,183,183,191,185,189,190,14,18,1,4,14,14,"win_A",-8,0,6,-1,0,0,0,0,0.933333333333333,0.818181818181818,0.933333333333333,0.636363636363636,0,"orthodox"
"197798",25,26,183,185,191,196,193,184,8,0,1,2,8,0,"win_A",-1,-2,-5,9,0,0,0,0,0.888888888888889,0,0.888888888888889,0,0,"orthodox"
"197800",24,24,183,178,191,191,188,187,6,6,1,0,6,5,"win_A",0,5,0,1,0,0,0,0,0.857142857142857,1,0.857142857142857,0.833333333333333,0,"orthodox"
"197818",33,28,178,179,180,193,144,147,154,54,58,9,81,34,"win_B",5,-1,-13,-3,0,0,0,0,0.726415094339623,0.857142857142857,0.382075471698113,0.53968253968254,1,"orthodox"
"197875",29,25,178,173,180,173,144,138,117,50,30,22,62,34,"win_A",4,5,7,6,0,0,0,0,0.795918367346939,0.694444444444444,0.421768707482993,0.472222222222222,0,"orthodox"
"197879",28,27,178,174,180,182,151,148,114,42,29,22,60,3,"win_A",1,4,-2,3,0,0,0,0,0.797202797202797,0.65625,0.41958041958042,0.046875,0,"orthodox"
"197930",25,28,178,168,180,168,148,147,67,74,19,43,38,33,"win_A",-3,10,12,1,0,0,0,0,0.779069767441861,0.632478632478632,0.441860465116279,0.282051282051282,0,"orthodox"
"197970",22,28,178,179,180,180,142,139,35,85,8,18,19,22,"win_B",-6,-1,0,3,0,0,0,0,0.813953488372093,0.825242718446602,0.441860465116279,0.213592233009709,1,"orthodox"
"198017",35,24,168,173,178,183,158,163,117,44,27,10,74,10,"win_B",11,-5,-5,-5,1,0,0,0,0.8125,0.814814814814815,0.513888888888889,0.185185185185185,1,"orthodox"
"198018",34,30,168,168,178,168,162,165,116,90,27,69,73,43,"win_A",4,0,10,-3,0,0,0,0,0.811188811188811,0.566037735849057,0.510489510489511,0.270440251572327,0,"orthodox"
"198031",31,23,168,170,178,170,147,148,102,84,24,17,61,40,"win_A",8,-2,8,-1,0,0,0,0,0.80952380952381,0.831683168316832,0.484126984126984,0.396039603960396,0,"orthodox"
"198032",31,23,168,170,178,170,147,148,101,83,24,16,60,40,"win_A",8,-2,8,-1,0,0,0,0,0.808,0.838383838383838,0.48,0.404040404040404,0,"orthodox"
"198040",31,22,168,169,178,192,147,151,93,13,24,8,53,4,"win_A",9,-1,-14,-4,0,0,0,0,0.794871794871795,0.619047619047619,0.452991452991453,0.19047619047619,0,"orthodox"
"198048",30,21,168,169,178,192,148,148,86,9,22,3,48,2,"win_A",9,-1,-14,0,0,0,0,0,0.796296296296296,0.75,0.444444444444444,0.166666666666667,0,"orthodox"
"198054",29,21,168,170,178,170,147,147,80,50,22,6,44,23,"win_A",8,-2,8,0,0,0,0,0,0.784313725490196,0.892857142857143,0.431372549019608,0.410714285714286,0,"orthodox"
"198059",29,20,168,169,178,192,148,147,76,5,20,2,43,2,"win_A",9,-1,-14,1,0,0,0,0,0.791666666666667,0.714285714285714,0.447916666666667,0.285714285714286,0,"orthodox"
"198089",27,23,168,168,178,168,146,141,49,33,16,12,22,16,"win_A",4,0,10,5,0,0,0,0,0.753846153846154,0.733333333333333,0.338461538461538,0.355555555555556,0,"orthodox"
"198108",26,22,168,177,178,180,144,147,34,66,12,13,13,39,"win_A",4,-9,-2,-3,0,0,0,0,0.739130434782609,0.835443037974684,0.282608695652174,0.493670886075949,0,"orthodox"
"198115",19,25,178,168,183,178,142,145,56,31,1,7,23,10,"win_A",-6,10,5,-3,0,0,0,0,0.982456140350877,0.815789473684211,0.403508771929825,0.263157894736842,0,"orthodox"
"198153",37,29,187,183,188,208,174,175,40,16,4,2,21,7,"win_B",8,4,-20,-1,1,0,0,0,0.909090909090909,0.888888888888889,0.477272727272727,0.388888888888889,1,"southpaw"
"198155",35,37,187,193,188,203,213,225,38,22,2,3,20,18,"win_A",-2,-6,-15,-12,1,1,0,0,0.95,0.88,0.5,0.72,0,"southpaw"
"198156",34,34,187,198,188,208,214,270,37,31,2,3,20,19,"win_A",0,-11,-20,-56,0,0,0,1,0.948717948717949,0.911764705882353,0.512820512820513,0.558823529411765,0,"southpaw"
"198159",31,28,187,178,188,178,215,233,33,38,2,2,19,33,"win_A",3,9,10,-18,0,0,0,1,0.942857142857143,0.95,0.542857142857143,0.825,0,"southpaw"
"198161",30,36,187,185,188,193,219,224,31,21,2,18,19,3,"win_A",-6,2,-5,-5,0,1,0,0,0.939393939393939,0.538461538461538,0.575757575757576,0.0769230769230769,0,"southpaw"
"198162",29,29,187,185,188,198,220,205,29,12,1,3,17,7,"win_A",0,2,-10,15,0,0,1,0,0.966666666666667,0.8,0.566666666666667,0.466666666666667,0,"southpaw"
"198167",27,31,187,191,188,203,213,247,25,23,0,12,14,21,"win_A",-4,-4,-15,-34,0,0,0,1,1,0.657142857142857,0.56,0.6,0,"southpaw"
"198169",27,31,187,188,188,196,215,230,22,32,0,8,12,26,"win_A",-4,-1,-8,-15,0,0,0,1,1,0.8,0.545454545454545,0.65,0,"southpaw"
"198170",26,33,187,178,188,185,215,224,21,31,0,15,12,22,"win_A",-7,9,3,-9,0,0,0,0,1,0.673913043478261,0.571428571428571,0.478260869565217,0,"southpaw"
"198172",26,26,187,185,188,193,211,245,19,22,0,5,11,9,"win_A",0,2,-5,-34,0,0,0,1,1,0.814814814814815,0.578947368421053,0.333333333333333,0,"southpaw"
"198175",25,39,187,190,188,193,217,244,16,9,0,2,11,9,"win_A",-14,-3,-5,-27,0,1,0,1,1,0.818181818181818,0.6875,0.818181818181818,0,"southpaw"
"198176",25,28,187,180,188,183,218,259,15,23,0,11,10,18,"win_A",-3,7,5,-41,0,0,0,1,1,0.676470588235294,0.666666666666667,0.529411764705882,0,"southpaw"
"198178",25,31,187,185,188,201,210,216,13,34,0,2,10,31,"win_A",-6,2,-13,-6,0,0,0,0,1,0.944444444444444,0.769230769230769,0.861111111111111,0,"southpaw"
"198189",23,30,187,183,188,180,193,195,2,6,0,10,1,3,"win_A",-7,4,8,-2,0,0,0,0,1,0.375,0.5,0.1875,0,"southpaw"
"198206",35,24,173,173,180,175,159,155,58,21,16,3,48,15,"win_A",11,0,5,4,1,0,0,0,0.783783783783784,0.875,0.648648648648649,0.625,0,"orthodox"
"198214",32,23,173,183,180,185,161,161,51,13,14,1,43,10,"win_A",9,-10,-5,0,0,0,0,0,0.784615384615385,0.928571428571429,0.661538461538462,0.714285714285714,0,"orthodox"
"198217",31,22,173,178,180,187,160,159,48,44,12,2,41,38,"win_A",9,-5,-7,1,0,0,0,0,0.8,0.956521739130435,0.683333333333333,0.826086956521739,0,"orthodox"
"198278",42,37,185,178,198,191,225,212,37,23,16,16,26,18,"win_A",5,7,7,13,1,1,0,0,0.69811320754717,0.58974358974359,0.490566037735849,0.461538461538462,0,"orthodox"
"198279",41,27,185,181,198,199,214,214,36,29,16,9,26,25,"win_A",14,4,-1,0,1,0,0,0,0.692307692307692,0.763157894736842,0.5,0.657894736842105,0,"orthodox"
"198282",37,38,193,185,208,198,211,247,23,34,8,14,18,24,"win_A",-1,8,10,-36,1,1,0,1,0.741935483870968,0.708333333333333,0.580645161290323,0.5,0,"orthodox"
"198288",36,26,185,183,198,188,215,213,29,15,13,0,20,11,"win_A",10,2,10,2,1,0,0,0,0.69047619047619,1,0.476190476190476,0.733333333333333,0,"orthodox"
"198291",33,34,193,185,208,198,215,240,15,28,5,11,12,19,"win_A",-1,8,10,-25,0,0,0,1,0.75,0.717948717948718,0.6,0.487179487179487,0,"orthodox"
"198292",26,34,193,185,216,198,213,218,17,27,1,11,13,18,"win_B",-8,8,18,-5,0,0,0,0,0.944444444444444,0.710526315789474,0.722222222222222,0.473684210526316,1,"orthodox"
"198298",24,30,185,185,203,198,215,209,20,23,0,9,16,16,"win_B",-6,0,5,6,0,0,0,0,1,0.71875,0.8,0.5,1,"orthodox"
"198301",30,28,187,185,203,198,212,220,25,20,7,9,17,14,"win_B",2,2,5,-8,0,0,0,0,0.78125,0.689655172413793,0.53125,0.482758620689655,1,"orthodox"
"198308",27,28,185,196,198,203,204,270,14,20,7,0,8,11,"win_B",-1,-11,-5,-66,0,0,0,1,0.666666666666667,1,0.380952380952381,0.55,1,"orthodox"
"198322",22,24,185,194,198,203,218,220,4,5,3,0,3,5,"win_B",-2,-9,-5,-2,0,0,0,0,0.571428571428571,1,0.428571428571429,1,1,"orthodox"
"198446",28,25,197,202,216,213,268,258,81,7,7,3,64,7,"win_A",3,-5,3,10,0,0,0,0,0.920454545454545,0.7,0.727272727272727,0.7,0,"orthodox"
"198451",26,24,197,188,216,191,250,207,74,58,6,14,60,23,"win_A",2,9,25,43,0,0,1,0,0.925,0.805555555555556,0.75,0.319444444444444,0,"orthodox"
"198456",26,27,197,183,216,201,262,205,69,48,6,37,55,16,"win_A",-1,14,15,57,0,0,1,0,0.92,0.564705882352941,0.733333333333333,0.188235294117647,0,"orthodox"
"198457",26,22,197,180,216,188,261,197,68,42,6,20,55,23,"win_A",4,17,28,64,0,0,1,0,0.918918918918919,0.67741935483871,0.743243243243243,0.370967741935484,0,"orthodox"
"198459",26,29,197,202,216,211,270,247,66,60,6,14,53,40,"win_A",-3,-5,5,23,0,0,1,0,0.916666666666667,0.810810810810811,0.736111111111111,0.540540540540541,0,"orthodox"
"198470",30,25,189,197,201,216,268,200,76,57,11,4,39,46,"win_A",5,-8,-15,68,0,0,1,0,0.873563218390805,0.934426229508197,0.448275862068966,0.754098360655738,0,"orthodox"
"198474",25,34,197,175,216,185,264,187,53,38,4,42,43,9,"win_A",-9,22,31,77,0,0,1,0,0.929824561403509,0.475,0.754385964912281,0.1125,0,"orthodox"
"198482",24,27,197,194,216,213,274,205,45,17,3,10,37,9,"win_A",-3,3,3,69,0,0,1,0,0.9375,0.62962962962963,0.770833333333333,0.333333333333333,0,"orthodox"
"198495",23,33,197,187,216,202,262,250,33,68,2,15,28,55,"win_A",-10,10,14,12,0,0,0,0,0.942857142857143,0.819277108433735,0.8,0.662650602409639,0,"orthodox"
"198512",23,24,197,183,216,201,269,209,16,46,2,24,11,14,"win_A",-1,14,15,60,0,0,1,0,0.888888888888889,0.657142857142857,0.611111111111111,0.2,0,"orthodox"
"198531",24,29,165,161,169,165,108,108,11,43,0,8,7,13,"win_A",-5,4,4,0,0,0,0,0,1,0.843137254901961,0.636363636363636,0.254901960784314,0,"orthodox"
"198550",25,29,175,169,175,173,141,147,40,26,16,10,21,15,"win_A",-4,6,2,-6,0,0,0,0,0.714285714285714,0.722222222222222,0.375,0.416666666666667,0,"orthodox"
"198560",25,28,168,169,165,173,139,138,20,18,4,8,11,9,"win_A",-3,-1,-8,1,0,0,0,0,0.833333333333333,0.692307692307692,0.458333333333333,0.346153846153846,0,"orthodox"
"198698",27,29,164,170,166,170,137,136,74,79,19,33,34,20,"win_B",-2,-6,-4,1,0,0,0,0,0.795698924731183,0.705357142857143,0.365591397849462,0.178571428571429,1,"Unknown"
"198714",24,20,164,164,166,174,130,133,66,15,8,1,30,11,"win_A",4,0,-8,-3,0,0,0,0,0.891891891891892,0.9375,0.405405405405405,0.6875,0,"Unknown"
"198747",20,21,164,160,166,168,122,122,36,13,2,5,18,5,"win_A",-1,4,-2,0,0,0,0,0,0.947368421052632,0.722222222222222,0.473684210526316,0.277777777777778,0,"Unknown"
"198845",28,30,175,174,185,173,152,150,18,44,10,2,15,34,"win_A",-2,1,12,2,0,0,0,0,0.642857142857143,0.956521739130435,0.535714285714286,0.739130434782609,0,"orthodox"
"198847",27,26,174,168,173,175,144,141,42,21,1,11,32,18,"win_A",1,6,-2,3,0,0,0,0,0.976744186046512,0.65625,0.744186046511628,0.5625,0,"orthodox"
"198848",26,31,174,168,173,165,145,144,41,21,1,16,31,11,"win_A",-5,6,8,1,0,0,0,0,0.976190476190476,0.567567567567568,0.738095238095238,0.297297297297297,0,"orthodox"
"198852",22,24,170,174,180,173,135,135,18,37,0,0,13,29,"win_B",-2,-4,7,0,0,0,0,0,1,1,0.722222222222222,0.783783783783784,1,"orthodox"
"198860",26,22,173,174,173,173,135,134,25,28,1,0,12,24,"win_B",4,-1,0,1,0,0,0,0,0.961538461538462,1,0.461538461538462,0.857142857142857,1,"orthodox"
"198875",19,26,174,173,173,173,132,129,13,12,0,3,11,7,"win_A",-7,1,0,3,0,0,0,0,1,0.8,0.846153846153846,0.466666666666667,0,"orthodox"
"198883",18,25,174,168,173,178,128,130,4,7,0,8,4,3,"win_A",-7,6,-5,-2,0,0,0,0,1,0.466666666666667,1,0.2,0,"orthodox"
"198889",33,26,188,189,199,203,210,180,32,4,9,5,18,4,"win_A",7,-1,-4,30,0,0,1,0,0.780487804878049,0.444444444444444,0.439024390243902,0.444444444444444,0,"orthodox"
"198999",33,26,166,170,168,173,125,123,34,24,2,10,12,18,"win_A",7,-4,-5,2,0,0,0,0,0.944444444444444,0.705882352941177,0.333333333333333,0.529411764705882,0,"southpaw"
"199001",31,27,166,166,168,170,122,122,32,41,1,3,12,19,"win_A",4,0,-2,0,0,0,0,0,0.96969696969697,0.931818181818182,0.363636363636364,0.431818181818182,0,"southpaw"
"199008",27,26,166,168,168,168,120,119,22,20,0,15,9,13,"win_A",1,-2,0,1,0,0,0,0,1,0.571428571428571,0.409090909090909,0.371428571428571,0,"southpaw"
"199009",27,24,166,170,168,168,118,117,21,14,0,6,8,5,"win_A",3,-4,0,1,0,0,0,0,1,0.7,0.380952380952381,0.25,0,"southpaw"
"199011",26,26,166,159,168,160,118,118,19,36,0,6,8,25,"win_A",0,7,8,0,0,0,0,0,1,0.857142857142857,0.421052631578947,0.595238095238095,0,"southpaw"
"199012",26,27,166,170,168,160,118,118,18,12,0,3,8,6,"win_A",-1,-4,8,0,0,0,0,0,1,0.8,0.444444444444444,0.4,0,"southpaw"
"199039",27,37,170,170,175,180,132,130,17,55,1,6,6,37,"win_B",-10,0,-5,2,0,1,0,0,0.944444444444444,0.901639344262295,0.333333333333333,0.60655737704918,1,"orthodox"
"199042",35,22,170,172,180,175,130,131,52,22,5,4,35,12,"win_A",13,-2,5,-1,1,0,0,0,0.912280701754386,0.846153846153846,0.614035087719298,0.461538461538462,0,"southpaw"
"199047",25,31,175,170,183,180,126,126,23,48,4,2,16,32,"win_A",-6,5,3,0,0,0,0,0,0.851851851851852,0.96,0.592592592592593,0.64,0,"southpaw"
"199049",30,34,170,163,180,163,126,126,46,22,1,7,31,13,"win_A",-4,7,17,0,0,0,0,0,0.978723404255319,0.758620689655172,0.659574468085106,0.448275862068966,0,"southpaw"
"199050",29,33,170,168,180,165,126,126,45,54,1,8,31,31,"win_A",-4,2,15,0,0,0,0,0,0.978260869565217,0.870967741935484,0.673913043478261,0.5,0,"southpaw"
"199055",21,27,173,170,173,180,126,126,34,41,2,0,24,29,"win_A",-6,3,-7,0,0,0,0,0,0.944444444444444,1,0.666666666666667,0.707317073170732,0,"orthodox"
"199060",26,23,170,167,180,171,125,126,36,29,0,3,26,20,"win_A",3,3,9,-1,0,0,0,0,1,0.90625,0.722222222222222,0.625,0,"southpaw"
"199067",25,21,170,165,180,180,127,128,29,31,0,6,21,24,"win_A",4,5,0,-1,0,0,0,0,1,0.837837837837838,0.724137931034483,0.648648648648649,0,"southpaw"
"199078",23,30,170,161,180,170,127,128,18,14,0,4,13,5,"win_A",-7,9,10,-1,0,0,0,0,1,0.777777777777778,0.722222222222222,0.277777777777778,0,"southpaw"
"199127",22,22,184,185,188,191,164,178,23,5,5,1,15,4,"win_B",0,-1,-3,-14,0,0,0,0,0.821428571428571,0.833333333333333,0.535714285714286,0.666666666666667,1,"Unknown"
"199201",34,25,189,182,196,180,168,168,32,19,1,0,19,15,"win_B",9,7,16,0,0,0,0,0,0.96969696969697,1,0.575757575757576,0.789473684210526,1,"southpaw"
"199202",33,29,189,170,196,175,168,168,31,41,1,3,19,18,"win_A",4,19,21,0,0,0,0,0,0.96875,0.931818181818182,0.59375,0.409090909090909,0,"southpaw"
"199343",28,35,170,170,177,168,120,122,55,27,3,5,35,18,"win_A",-7,0,9,-2,0,1,0,0,0.948275862068966,0.84375,0.603448275862069,0.5625,0,"orthodox"
"199349",31,32,170,168,168,183,125,127,23,17,3,4,14,6,"win_A",-1,2,-15,-2,0,0,0,0,0.884615384615385,0.80952380952381,0.538461538461538,0.285714285714286,0,"orthodox"
"199357",24,28,170,160,168,160,118,118,14,36,0,14,12,19,"win_A",-4,10,8,0,0,0,0,0,1,0.72,0.857142857142857,0.38,0,"orthodox"
"199359",23,31,170,164,168,165,117,117,12,37,0,12,11,19,"win_A",-8,6,3,0,0,0,0,0,1,0.755102040816326,0.916666666666667,0.387755102040816,0,"orthodox"
"199597",37,31,161,164,168,166,115,115,61,19,3,5,26,13,"win_A",6,-3,2,0,1,0,0,0,0.953125,0.791666666666667,0.40625,0.541666666666667,0,"orthodox"
"199599",23,30,160,164,171,166,115,115,20,18,2,4,13,12,"win_A",-7,-4,5,0,0,0,0,0,0.909090909090909,0.818181818181818,0.590909090909091,0.545454545454545,0,"orthodox"
"199603",27,25,164,170,166,171,115,115,12,18,1,1,7,6,"win_A",2,-6,-5,0,0,0,0,0,0.923076923076923,0.947368421052632,0.538461538461538,0.315789473684211,0,"orthodox"
"199638",28,24,179,173,184,193,162,169,76,125,17,36,46,70,"win_A",4,6,-9,-7,0,0,0,0,0.817204301075269,0.77639751552795,0.494623655913978,0.434782608695652,0,"orthodox"
"199643",28,23,179,183,184,188,163,186,70,25,17,8,42,2,"win_A",5,-4,-4,-23,0,0,0,1,0.804597701149425,0.757575757575758,0.482758620689655,0.0606060606060606,0,"orthodox"
"199644",28,23,179,183,184,188,163,185,69,24,17,7,41,1,"win_A",5,-4,-4,-22,0,0,0,1,0.802325581395349,0.774193548387097,0.476744186046512,0.032258064516129,0,"orthodox"
"199646",27,26,179,179,184,184,166,175,68,56,16,6,40,22,"win_B",1,0,0,-9,0,0,0,0,0.80952380952381,0.903225806451613,0.476190476190476,0.354838709677419,1,"orthodox"
"199679",23,24,179,179,184,184,158,172,43,40,5,11,16,24,"win_A",-1,0,0,-14,0,0,0,0,0.895833333333333,0.784313725490196,0.333333333333333,0.470588235294118,0,"orthodox"
"199685",23,24,179,179,188,184,156,155,37,35,7,10,21,19,"win_A",-1,0,4,1,0,0,0,0,0.840909090909091,0.777777777777778,0.477272727272727,0.422222222222222,0,"Unknown"
"199691",22,24,179,179,188,184,157,157,35,31,6,8,21,17,"win_A",-2,0,4,0,0,0,0,0,0.853658536585366,0.794871794871795,0.51219512195122,0.435897435897436,0,"Unknown"
"199701",24,23,165,179,170,184,153,146,56,25,14,4,32,12,"win_A",1,-14,-14,7,0,0,0,0,0.8,0.862068965517241,0.457142857142857,0.413793103448276,0,"orthodox"
"199704",21,23,179,179,184,184,155,172,32,23,4,3,13,12,"win_A",-2,0,0,-17,0,0,0,1,0.888888888888889,0.884615384615385,0.361111111111111,0.461538461538462,0,"orthodox"
"199712",22,25,179,175,184,178,165,160,17,48,1,23,10,26,"win_A",-3,4,6,5,0,0,0,0,0.944444444444444,0.676056338028169,0.555555555555556,0.366197183098592,0,"orthodox"
"199720",22,26,179,171,184,175,157,145,10,63,0,18,8,22,"win_A",-4,8,9,12,0,0,0,0,1,0.777777777777778,0.8,0.271604938271605,0,"orthodox"
"199820",24,32,169,170,174,177,126,126,16,63,1,6,8,39,"win_A",-8,-1,-3,0,0,0,0,0,0.941176470588235,0.91304347826087,0.470588235294118,0.565217391304348,0,"southpaw"
"199821",31,24,170,169,177,174,126,126,62,16,6,0,39,8,"win_A",7,1,3,0,0,0,0,0,0.911764705882353,1,0.573529411764706,0.5,0,"orthodox"
"199829",27,35,170,170,177,160,125,125,52,19,3,13,35,8,"win_A",-8,0,17,0,0,1,0,0,0.945454545454545,0.59375,0.636363636363636,0.25,0,"orthodox"
"199830",27,31,170,168,177,173,127,127,51,23,3,4,35,13,"win_A",-4,2,4,0,0,0,0,0,0.944444444444444,0.851851851851852,0.648148148148148,0.481481481481481,0,"orthodox"
"199832",27,25,170,171,177,177,122,122,49,23,3,1,34,18,"win_A",2,-1,0,0,0,0,0,0,0.942307692307692,0.958333333333333,0.653846153846154,0.75,0,"orthodox"
"199836",26,32,170,166,177,173,122,122,45,28,3,0,32,12,"win_A",-6,4,4,0,0,0,0,0,0.9375,1,0.666666666666667,0.428571428571429,0,"orthodox"
"199839",25,32,170,170,177,160,122,122,41,18,3,8,30,8,"win_A",-7,0,17,0,0,0,0,0,0.931818181818182,0.692307692307692,0.681818181818182,0.307692307692308,0,"orthodox"
"199842",31,24,166,170,173,177,122,122,27,39,0,2,12,30,"win_A",7,-4,-4,0,0,0,0,0,1,0.951219512195122,0.444444444444444,0.731707317073171,0,"orthodox"
"199853",28,21,162,170,163,177,122,122,22,29,9,1,11,22,"win_A",7,-8,-14,0,0,0,0,0,0.709677419354839,0.966666666666667,0.354838709677419,0.733333333333333,0,"southpaw"
"200395",38,28,191,180,198,203,280,221,53,5,4,6,34,3,"win_B",10,11,-5,59,1,0,1,0,0.929824561403509,0.454545454545455,0.596491228070175,0.272727272727273,1,"orthodox"
"200400",34,29,191,195,198,203,258,237,48,31,3,8,32,22,"win_A",5,-4,-5,21,0,0,1,0,0.941176470588235,0.794871794871795,0.627450980392157,0.564102564102564,0,"orthodox"
"200401",35,33,188,191,196,198,258,234,18,47,7,3,13,32,"win_B",2,-3,-2,24,1,0,1,0,0.72,0.94,0.52,0.64,1,"orthodox"
"200408",31,26,191,191,198,208,240,230,41,22,2,1,27,15,"win_B",5,0,-10,10,0,0,0,0,0.953488372093023,0.956521739130435,0.627906976744186,0.652173913043478,1,"orthodox"
"200413",30,29,191,182,198,178,220,228,36,22,1,8,23,11,"win_A",1,9,20,-8,0,0,0,0,0.972972972972973,0.733333333333333,0.621621621621622,0.366666666666667,0,"orthodox"
"200417",29,27,191,183,198,188,225,210,32,18,1,1,19,14,"win_A",2,8,10,15,0,0,1,0,0.96969696969697,0.947368421052632,0.575757575757576,0.736842105263158,0,"orthodox"
"200424",28,25,192,191,206,198,217,215,28,26,3,0,17,15,"win_A",3,1,8,2,0,0,0,0,0.903225806451613,1,0.548387096774194,0.576923076923077,0,"orthodox"
"200467",23,23,171,168,170,173,135,135,27,54,7,8,7,22,"win_B",0,3,-3,0,0,0,0,0,0.794117647058823,0.870967741935484,0.205882352941176,0.354838709677419,1,"orthodox"
"200599",33,28,183,183,185,185,176,182,46,16,6,3,37,11,"win_A",5,0,0,-6,0,0,0,0,0.884615384615385,0.842105263157895,0.711538461538462,0.578947368421053,0,"orthodox"
"200609",28,32,183,183,185,211,175,175,37,34,4,0,31,22,"win_A",-4,0,-26,0,0,0,0,0,0.902439024390244,1,0.75609756097561,0.647058823529412,0,"orthodox"
"200610",28,26,183,185,185,197,175,175,36,19,4,1,30,12,"win_A",2,-2,-12,0,0,0,0,0,0.9,0.95,0.75,0.6,0,"orthodox"
"200647",31,35,178,173,191,178,130,130,31,66,2,14,16,32,"win_A",-4,5,13,0,0,1,0,0,0.939393939393939,0.825,0.484848484848485,0.4,0,"orthodox"
"200650",33,27,173,173,178,185,129,130,63,15,14,5,30,8,"win_A",6,0,-7,-1,0,0,0,0,0.818181818181818,0.75,0.38961038961039,0.4,0,"orthodox"
"200655",30,31,173,169,178,170,126,126,59,40,11,5,27,15,"win_A",-1,4,8,0,0,0,0,0,0.842857142857143,0.888888888888889,0.385714285714286,0.333333333333333,0,"orthodox"
"200659",28,27,173,165,178,170,125,126,56,21,10,1,26,15,"win_B",1,8,8,-1,0,0,0,0,0.848484848484849,0.954545454545455,0.393939393939394,0.681818181818182,1,"orthodox"
"200660",28,28,173,175,178,188,126,126,55,23,10,1,26,20,"win_A",0,-2,-10,0,0,0,0,0,0.846153846153846,0.958333333333333,0.4,0.833333333333333,0,"orthodox"
"200663",24,26,175,173,183,178,130,130,20,53,4,9,13,25,"win_A",-2,2,5,0,0,0,0,0,0.833333333333333,0.854838709677419,0.541666666666667,0.403225806451613,0,"southpaw"
"200666",24,22,173,173,178,173,126,126,50,37,6,2,24,26,"win_A",2,0,5,0,0,0,0,0,0.892857142857143,0.948717948717949,0.428571428571429,0.666666666666667,0,"orthodox"
"200676",20,25,173,160,178,160,126,126,42,32,3,10,21,18,"win_A",-5,13,18,0,0,0,0,0,0.933333333333333,0.761904761904762,0.466666666666667,0.428571428571429,0,"orthodox"
"200699",17,19,173,175,178,173,130,134,20,16,2,5,8,11,"win_A",-2,-2,5,-4,0,0,0,0,0.909090909090909,0.761904761904762,0.363636363636364,0.523809523809524,0,"orthodox"
"200745",25,30,185,192,189,208,188,206,233,65,13,11,117,29,"win_A",-5,-7,-19,-18,0,0,0,1,0.947154471544715,0.855263157894737,0.475609756097561,0.381578947368421,0,"orthodox"
"200754",24,31,185,175,189,185,182,186,223,28,12,32,111,7,"win_A",-7,10,4,-4,0,0,0,0,0.948936170212766,0.466666666666667,0.472340425531915,0.116666666666667,0,"orthodox"
"200757",24,22,185,183,189,193,180,176,220,61,12,14,111,19,"win_A",2,2,-4,4,0,0,0,0,0.948275862068966,0.813333333333333,0.478448275862069,0.253333333333333,0,"orthodox"
"200760",24,31,185,175,189,185,182,188,218,28,11,30,110,7,"win_A",-7,10,4,-6,0,0,0,0,0.951965065502183,0.482758620689655,0.480349344978166,0.120689655172414,0,"orthodox"
"200777",23,31,185,191,189,202,181,173,201,59,10,27,96,22,"win_A",-8,-6,-13,8,0,0,0,0,0.95260663507109,0.686046511627907,0.454976303317536,0.255813953488372,0,"orthodox"
"200828",21,21,185,183,189,201,177,192,149,18,9,4,60,6,"win_A",0,2,-12,-15,0,0,0,1,0.943037974683544,0.818181818181818,0.379746835443038,0.272727272727273,0,"orthodox"
"200846",20,27,185,175,189,185,175,185,131,17,8,20,52,3,"win_A",-7,10,4,-10,0,0,0,0,0.942446043165468,0.459459459459459,0.37410071942446,0.0810810810810811,0,"orthodox"
"201098",27,33,174,175,180,183,147,147,28,35,3,5,19,18,"win_A",-6,-1,-3,0,0,0,0,0,0.903225806451613,0.875,0.612903225806452,0.45,0,"orthodox"
"201101",24,31,174,174,180,178,139,139,24,22,1,0,17,12,"win_A",-7,0,2,0,0,0,0,0,0.96,1,0.68,0.545454545454545,0,"orthodox"
"201102",24,27,174,170,180,175,140,139,23,29,1,1,17,27,"win_A",-3,4,5,1,0,0,0,0,0.958333333333333,0.966666666666667,0.708333333333333,0.9,0,"orthodox"
"201341",34,25,191,183,198,183,218,211,47,22,18,5,35,19,"win_A",9,8,15,7,0,0,0,0,0.723076923076923,0.814814814814815,0.538461538461538,0.703703703703704,0,"orthodox"
"201358",25,31,185,191,196,198,209,195,25,34,2,13,18,26,"win_A",-6,-6,-2,14,0,0,0,0,0.925925925925926,0.723404255319149,0.666666666666667,0.553191489361702,0,"orthodox"
"201361",23,31,183,191,191,198,212,193,12,33,0,11,10,25,"win_A",-8,-8,-7,19,0,0,1,0,1,0.75,0.833333333333333,0.568181818181818,0,"orthodox"
"201363",30,26,191,180,198,180,207,218,32,66,10,12,24,38,"win_A",4,11,18,-11,0,0,0,0,0.761904761904762,0.846153846153846,0.571428571428571,0.487179487179487,0,"orthodox"
"201547",39,35,185,188,185,187,192,195,32,29,5,2,28,22,"win_A",4,-3,-2,-3,1,1,0,0,0.864864864864865,0.935483870967742,0.756756756756757,0.709677419354839,0,"orthodox"
"201559",33,32,176,185,180,185,166,167,31,19,2,1,12,18,"win_A",1,-9,-5,-1,0,0,0,0,0.939393939393939,0.95,0.363636363636364,0.9,0,"southpaw"
"201597",26,30,194,188,215,183,185,220,34,75,5,26,27,38,"win_A",-4,6,32,-35,0,0,0,1,0.871794871794872,0.742574257425743,0.692307692307692,0.376237623762376,0,"southpaw"
"201598",30,30,188,187,183,197,180,198,74,31,25,14,38,23,"win_A",0,1,-14,-18,0,0,0,1,0.747474747474748,0.688888888888889,0.383838383838384,0.511111111111111,0,"orthodox"
"201601",24,29,192,188,211,183,183,207,38,71,8,21,31,38,"win_A",-5,4,28,-24,0,0,0,1,0.826086956521739,0.771739130434783,0.673913043478261,0.41304347826087,0,"Unknown"
"201618",28,23,188,192,183,211,182,205,58,32,14,3,37,28,"win_A",5,-4,-28,-23,0,0,0,1,0.805555555555556,0.914285714285714,0.513888888888889,0.8,0,"orthodox"
"201626",26,29,188,187,183,196,180,205,46,21,9,6,34,14,"win_A",-3,1,-13,-25,0,0,0,1,0.836363636363636,0.777777777777778,0.618181818181818,0.518518518518518,0,"orthodox"
"201631",31,26,199,188,211,183,180,230,14,39,2,9,11,30,"win_B",5,11,28,-50,0,0,0,1,0.875,0.8125,0.6875,0.625,1,"orthodox"
"201633",26,29,188,197,183,208,183,212,37,4,9,4,29,3,"win_A",-3,-9,-25,-29,0,0,0,1,0.804347826086957,0.5,0.630434782608696,0.375,0,"orthodox"
"201636",25,25,188,187,183,197,186,206,34,22,9,7,27,15,"win_A",0,1,-14,-20,0,0,0,1,0.790697674418605,0.758620689655172,0.627906976744186,0.517241379310345,0,"orthodox"
"201714",23,27,174,173,183,173,151,154,35,98,9,18,8,17,"win_B",-4,1,10,-3,0,0,0,0,0.795454545454545,0.844827586206897,0.181818181818182,0.146551724137931,1,"orthodox"
"201746",22,22,173,175,173,185,141,145,68,44,8,10,13,19,"win_A",0,-2,-12,-4,0,0,0,0,0.894736842105263,0.814814814814815,0.171052631578947,0.351851851851852,0,"Unknown"
"201748",21,28,173,175,173,175,142,145,66,54,8,28,13,26,"win_A",-7,-2,-2,-3,0,0,0,0,0.891891891891892,0.658536585365854,0.175675675675676,0.317073170731707,0,"Unknown"
"201829",34,42,192,188,204,208,228,235,42,51,1,8,35,36,"win_A",-8,4,-4,-7,0,1,0,0,0.976744186046512,0.864406779661017,0.813953488372093,0.610169491525424,0,"southpaw"
"201838",28,37,192,193,204,203,208,231,32,31,0,8,27,16,"win_A",-9,-1,1,-23,0,1,0,1,1,0.794871794871795,0.84375,0.41025641025641,0,"southpaw"
"201839",27,33,192,173,204,175,187,183,31,115,0,6,26,80,"win_A",-6,19,29,4,0,0,0,0,1,0.950413223140496,0.838709677419355,0.661157024793388,0,"southpaw"
"201857",23,33,192,177,204,188,190,190,13,26,0,6,11,13,"win_A",-10,15,16,0,0,0,0,0,1,0.8125,0.846153846153846,0.40625,0,"southpaw"
"202242",30,19,169,175,173,182,135,135,36,22,12,2,13,14,"win_A",11,-6,-9,0,0,0,0,0,0.75,0.916666666666667,0.270833333333333,0.583333333333333,0,"orthodox"
"202367",22,33,175,163,180,163,146,145,18,67,0,32,14,20,"win_A",-11,12,17,1,0,0,0,0,1,0.676767676767677,0.777777777777778,0.202020202020202,0,"orthodox"
"202412",26,20,163,168,163,171,132,127,45,26,5,11,16,11,"win_A",6,-5,-8,5,0,0,0,0,0.9,0.702702702702703,0.32,0.297297297297297,0,"orthodox"
"202417",25,25,165,163,174,163,130,125,26,41,5,4,7,14,"win_B",0,2,11,5,0,0,0,0,0.838709677419355,0.911111111111111,0.225806451612903,0.311111111111111,1,"orthodox"
"202465",31,31,170,170,178,173,122,121,33,30,4,3,21,17,"win_B",0,0,5,1,0,0,0,0,0.891891891891892,0.909090909090909,0.567567567567568,0.515151515151515,1,"orthodox"
"202466",30,24,170,165,173,163,124,122,29,16,2,1,17,14,"win_A",6,5,10,2,0,0,0,0,0.935483870967742,0.941176470588235,0.548387096774194,0.823529411764706,0,"orthodox"
"202468",29,29,170,169,173,178,122,122,27,21,1,0,16,14,"win_A",0,1,-5,0,0,0,0,0,0.964285714285714,1,0.571428571428571,0.666666666666667,0,"orthodox"
"202469",28,28,166,170,168,173,122,122,34,26,1,0,17,16,"win_B",0,-4,-5,0,0,0,0,0,0.971428571428571,1,0.485714285714286,0.615384615384615,1,"orthodox"
"202471",27,30,170,168,173,165,122,122,24,45,0,5,15,25,"win_A",-3,2,8,0,0,0,0,0,1,0.9,0.625,0.5,0,"orthodox"
"202472",27,24,170,170,173,173,121,122,23,21,0,1,14,17,"win_A",3,0,0,-1,0,0,0,0,1,0.954545454545455,0.608695652173913,0.772727272727273,0,"orthodox"
"202478",25,24,170,165,173,163,124,124,17,13,0,12,12,5,"win_A",1,5,10,0,0,0,0,0,1,0.52,0.705882352941177,0.2,0,"orthodox"
"202480",25,33,170,169,173,168,121,122,15,34,0,5,10,18,"win_A",-8,1,5,-1,0,0,0,0,1,0.871794871794872,0.666666666666667,0.461538461538462,0,"orthodox"
"202484",24,21,170,168,173,175,125,125,11,0,0,1,6,0,"win_A",3,2,-2,0,0,0,0,0,1,0,0.545454545454545,0,0,"orthodox"
"202485",24,20,170,168,173,168,127,127,10,11,0,3,6,8,"win_A",4,2,5,0,0,0,0,0,1,0.785714285714286,0.6,0.571428571428571,0,"orthodox"
"202491",23,19,170,168,173,168,126,126,4,6,0,2,2,4,"win_A",4,2,5,0,0,0,0,0,1,0.75,0.5,0.5,0,"orthodox"
"202566",30,33,178,173,188,175,154,151,43,35,6,14,26,22,"win_A",-3,5,13,3,0,0,0,0,0.877551020408163,0.714285714285714,0.530612244897959,0.448979591836735,0,"orthodox"
"202567",24,30,173,178,178,188,161,153,39,43,3,5,30,26,"win_A",-6,-5,-10,8,0,0,0,0,0.928571428571429,0.895833333333333,0.714285714285714,0.541666666666667,0,"orthodox"
"202568",26,29,183,178,191,188,158,155,22,42,6,5,7,26,"win_B",-3,5,3,3,0,0,0,0,0.785714285714286,0.893617021276596,0.25,0.553191489361702,1,"orthodox"
"202569",31,29,173,178,180,188,158,156,26,42,7,4,16,26,"win_A",2,-5,-8,2,0,0,0,0,0.787878787878788,0.91304347826087,0.484848484848485,0.565217391304348,0,"orthodox"
"202574",23,26,183,178,191,188,157,156,15,38,3,2,4,23,"win_A",-3,5,3,1,0,0,0,0,0.833333333333333,0.95,0.222222222222222,0.575,0,"orthodox"
"202575",26,27,178,173,188,175,154,153,38,44,1,1,23,32,"win_B",-1,5,13,1,0,0,0,0,0.974358974358974,0.977777777777778,0.58974358974359,0.711111111111111,1,"orthodox"
"202578",25,27,178,170,188,175,155,152,35,20,1,1,21,8,"win_A",-2,8,13,3,0,0,0,0,0.972222222222222,0.952380952380952,0.583333333333333,0.380952380952381,0,"orthodox"
"202661",25,22,189,193,191,209,180,194,37,50,11,6,22,24,"win_B",3,-4,-18,-14,0,0,0,0,0.770833333333333,0.892857142857143,0.458333333333333,0.428571428571429,1,"orthodox"
"202665",24,26,189,178,191,180,178,172,36,68,8,12,22,21,"win_B",-2,11,11,6,0,0,0,0,0.818181818181818,0.85,0.5,0.2625,1,"orthodox"
"202714",31,25,178,175,183,175,159,159,39,28,6,7,20,24,"win_A",6,3,8,0,0,0,0,0,0.866666666666667,0.8,0.444444444444444,0.685714285714286,0,"orthodox"
"202718",30,24,178,175,183,175,160,160,37,25,5,6,19,21,"win_A",6,3,8,0,0,0,0,0,0.880952380952381,0.806451612903226,0.452380952380952,0.67741935483871,0,"orthodox"
"202802",24,27,168,173,170,173,135,135,32,34,0,3,16,25,"win_A",-3,-5,-3,0,0,0,0,0,1,0.918918918918919,0.5,0.675675675675676,0,"orthodox"
"202803",23,25,168,168,170,174,134,134,30,18,0,3,15,12,"win_A",-2,0,-4,0,0,0,0,0,1,0.857142857142857,0.5,0.571428571428571,0,"orthodox"
"202805",22,28,168,167,170,173,135,134,28,27,0,0,14,19,"win_A",-6,1,-3,1,0,0,0,0,1,1,0.5,0.703703703703704,0,"orthodox"
"202811",20,32,168,171,170,169,135,136,22,34,0,6,10,20,"win_A",-12,-3,1,-1,0,0,0,0,1,0.85,0.454545454545455,0.5,0,"orthodox"
"202815",19,33,168,170,170,175,136,138,18,18,0,12,8,9,"win_A",-14,-2,-5,-2,0,0,0,0,1,0.6,0.444444444444444,0.3,0,"orthodox"
"202821",18,27,168,168,170,170,135,137,12,11,0,16,7,7,"win_A",-9,0,0,-2,0,0,0,0,1,0.407407407407407,0.583333333333333,0.259259259259259,0,"orthodox"
"202822",17,24,168,175,170,185,135,135,11,15,0,7,7,8,"win_A",-7,-7,-15,0,0,0,0,0,1,0.681818181818182,0.636363636363636,0.363636363636364,0,"orthodox"
"203044",31,31,163,164,165,165,130,130,43,24,3,13,32,16,"win_A",0,-1,0,0,0,0,0,0,0.934782608695652,0.648648648648649,0.695652173913043,0.432432432432432,0,"orthodox"
"203049",29,31,163,166,165,173,135,126,38,8,2,5,28,1,"win_A",-2,-3,-8,9,0,0,0,0,0.95,0.615384615384615,0.7,0.0769230769230769,0,"orthodox"
"203058",26,27,163,168,165,161,118,117,29,29,1,6,23,20,"win_A",-1,-5,4,1,0,0,0,0,0.966666666666667,0.828571428571429,0.766666666666667,0.571428571428571,0,"orthodox"
"203066",23,26,163,168,165,166,118,116,21,26,1,14,18,21,"win_A",-3,-5,-1,2,0,0,0,0,0.954545454545455,0.65,0.818181818181818,0.525,0,"orthodox"
"203068",22,25,163,168,165,166,118,118,19,25,1,13,16,20,"win_A",-3,-5,-1,0,0,0,0,0,0.95,0.657894736842105,0.8,0.526315789473684,0,"orthodox"
"203342",37,27,183,185,185,191,181,163,29,9,4,4,26,7,"win_A",10,-2,-6,18,1,0,1,0,0.878787878787879,0.692307692307692,0.787878787878788,0.538461538461538,0,"orthodox"
"203368",31,21,183,185,185,191,182,166,3,5,0,0,2,4,"win_A",10,-2,-6,16,0,0,1,0,1,1,0.666666666666667,0.8,0,"orthodox"
"203380",33,20,161,168,168,164,112,112,47,15,1,1,20,11,"win_A",13,-7,4,0,0,0,0,0,0.979166666666667,0.9375,0.416666666666667,0.6875,0,"orthodox"
"203584",28,34,188,170,201,178,175,175,37,47,2,5,23,30,"win_A",-6,18,23,0,0,0,0,0,0.948717948717949,0.903846153846154,0.58974358974359,0.576923076923077,0,"orthodox"
"203586",29,34,191,170,193,178,174,173,17,46,0,4,14,30,"win_A",-5,21,15,1,0,0,0,0,1,0.92,0.823529411764706,0.6,0,"orthodox"
"203588",33,29,170,183,178,191,176,173,44,17,4,11,29,9,"win_A",4,-13,-13,3,0,0,0,0,0.916666666666667,0.607142857142857,0.604166666666667,0.321428571428571,0,"orthodox"
"203590",32,32,170,185,178,198,175,175,42,22,3,2,29,10,"win_A",0,-15,-20,0,0,0,0,0,0.933333333333333,0.916666666666667,0.644444444444444,0.416666666666667,0,"orthodox"
"203592",30,27,170,185,178,188,175,175,40,15,3,1,28,13,"win_A",3,-15,-10,0,0,0,0,0,0.930232558139535,0.9375,0.651162790697674,0.8125,0,"orthodox"
"203594",29,33,170,183,178,185,174,174,38,18,3,2,27,14,"win_A",-4,-13,-7,0,0,0,0,0,0.926829268292683,0.9,0.658536585365854,0.7,0,"orthodox"
"203597",35,28,179,170,177,178,178,192,29,35,5,2,23,24,"win_B",7,9,-1,-14,1,0,0,0,0.852941176470588,0.945945945945946,0.676470588235294,0.648648648648649,1,"orthodox"
"203599",28,25,170,185,178,196,175,175,34,14,1,0,23,4,"win_B",3,-15,-18,0,0,0,0,0,0.971428571428571,1,0.657142857142857,0.285714285714286,1,"orthodox"
"203601",28,35,170,179,178,177,175,179,32,29,1,4,21,23,"win_A",-7,-9,1,-4,0,1,0,0,0.96969696969697,0.878787878787879,0.636363636363636,0.696969696969697,0,"orthodox"
"203618",23,29,170,185,178,193,176,176,12,15,0,14,8,3,"win_A",-6,-15,-15,0,0,0,0,0,1,0.517241379310345,0.666666666666667,0.103448275862069,0,"orthodox"
"203641",26,24,192,188,206,198,222,218,24,21,2,0,13,11,"win_B",2,4,8,4,0,0,0,0,0.923076923076923,1,0.5,0.523809523809524,1,"orthodox"
"203644",24,24,192,193,206,203,222,240,22,19,0,0,12,15,"win_B",0,-1,3,-18,0,0,0,1,1,1,0.545454545454545,0.789473684210526,1,"orthodox"
"203675",24,34,179,193,183,201,168,166,17,23,0,2,13,13,"win_A",-10,-14,-18,2,0,0,0,0,1,0.92,0.764705882352941,0.52,0,"orthodox"
"203873",36,37,188,198,198,208,233,268,42,38,7,8,29,23,"win_A",-1,-10,-10,-35,1,1,0,1,0.857142857142857,0.826086956521739,0.591836734693878,0.5,0,"orthodox"
"203877",32,36,188,193,198,201,239,238,40,38,5,4,28,31,"win_A",-4,-5,-3,1,0,1,0,0,0.888888888888889,0.904761904761905,0.622222222222222,0.738095238095238,0,"orthodox"
"203879",31,31,188,189,198,208,241,246,38,35,5,4,27,29,"win_A",0,-1,-10,-5,0,0,0,0,0.883720930232558,0.897435897435897,0.627906976744186,0.743589743589744,0,"orthodox"
"203880",30,30,188,188,198,206,233,238,37,32,4,0,27,23,"win_A",0,0,-8,-5,0,0,0,0,0.902439024390244,1,0.658536585365854,0.71875,0,"orthodox"
"203883",27,28,188,183,198,198,234,212,33,21,3,1,24,16,"win_A",-1,5,0,22,0,0,1,0,0.916666666666667,0.954545454545455,0.666666666666667,0.727272727272727,0,"orthodox"
"203886",25,30,188,191,198,201,221,236,30,24,3,3,21,18,"win_A",-5,-3,-3,-15,0,0,0,1,0.909090909090909,0.888888888888889,0.636363636363636,0.666666666666667,0,"orthodox"
"203887",25,30,188,188,198,196,222,230,29,31,3,6,21,25,"win_A",-5,0,2,-8,0,0,0,0,0.90625,0.837837837837838,0.65625,0.675675675675676,0,"orthodox"
"203889",24,39,188,188,198,201,226,249,27,12,3,15,19,8,"win_A",-15,0,-3,-23,0,1,0,1,0.9,0.444444444444444,0.633333333333333,0.296296296296296,0,"orthodox"
"203892",23,24,178,188,178,198,219,225,22,25,0,2,18,17,"win_A",-1,-10,-20,-6,0,0,0,0,1,0.925925925925926,0.818181818181818,0.62962962962963,0,"orthodox"
"203893",23,28,188,193,198,193,221,210,24,18,2,2,16,16,"win_A",-5,-5,5,11,0,0,0,0,0.923076923076923,0.9,0.615384615384615,0.8,0,"orthodox"
"203898",23,30,188,191,198,203,217,224,19,23,2,0,12,13,"win_A",-7,-3,-5,-7,0,0,0,0,0.904761904761905,1,0.571428571428571,0.565217391304348,0,"orthodox"
"203906",21,29,188,183,198,180,193,198,13,5,0,7,9,3,"win_A",-8,5,18,-5,0,0,0,0,1,0.416666666666667,0.692307692307692,0.25,0,"orthodox"
"203933",27,19,164,171,174,168,136,133,86,17,20,3,18,9,"win_A",8,-7,6,3,0,0,0,0,0.811320754716981,0.85,0.169811320754717,0.45,0,"orthodox"
"204067",21,32,178,171,178,180,135,133,73,37,1,7,65,26,"win_B",-11,7,-2,2,0,0,0,0,0.986486486486487,0.840909090909091,0.878378378378378,0.590909090909091,1,"orthodox"
"204152",25,24,163,165,165,173,136,132,61,27,27,19,30,6,"win_A",1,-2,-8,4,0,0,0,0,0.693181818181818,0.58695652173913,0.340909090909091,0.130434782608696,0,"Unknown"
"204154",25,25,163,165,165,165,135,135,59,36,27,15,28,10,"win_A",0,-2,0,0,0,0,0,0,0.686046511627907,0.705882352941177,0.325581395348837,0.196078431372549,0,"Unknown"
"204166",23,27,163,170,165,173,135,145,49,18,18,14,24,4,"win_A",-4,-7,-8,-10,0,0,0,0,0.73134328358209,0.5625,0.358208955223881,0.125,0,"Unknown"
"204247",27,21,155,156,157,159,111,108,61,14,32,6,4,4,"win_A",6,-1,-2,3,0,0,0,0,0.655913978494624,0.7,0.043010752688172,0.2,0,"Unknown"
"204678",34,35,173,184,193,188,200,185,178,85,53,18,108,48,"win_A",-1,-11,5,15,0,1,1,0,0.770562770562771,0.825242718446602,0.467532467532468,0.466019417475728,0,"southpaw"
"204715",28,24,184,171,188,185,200,190,55,28,11,9,31,9,"win_A",4,13,3,10,0,0,0,0,0.833333333333333,0.756756756756757,0.46969696969697,0.243243243243243,0,"orthodox"
"204716",27,24,184,180,188,183,202,194,54,49,11,8,31,17,"win_A",3,4,5,8,0,0,0,0,0.830769230769231,0.859649122807018,0.476923076923077,0.298245614035088,0,"orthodox"
"204780",22,34,173,169,185,175,131,135,42,164,7,41,22,84,"win_A",-12,4,10,-4,0,0,0,0,0.857142857142857,0.8,0.448979591836735,0.409756097560976,0,"orthodox"
"204808",31,23,169,157,175,183,125,124,142,18,33,4,69,4,"win_A",8,12,-8,1,0,0,0,0,0.811428571428571,0.818181818181818,0.394285714285714,0.181818181818182,0,"orthodox"
"204822",30,19,169,166,175,170,128,128,128,52,31,0,59,10,"win_A",11,3,5,0,0,0,0,0,0.805031446540881,1,0.371069182389937,0.192307692307692,0,"orthodox"
"204833",29,32,169,165,175,165,131,130,119,88,28,18,54,17,"win_A",-3,4,10,1,0,0,0,0,0.80952380952381,0.830188679245283,0.36734693877551,0.160377358490566,0,"orthodox"
"204845",28,26,169,170,175,170,127,136,107,70,28,37,47,27,"win_A",2,-1,5,-9,0,0,0,0,0.792592592592593,0.654205607476635,0.348148148148148,0.252336448598131,0,"orthodox"
"204890",24,23,169,165,175,173,126,126,68,69,19,23,27,18,"win_A",1,4,2,0,0,0,0,0,0.781609195402299,0.75,0.310344827586207,0.195652173913043,0,"orthodox"
"204979",32,32,172,173,182,175,130,130,17,41,0,3,14,30,"win_A",0,-1,7,0,0,0,0,0,1,0.931818181818182,0.823529411764706,0.681818181818182,0,"orthodox"
"204980",31,26,172,169,182,178,130,130,16,20,0,1,13,16,"win_A",5,3,4,0,0,0,0,0,1,0.952380952380952,0.8125,0.761904761904762,0,"orthodox"
"204989",27,28,172,170,182,157,131,131,4,17,0,5,3,8,"win_A",-1,2,25,0,0,0,0,0,1,0.772727272727273,0.75,0.363636363636364,0,"orthodox"
"205000",28,28,183,183,183,201,202,210,47,45,6,2,28,44,"win_A",0,0,-18,-8,0,0,0,0,0.886792452830189,0.957446808510638,0.528301886792453,0.936170212765957,0,"orthodox"
"205003",27,31,183,191,183,193,200,219,44,19,6,0,26,17,"win_A",-4,-8,-10,-19,0,0,0,1,0.88,1,0.52,0.894736842105263,0,"orthodox"
"205009",26,26,183,193,183,203,198,207,38,37,5,9,23,19,"win_A",0,-10,-20,-9,0,0,0,0,0.883720930232558,0.804347826086957,0.534883720930233,0.41304347826087,0,"orthodox"
"205023",22,28,183,185,183,193,195,197,26,25,1,5,15,12,"win_B",-6,-2,-10,-2,0,0,0,0,0.962962962962963,0.833333333333333,0.555555555555556,0.4,1,"orthodox"
"205027",21,32,183,183,183,183,194,203,21,35,1,14,12,26,"win_A",-11,0,0,-9,0,0,0,0,0.954545454545455,0.714285714285714,0.545454545454545,0.530612244897959,0,"orthodox"
"205032",21,33,183,183,183,191,187,193,17,48,0,8,10,29,"win_B",-12,0,-8,-6,0,0,0,0,1,0.857142857142857,0.588235294117647,0.517857142857143,1,"orthodox"
"205106",24,32,169,160,174,168,113,113,5,34,0,7,3,20,"win_A",-8,9,6,0,0,0,0,0,1,0.829268292682927,0.6,0.48780487804878,0,"orthodox"
"205114",27,32,160,160,168,152,105,104,28,30,1,6,17,20,"win_A",-5,0,16,1,0,0,0,0,0.96551724137931,0.833333333333333,0.586206896551724,0.555555555555556,0,"orthodox"
"205127",22,26,160,157,168,168,108,109,14,15,1,6,7,8,"win_A",-4,3,0,-1,0,0,0,0,0.933333333333333,0.714285714285714,0.466666666666667,0.380952380952381,0,"orthodox"
"205130",21,24,160,165,168,165,115,113,11,4,0,15,6,4,"win_A",-3,-5,3,2,0,0,0,0,1,0.210526315789474,0.545454545454545,0.210526315789474,0,"orthodox"
"205132",21,24,160,165,168,165,108,108,9,4,0,13,4,4,"win_A",-3,-5,3,0,0,0,0,0,1,0.235294117647059,0.444444444444444,0.235294117647059,0,"orthodox"
"205210",21,24,182,188,185,180,200,213,62,6,7,12,44,4,"win_A",-3,-6,5,-13,0,0,0,0,0.898550724637681,0.333333333333333,0.63768115942029,0.222222222222222,0,"orthodox"
"205213",21,32,182,188,185,191,197,203,59,49,7,8,41,31,"win_A",-11,-6,-6,-6,0,0,0,0,0.893939393939394,0.859649122807018,0.621212121212121,0.543859649122807,0,"orthodox"
"205217",21,28,182,180,185,185,194,193,56,35,6,16,39,19,"win_A",-7,2,0,1,0,0,0,0,0.903225806451613,0.686274509803922,0.629032258064516,0.372549019607843,0,"orthodox"
"205229",19,27,182,171,185,185,196,185,45,33,5,23,32,9,"win_A",-8,11,0,11,0,0,0,0,0.9,0.589285714285714,0.64,0.160714285714286,0,"orthodox"
"205278",36,37,182,175,183,178,161,158,38,24,3,15,24,20,"win_A",-1,7,5,3,1,1,0,0,0.926829268292683,0.615384615384615,0.585365853658537,0.512820512820513,0,"orthodox"
"205282",34,28,182,174,183,175,154,154,35,25,2,2,22,24,"win_A",6,8,8,0,0,0,0,0,0.945945945945946,0.925925925925926,0.594594594594595,0.888888888888889,0,"orthodox"
"205411",20,28,178,173,183,178,153,147,11,31,5,11,4,27,"win_A",-8,5,5,6,0,0,0,0,0.6875,0.738095238095238,0.25,0.642857142857143,0,"orthodox"
"205452",38,41,177,180,178,191,198,217,56,19,8,18,29,15,"win_A",-3,-3,-13,-19,1,1,0,1,0.875,0.513513513513513,0.453125,0.405405405405405,0,"orthodox"
"205455",37,30,177,191,178,191,210,229,53,41,8,14,28,30,"win_A",7,-14,-13,-19,1,0,0,1,0.868852459016393,0.745454545454545,0.459016393442623,0.545454545454545,0,"orthodox"
"205460",32,34,193,177,201,178,230,238,35,50,4,5,29,27,"win_A",-2,16,23,-8,0,0,0,0,0.897435897435897,0.909090909090909,0.743589743589744,0.490909090909091,0,"orthodox"
"205461",33,26,177,191,178,203,220,233,49,13,5,1,26,13,"win_A",7,-14,-25,-13,0,0,0,0,0.907407407407407,0.928571428571429,0.481481481481481,0.928571428571429,0,"orthodox"
"205462",32,30,177,182,178,193,210,208,47,26,5,5,26,15,"win_A",2,-5,-15,2,0,0,0,0,0.903846153846154,0.838709677419355,0.5,0.483870967741935,0,"orthodox"
"205464",31,40,177,185,178,196,212,208,46,9,4,19,26,4,"win_A",-9,-8,-18,4,0,1,0,0,0.92,0.321428571428571,0.52,0.142857142857143,0,"orthodox"
"205466",37,30,196,177,208,178,215,242,52,44,4,4,43,25,"win_B",7,19,30,-27,1,0,0,1,0.928571428571429,0.916666666666667,0.767857142857143,0.520833333333333,1,"orthodox"
"205467",30,30,177,188,178,188,220,230,43,13,4,7,24,10,"win_A",0,-11,-10,-10,0,0,0,0,0.914893617021277,0.65,0.51063829787234,0.5,0,"orthodox"
"205468",29,27,177,182,178,193,190,190,42,24,3,2,24,15,"win_A",2,-5,-15,0,0,0,0,0,0.933333333333333,0.923076923076923,0.533333333333333,0.576923076923077,0,"orthodox"
"205470",28,29,177,188,178,203,188,190,40,21,3,2,22,16,"win_A",-1,-11,-25,-2,0,0,0,0,0.930232558139535,0.91304347826087,0.511627906976744,0.695652173913043,0,"orthodox"
"205471",28,29,177,188,178,203,187,189,39,21,3,1,22,16,"win_A",-1,-11,-25,-2,0,0,0,0,0.928571428571429,0.954545454545455,0.523809523809524,0.727272727272727,0,"orthodox"
"205472",28,30,177,180,178,183,193,195,38,29,3,5,21,16,"win_A",-2,-3,-5,-2,0,0,0,0,0.926829268292683,0.852941176470588,0.51219512195122,0.470588235294118,0,"orthodox"
"205480",26,30,177,183,178,188,190,192,30,27,3,6,15,22,"win_A",-4,-6,-10,-2,0,0,0,0,0.909090909090909,0.818181818181818,0.454545454545455,0.666666666666667,0,"orthodox"
"205482",32,25,196,177,208,178,213,235,40,29,1,2,34,15,"win_A",7,19,30,-22,0,0,0,1,0.975609756097561,0.935483870967742,0.829268292682927,0.483870967741935,0,"orthodox"
"205485",25,31,177,180,178,185,220,189,26,19,2,1,12,14,"win_A",-6,-3,-7,31,0,0,1,0,0.928571428571429,0.95,0.428571428571429,0.7,0,"orthodox"
"205492",23,30,177,188,178,206,211,220,20,28,1,7,9,21,"win_A",-7,-11,-28,-9,0,0,0,0,0.952380952380952,0.8,0.428571428571429,0.6,0,"orthodox"
"205493",23,31,177,188,178,196,214,223,19,16,1,4,9,11,"win_A",-8,-11,-18,-9,0,0,0,0,0.95,0.8,0.45,0.55,0,"orthodox"
"205496",22,31,177,188,178,198,210,215,16,29,1,6,9,15,"win_A",-9,-11,-20,-5,0,0,0,0,0.941176470588235,0.828571428571429,0.529411764705882,0.428571428571429,0,"orthodox"
"206056",20,28,160,154,168,160,118,118,58,91,8,17,21,78,"win_A",-8,6,8,0,0,0,0,0,0.878787878787879,0.842592592592593,0.318181818181818,0.722222222222222,0,"southpaw"
"206057",28,29,154,160,160,165,117,113,91,53,16,6,78,12,"win_B",-1,-6,-5,4,0,0,0,0,0.850467289719626,0.898305084745763,0.728971962616822,0.203389830508475,1,"Unknown"
"206161",25,35,180,173,180,188,141,140,45,38,3,17,35,24,"win_A",-10,7,-8,1,0,1,0,0,0.9375,0.690909090909091,0.729166666666667,0.436363636363636,0,"orthodox"
"206165",23,25,180,174,180,178,135,134,42,26,1,1,32,21,"win_A",-2,6,2,1,0,0,0,0,0.976744186046512,0.962962962962963,0.744186046511628,0.777777777777778,0,"orthodox"
"206168",22,31,180,173,180,183,135,135,39,35,1,18,30,23,"win_A",-9,7,-3,0,0,0,0,0,0.975,0.660377358490566,0.75,0.433962264150943,0,"orthodox"
"206174",21,27,180,165,180,173,135,134,33,43,1,4,25,29,"win_A",-6,15,7,1,0,0,0,0,0.970588235294118,0.914893617021277,0.735294117647059,0.617021276595745,0,"orthodox"
"206181",20,25,180,165,180,175,131,131,26,32,0,7,21,23,"win_A",-5,15,5,0,0,0,0,0,1,0.82051282051282,0.807692307692308,0.58974358974359,0,"orthodox"
"206184",19,23,180,165,180,163,128,127,23,13,0,9,19,5,"win_A",-4,15,17,1,0,0,0,0,1,0.590909090909091,0.826086956521739,0.227272727272727,0,"orthodox"
"206191",19,23,180,165,180,163,127,125,16,13,0,7,13,5,"win_A",-4,15,17,2,0,0,0,0,1,0.65,0.8125,0.25,0,"orthodox"
"206602",30,26,171,182,168,183,151,151,34,13,4,3,19,6,"win_B",4,-11,-15,0,0,0,0,0,0.894736842105263,0.8125,0.5,0.375,1,"orthodox"
"206603",29,33,171,173,168,175,147,150,33,34,4,13,19,22,"win_A",-4,-2,-7,-3,0,0,0,0,0.891891891891892,0.723404255319149,0.513513513513513,0.468085106382979,0,"orthodox"
"206624",19,30,171,175,168,185,137,139,11,35,0,6,7,22,"win_A",-11,-4,-17,-2,0,0,0,0,1,0.853658536585366,0.636363636363636,0.536585365853659,0,"orthodox"
"206678",28,28,175,178,178,184,160,162,93,97,16,10,14,17,"win_B",0,-3,-6,-2,0,0,0,0,0.853211009174312,0.906542056074766,0.128440366972477,0.158878504672897,1,"orthodox"
"206867",34,33,188,180,193,181,175,174,38,18,3,4,24,9,"win_A",1,8,12,1,0,0,0,0,0.926829268292683,0.818181818181818,0.585365853658537,0.409090909090909,0,"orthodox"
"206870",32,32,188,180,193,181,174,172,35,15,3,2,22,8,"win_A",0,8,12,2,0,0,0,0,0.921052631578947,0.882352941176471,0.578947368421053,0.470588235294118,0,"orthodox"
"206872",30,34,188,175,193,178,179,178,33,18,2,2,20,15,"win_A",-4,13,15,1,0,0,0,0,0.942857142857143,0.9,0.571428571428571,0.75,0,"orthodox"
"207038",28,25,169,170,173,175,136,135,26,39,11,6,10,12,"win_A",3,-1,-2,1,0,0,0,0,0.702702702702703,0.866666666666667,0.27027027027027,0.266666666666667,0,"orthodox"
"207185",26,27,170,171,185,172,140,140,7,31,1,12,6,17,"win_A",-1,-1,13,0,0,0,0,0,0.875,0.720930232558139,0.75,0.395348837209302,0,"southpaw"
"207391",26,26,175,175,178,178,135,135,72,25,6,2,61,12,"win_A",0,0,0,0,0,0,0,0,0.923076923076923,0.925925925925926,0.782051282051282,0.444444444444444,0,"orthodox"
"207516",32,25,183,198,191,208,192,199,47,36,5,4,29,18,"win_B",7,-15,-17,-7,0,0,0,0,0.903846153846154,0.9,0.557692307692308,0.45,1,"orthodox"
"207525",29,27,183,183,191,183,200,209,38,24,4,7,22,21,"win_A",2,0,8,-9,0,0,0,0,0.904761904761905,0.774193548387097,0.523809523809524,0.67741935483871,0,"orthodox"
"207533",28,27,185,183,196,191,199,194,49,31,3,1,29,19,"win_A",1,2,5,5,0,0,0,0,0.942307692307692,0.96875,0.557692307692308,0.59375,0,"orthodox"
"207541",25,26,183,188,191,203,195,201,23,29,0,6,15,13,"win_A",-1,-5,-12,-6,0,0,0,0,1,0.828571428571429,0.652173913043478,0.371428571428571,0,"orthodox"
"207751",28,32,180,176,188,189,153,153,23,16,0,7,10,11,"win_A",-4,4,-1,0,0,0,0,0,1,0.695652173913043,0.434782608695652,0.478260869565217,0,"southpaw"
"207755",26,29,179,176,188,189,154,154,27,14,0,3,20,9,"win_A",-3,3,-1,0,0,0,0,0,1,0.823529411764706,0.740740740740741,0.529411764705882,0,"southpaw"
"207756",28,28,176,175,189,183,154,154,13,39,3,1,9,33,"win_A",0,1,6,0,0,0,0,0,0.8125,0.975,0.5625,0.825,0,"orthodox"
"207757",26,28,183,176,191,189,154,154,23,13,7,2,8,9,"win_A",-2,7,2,0,0,0,0,0,0.766666666666667,0.866666666666667,0.266666666666667,0.6,0,"orthodox"
"207899",41,33,173,173,173,178,155,155,57,23,13,10,42,15,"win_A",8,0,-5,0,1,0,0,0,0.814285714285714,0.696969696969697,0.6,0.454545454545455,0,"orthodox"
"207902",40,24,173,175,173,183,154,156,55,8,12,2,42,5,"win_A",16,-2,-10,-2,1,0,0,0,0.82089552238806,0.8,0.626865671641791,0.5,0,"orthodox"
"207904",28,39,173,173,178,173,147,147,33,55,3,10,21,42,"win_A",-11,0,5,0,0,1,0,0,0.916666666666667,0.846153846153846,0.583333333333333,0.646153846153846,0,"orthodox"
"207905",25,39,173,173,183,173,151,155,19,55,2,9,14,42,"win_A",-14,0,10,-4,0,1,0,0,0.904761904761905,0.859375,0.666666666666667,0.65625,0,"orthodox"
"207907",29,38,179,173,181,173,146,146,31,55,1,6,21,42,"win_A",-9,6,8,0,0,1,0,0,0.96875,0.901639344262295,0.65625,0.688524590163934,0,"orthodox"
"207908",26,37,176,173,183,173,146,148,47,55,2,5,28,42,"win_A",-11,3,10,-2,0,1,0,0,0.959183673469388,0.916666666666667,0.571428571428571,0.7,0,"orthodox"
"207923",27,32,173,178,173,175,142,142,37,14,2,16,31,9,"win_A",-5,-5,-2,0,0,0,0,0,0.948717948717949,0.466666666666667,0.794871794871795,0.3,0,"orthodox"
"207940",23,22,173,173,173,183,136,136,21,12,0,11,18,4,"win_A",1,0,-10,0,0,0,0,0,1,0.521739130434783,0.857142857142857,0.173913043478261,0,"orthodox"
"207969",31,31,185,178,188,183,172,174,24,36,0,5,21,23,"win_B",0,7,5,-2,0,0,0,0,1,0.878048780487805,0.875,0.560975609756098,1,"southpaw"
"208104",28,38,185,182,198,196,167,168,30,48,5,5,20,28,"win_A",-10,3,2,-1,0,1,0,0,0.857142857142857,0.905660377358491,0.571428571428571,0.528301886792453,0,"orthodox"
"208105",34,38,171,182,179,196,165,168,41,47,6,5,28,28,"win_B",-4,-11,-17,-3,0,1,0,0,0.872340425531915,0.903846153846154,0.595744680851064,0.538461538461538,1,"orthodox"
"208160",32,21,152,163,160,165,107,108,29,22,0,2,6,17,"win_A",11,-11,-5,-1,0,0,0,0,1,0.916666666666667,0.206896551724138,0.708333333333333,0,"southpaw"
"208165",30,20,152,165,160,160,104,103,22,13,0,1,5,10,"win_A",10,-13,0,1,0,0,0,0,1,0.928571428571429,0.227272727272727,0.714285714285714,0,"southpaw"
"208170",28,30,152,159,160,163,105,105,17,29,0,3,3,20,"win_A",-2,-7,-3,0,0,0,0,0,1,0.90625,0.176470588235294,0.625,0,"southpaw"
"208171",28,27,152,161,160,168,104,105,15,18,0,5,3,13,"win_A",1,-9,-8,-1,0,0,0,0,1,0.782608695652174,0.2,0.565217391304348,0,"southpaw"
"208172",28,23,152,165,160,175,108,109,14,0,0,5,3,0,"win_A",5,-13,-15,-1,0,0,0,0,1,0,0.214285714285714,0,0,"southpaw"
"208173",27,23,152,163,160,168,107,108,13,14,0,4,3,6,"win_A",4,-11,-8,-1,0,0,0,0,1,0.777777777777778,0.230769230769231,0.333333333333333,0,"southpaw"
"208180",26,26,152,155,160,157,108,108,5,7,0,1,2,4,"win_A",0,-3,3,0,0,0,0,0,1,0.875,0.4,0.5,0,"southpaw"
"208182",26,21,152,165,160,163,106,112,3,0,0,2,1,0,"win_A",5,-13,-3,-6,0,0,0,0,1,0,0.333333333333333,0,0,"southpaw"
"208187",27,40,180,170,185,178,139,139,27,34,2,9,19,25,"win_B",-13,10,7,0,0,1,0,0,0.931034482758621,0.790697674418605,0.655172413793103,0.581395348837209,1,"orthodox"
"208188",28,39,173,170,173,178,141,140,14,34,0,8,6,25,"win_A",-11,3,-5,1,0,1,0,0,1,0.80952380952381,0.428571428571429,0.595238095238095,0,"southpaw"
"208194",34,30,170,173,178,178,133,134,28,37,5,1,24,21,"win_A",4,-3,0,-1,0,0,0,0,0.848484848484849,0.973684210526316,0.727272727272727,0.552631578947368,0,"orthodox"
"208197",33,28,170,170,178,173,135,135,26,20,4,0,22,12,"win_A",5,0,5,0,0,0,0,0,0.866666666666667,1,0.733333333333333,0.6,0,"orthodox"
"208203",31,25,170,170,178,170,130,130,23,21,1,2,21,8,"win_A",6,0,8,0,0,0,0,0,0.958333333333333,0.91304347826087,0.875,0.347826086956522,0,"orthodox"
"208205",30,29,170,173,178,178,129,130,21,27,0,4,19,20,"win_A",1,-3,0,-1,0,0,0,0,1,0.870967741935484,0.904761904761905,0.645161290322581,0,"orthodox"
"208206",30,25,170,173,178,173,133,133,20,23,0,2,18,18,"win_A",5,-3,5,0,0,0,0,0,1,0.92,0.9,0.72,0,"orthodox"
"208225",25,28,170,170,170,178,133,131,1,1,1,0,1,1,"win_B",-3,0,-8,2,0,0,0,0,0.5,1,0.5,1,1,"orthodox"
"208425",20,32,178,174,187,183,156,159,31,84,2,23,27,23,"win_A",-12,4,4,-3,0,0,0,0,0.939393939393939,0.785046728971963,0.818181818181818,0.214953271028037,0,"orthodox"
"208466",31,28,175,174,183,183,168,169,49,45,27,19,17,8,"win_B",3,1,0,-1,0,0,0,0,0.644736842105263,0.703125,0.223684210526316,0.125,1,"Unknown"
"208903",36,35,171,180,175,181,155,155,39,23,10,7,20,17,"win_A",1,-9,-6,0,1,1,0,0,0.795918367346939,0.766666666666667,0.408163265306122,0.566666666666667,0,"orthodox"
"208908",33,32,171,183,175,183,156,156,34,45,8,4,18,29,"win_A",1,-12,-8,0,0,0,0,0,0.80952380952381,0.918367346938776,0.428571428571429,0.591836734693878,0,"orthodox"
"208909",33,30,171,185,175,180,153,156,33,44,8,8,18,26,"win_A",3,-14,-5,-3,0,0,0,0,0.804878048780488,0.846153846153846,0.439024390243902,0.5,0,"orthodox"
"208918",26,31,171,183,175,188,160,159,25,33,5,1,13,25,"win_B",-5,-12,-13,1,0,0,0,0,0.833333333333333,0.970588235294118,0.433333333333333,0.735294117647059,1,"orthodox"
"208931",21,24,171,173,175,175,152,153,12,30,4,0,5,22,"win_A",-3,-2,0,-1,0,0,0,0,0.75,1,0.3125,0.733333333333333,0,"orthodox"
"209159",22,33,174,165,178,169,118,118,13,31,2,5,12,20,"win_A",-11,9,9,0,0,0,0,0,0.866666666666667,0.861111111111111,0.8,0.555555555555556,0,"southpaw"
"209170",27,21,165,163,169,168,118,118,23,14,0,3,15,10,"win_B",6,2,1,0,0,0,0,0,1,0.823529411764706,0.652173913043478,0.588235294117647,1,"orthodox"
"209239",23,26,173,175,173,183,130,125,42,122,15,38,27,75,"win_A",-3,-2,-10,5,0,0,0,0,0.736842105263158,0.7625,0.473684210526316,0.46875,0,"orthodox"
"209275",21,24,173,175,173,183,133,129,15,111,6,35,10,68,"win_B",-3,-2,-10,4,0,0,0,0,0.714285714285714,0.76027397260274,0.476190476190476,0.465753424657534,1,"orthodox"
"209302",29,31,165,170,178,185,125,125,38,19,2,4,32,12,"win_A",-2,-5,-7,0,0,0,0,0,0.95,0.826086956521739,0.8,0.521739130434783,0,"southpaw"
"209306",27,23,165,170,178,168,121,122,33,21,1,2,30,15,"win_A",4,-5,10,-1,0,0,0,0,0.970588235294118,0.91304347826087,0.882352941176471,0.652173913043478,0,"southpaw"
"209313",24,34,165,171,178,175,122,122,25,16,1,13,24,8,"win_A",-10,-6,3,0,0,0,0,0,0.961538461538462,0.551724137931034,0.923076923076923,0.275862068965517,0,"southpaw"
"209314",24,25,165,168,178,165,124,125,24,23,1,4,23,22,"win_A",-1,-3,13,-1,0,0,0,0,0.96,0.851851851851852,0.92,0.814814814814815,0,"southpaw"
"209315",24,32,165,168,178,173,121,121,23,28,0,8,22,17,"win_A",-8,-3,5,0,0,0,0,0,1,0.777777777777778,0.956521739130435,0.472222222222222,0,"southpaw"
"209316",24,25,165,163,178,170,122,122,22,22,0,2,21,13,"win_A",-1,2,8,0,0,0,0,0,1,0.916666666666667,0.954545454545455,0.541666666666667,0,"southpaw"
"209319",23,34,165,170,178,160,123,124,19,19,0,12,19,8,"win_A",-11,-5,18,-1,0,0,0,0,1,0.612903225806452,1,0.258064516129032,0,"southpaw"
"209326",22,25,165,168,178,168,118,118,12,19,0,4,12,14,"win_A",-3,-3,10,0,0,0,0,0,1,0.826086956521739,1,0.608695652173913,0,"southpaw"
"209344",27,23,178,183,183,189,176,175,56,26,10,2,12,18,"win_B",4,-5,-6,1,0,0,0,0,0.848484848484849,0.928571428571429,0.181818181818182,0.642857142857143,1,"orthodox"
"209350",24,26,178,180,183,193,175,173,52,19,8,9,12,7,"win_A",-2,-2,-10,2,0,0,0,0,0.866666666666667,0.678571428571429,0.2,0.25,0,"orthodox"
"209433",25,28,165,170,168,175,137,138,106,82,19,8,36,37,"win_A",-3,-5,-7,-1,0,0,0,0,0.848,0.911111111111111,0.288,0.411111111111111,0,"orthodox"
"209440",24,20,165,171,168,168,133,135,99,22,19,11,32,10,"win_A",4,-6,0,-2,0,0,0,0,0.838983050847458,0.666666666666667,0.271186440677966,0.303030303030303,0,"orthodox"
"209605",24,33,186,180,193,183,199,200,18,42,0,11,13,38,"win_A",-9,6,10,-1,0,0,0,0,1,0.792452830188679,0.722222222222222,0.716981132075472,0,"orthodox"
"209679",21,27,180,182,188,188,169,190,38,110,14,11,22,47,"win_A",-6,-2,0,-21,0,0,0,1,0.730769230769231,0.909090909090909,0.423076923076923,0.388429752066116,0,"Unknown"
"209787",27,37,178,178,178,183,154,154,25,58,2,5,22,40,"win_A",-10,0,-5,0,0,1,0,0,0.925925925925926,0.920634920634921,0.814814814814815,0.634920634920635,0,"orthodox"
"209817",25,26,178,173,183,175,152,153,29,42,1,1,17,32,"win_B",-1,5,8,-1,0,0,0,0,0.966666666666667,0.976744186046512,0.566666666666667,0.744186046511628,1,"orthodox"
"209823",44,24,173,178,178,183,150,149,42,23,26,1,18,16,"win_B",20,-5,-5,1,1,0,0,0,0.617647058823529,0.958333333333333,0.264705882352941,0.666666666666667,1,"orthodox"
"210303",29,41,175,173,173,188,143,143,38,40,19,21,25,25,"win_A",-12,2,-15,0,0,1,0,0,0.666666666666667,0.655737704918033,0.43859649122807,0.409836065573771,0,"orthodox"
"210305",39,33,173,175,188,183,148,148,39,21,20,52,25,15,"win_A",6,-2,5,0,1,0,0,0,0.661016949152542,0.287671232876712,0.423728813559322,0.205479452054795,0,"orthodox"
"210307",36,27,173,180,188,183,152,149,38,23,19,2,24,14,"win_B",9,-7,5,3,1,0,0,0,0.666666666666667,0.92,0.421052631578947,0.56,1,"orthodox"
"210308",36,28,173,178,188,188,150,142,38,38,18,3,24,23,"win_B",8,-5,0,8,1,0,0,0,0.678571428571429,0.926829268292683,0.428571428571429,0.560975609756098,1,"orthodox"
"210322",23,31,178,173,188,188,143,140,22,31,1,7,15,20,"win_A",-8,5,0,3,0,0,0,0,0.956521739130435,0.815789473684211,0.652173913043478,0.526315789473684,0,"orthodox"
"210323",31,19,173,176,188,183,142,142,31,20,6,0,20,14,"win_B",12,-3,5,0,0,0,0,0,0.837837837837838,1,0.540540540540541,0.7,1,"orthodox"
"210329",28,33,173,175,188,185,140,140,28,63,3,9,18,46,"win_A",-5,-2,3,0,0,0,0,0,0.903225806451613,0.875,0.580645161290323,0.638888888888889,0,"orthodox"
"210364",25,37,179,185,185,196,215,206,35,76,4,9,28,42,"win_A",-12,-6,-11,9,0,1,0,0,0.897435897435897,0.894117647058824,0.717948717948718,0.494117647058824,0,"orthodox"
"210390",30,24,185,192,196,185,200,206,53,12,4,1,30,10,"win_B",6,-7,11,-6,0,0,0,0,0.929824561403509,0.923076923076923,0.526315789473684,0.769230769230769,1,"orthodox"
"210403",29,27,187,185,196,196,200,198,0,40,1,2,0,25,"win_B",2,2,0,2,0,0,0,0,0,0.952380952380952,0,0.595238095238095,1,"orthodox"
"210450",24,25,185,180,191,193,178,174,38,18,6,6,29,7,"win_A",-1,5,-2,4,0,0,0,0,0.863636363636364,0.75,0.659090909090909,0.291666666666667,0,"orthodox"
"210656",30,26,180,165,183,180,132,132,33,43,1,20,17,32,"win_A",4,15,3,0,0,0,0,0,0.970588235294118,0.682539682539683,0.5,0.507936507936508,0,"orthodox"
"210658",29,28,165,180,173,183,131,131,53,31,7,0,36,15,"win_B",1,-15,-10,0,0,0,0,0,0.883333333333333,1,0.6,0.483870967741935,1,"orthodox"
"210661",27,33,180,161,183,170,130,130,28,25,0,5,14,12,"win_A",-6,19,13,0,0,0,0,0,1,0.833333333333333,0.5,0.4,0,"orthodox"
"210749",30,25,168,179,174,188,150,148,43,36,12,1,29,23,"win_A",5,-11,-14,2,0,0,0,0,0.781818181818182,0.972972972972973,0.527272727272727,0.621621621621622,0,"Unknown"
"210782",24,24,168,169,174,170,146,144,15,29,0,1,11,19,"win_A",0,-1,4,2,0,0,0,0,1,0.966666666666667,0.733333333333333,0.633333333333333,0,"Unknown"
"210802",26,24,171,176,180,183,147,147,32,39,0,1,28,25,"win_A",2,-5,-3,0,0,0,0,0,1,0.975,0.875,0.625,0,"orthodox"
"210803",26,32,171,171,180,178,147,147,31,33,0,1,27,22,"win_A",-6,0,2,0,0,0,0,0,1,0.970588235294118,0.870967741935484,0.647058823529412,0,"orthodox"
"210835",29,34,178,175,178,175,164,164,26,27,4,6,22,22,"win_B",-5,3,3,0,0,0,0,0,0.866666666666667,0.818181818181818,0.733333333333333,0.666666666666667,1,"orthodox"
"210836",27,36,178,180,178,185,162,162,24,33,2,3,22,15,"win_A",-9,-2,-7,0,0,1,0,0,0.923076923076923,0.916666666666667,0.846153846153846,0.416666666666667,0,"orthodox"
"210840",23,32,178,180,178,183,156,156,20,32,1,4,18,20,"win_A",-9,-2,-5,0,0,0,0,0,0.952380952380952,0.888888888888889,0.857142857142857,0.555555555555556,0,"orthodox"
"210842",21,27,178,179,178,188,154,153,16,30,0,1,16,20,"win_A",-6,-1,-10,1,0,0,0,0,1,0.967741935483871,1,0.645161290322581,0,"orthodox"
"210844",21,27,178,171,178,173,151,151,14,72,0,2,14,62,"win_A",-6,7,5,0,0,0,0,0,1,0.972972972972973,1,0.837837837837838,0,"orthodox"
"210845",20,28,178,182,178,183,153,155,13,16,0,5,13,6,"win_A",-8,-4,-5,-2,0,0,0,0,1,0.761904761904762,1,0.285714285714286,0,"orthodox"
"210848",20,32,178,173,178,180,153,151,10,24,0,3,10,17,"win_A",-12,5,-2,2,0,0,0,0,1,0.888888888888889,1,0.62962962962963,0,"orthodox"
"210850",20,27,178,170,178,171,152,150,8,7,0,3,8,4,"win_A",-7,8,7,2,0,0,0,0,1,0.7,1,0.4,0,"orthodox"
"210855",19,30,178,165,178,170,149,145,3,3,0,5,3,2,"win_A",-11,13,8,4,0,0,0,0,1,0.375,1,0.25,0,"orthodox"
"210978",29,27,175,174,180,179,152,153,56,41,2,1,21,27,"win_B",2,1,1,-1,0,0,0,0,0.96551724137931,0.976190476190476,0.362068965517241,0.642857142857143,1,"orthodox"
"211357",22,20,178,180,183,185,166,161,5,13,0,6,5,4,"win_A",2,-2,-2,5,0,0,0,0,1,0.684210526315789,1,0.210526315789474,0,"orthodox"
"211364",42,23,171,175,178,170,149,149,48,13,9,5,34,8,"win_B",19,-4,8,0,1,0,0,0,0.842105263157895,0.722222222222222,0.596491228070175,0.444444444444444,1,"orthodox"
"211367",29,41,175,171,191,178,154,154,25,46,4,8,12,33,"win_A",-12,4,13,0,0,1,0,0,0.862068965517241,0.851851851851852,0.413793103448276,0.611111111111111,0,"orthodox"
"211373",32,37,180,171,185,178,140,140,41,41,7,5,19,30,"win_A",-5,9,7,0,0,1,0,0,0.854166666666667,0.891304347826087,0.395833333333333,0.652173913043478,0,"orthodox"
"211374",37,34,171,170,178,178,143,140,40,24,5,6,29,16,"win_A",3,1,0,3,1,0,0,0,0.888888888888889,0.8,0.644444444444444,0.533333333333333,0,"orthodox"
"211376",35,30,171,170,178,170,140,140,39,20,3,1,28,15,"win_B",5,1,8,0,1,0,0,0,0.928571428571429,0.952380952380952,0.666666666666667,0.714285714285714,1,"orthodox"
"211377",34,26,171,180,178,170,140,139,38,18,3,1,27,16,"win_A",8,-9,8,1,0,0,0,0,0.926829268292683,0.947368421052632,0.658536585365854,0.842105263157895,0,"orthodox"
"211378",34,34,171,173,178,183,140,140,37,43,3,21,26,31,"win_A",0,-2,-5,0,0,0,0,0,0.925,0.671875,0.65,0.484375,0,"orthodox"
"211380",31,33,173,171,180,178,147,147,23,35,1,2,17,24,"win_A",-2,2,2,0,0,0,0,0,0.958333333333333,0.945945945945946,0.708333333333333,0.648648648648649,0,"southpaw"
"211381",33,23,171,175,178,173,142,143,34,32,2,6,23,20,"win_A",10,-4,5,-1,0,0,0,0,0.944444444444444,0.842105263157895,0.638888888888889,0.526315789473684,0,"orthodox"
"211387",31,22,171,185,178,180,147,147,28,28,1,1,19,19,"win_A",9,-14,-2,0,0,0,0,0,0.96551724137931,0.96551724137931,0.655172413793103,0.655172413793103,0,"orthodox"
"211388",30,27,171,172,178,175,145,145,28,32,0,5,19,21,"win_B",3,-1,3,0,0,0,0,0,1,0.864864864864865,0.678571428571429,0.567567567567568,1,"orthodox"
"211398",27,30,171,173,178,175,140,137,18,18,0,9,12,12,"win_A",-3,-2,3,3,0,0,0,0,1,0.666666666666667,0.666666666666667,0.444444444444444,0,"orthodox"
"211550",36,23,148,156,150,152,108,108,47,23,11,8,23,11,"win_A",13,-8,-2,0,1,0,0,0,0.810344827586207,0.741935483870968,0.396551724137931,0.354838709677419,0,"orthodox"
"211632",27,27,178,173,175,183,150,144,11,21,1,7,10,11,"win_A",0,5,-8,6,0,0,0,0,0.916666666666667,0.75,0.833333333333333,0.392857142857143,0,"Unknown"
"211657",26,32,180,178,188,180,187,204,71,99,30,25,38,37,"win_A",-6,2,8,-17,0,0,0,1,0.702970297029703,0.798387096774194,0.376237623762376,0.298387096774194,0,"Unknown"
"211666",25,29,171,178,183,180,188,176,60,93,12,22,36,35,"win_A",-4,-7,3,12,0,0,0,0,0.833333333333333,0.808695652173913,0.5,0.304347826086957,0,"orthodox"
"211675",25,28,171,178,183,180,182,172,59,86,12,20,36,31,"win_A",-3,-7,3,10,0,0,0,0,0.830985915492958,0.811320754716981,0.507042253521127,0.292452830188679,0,"orthodox"
"211693",29,27,180,178,185,180,177,181,52,72,19,15,17,24,"win_A",2,2,5,-4,0,0,0,0,0.732394366197183,0.827586206896552,0.23943661971831,0.275862068965517,0,"orthodox"
"211699",24,26,189,178,191,180,172,178,36,68,8,12,22,21,"win_B",-2,11,11,-6,0,0,0,0,0.818181818181818,0.85,0.5,0.2625,1,"orthodox"
"211775",23,46,180,173,191,178,147,147,19,42,0,30,12,18,"win_A",-23,7,13,0,0,1,0,0,1,0.583333333333333,0.631578947368421,0.25,0,"orthodox"
"211788",41,20,173,171,178,184,144,144,38,18,20,0,16,14,"win_A",21,2,-6,0,1,0,0,0,0.655172413793103,1,0.275862068965517,0.777777777777778,0,"orthodox"
"211854",21,36,164,164,168,165,118,119,16,43,2,15,11,24,"win_A",-15,0,3,-1,0,1,0,0,0.888888888888889,0.741379310344828,0.611111111111111,0.413793103448276,0,"orthodox"
"211858",32,24,164,160,165,168,118,119,38,7,14,3,20,5,"win_A",8,4,-3,-1,0,0,0,0,0.730769230769231,0.7,0.384615384615385,0.5,0,"orthodox"
"211871",28,19,164,168,165,173,116,117,26,32,9,3,14,18,"win_A",9,-4,-8,-1,0,0,0,0,0.742857142857143,0.914285714285714,0.4,0.514285714285714,0,"orthodox"
"211946",23,38,165,168,168,165,127,126,17,63,4,12,9,38,"win_A",-15,-3,3,1,0,1,0,0,0.80952380952381,0.84,0.428571428571429,0.506666666666667,0,"southpaw"
"211958",33,22,168,175,165,170,122,123,53,20,8,1,31,15,"win_A",11,-7,-5,-1,0,0,0,0,0.868852459016393,0.952380952380952,0.508196721311475,0.714285714285714,0,"orthodox"
"211968",27,30,170,168,173,165,122,122,24,45,0,5,15,25,"win_A",-3,2,8,0,0,0,0,0,1,0.9,0.625,0.5,0,"orthodox"
"211972",29,23,168,170,165,173,122,122,41,17,5,0,21,14,"win_A",6,-2,-8,0,0,0,0,0,0.891304347826087,1,0.456521739130435,0.823529411764706,0,"orthodox"
"211975",28,24,168,163,165,160,121,121,39,9,4,11,20,7,"win_A",4,5,5,0,0,0,0,0,0.906976744186046,0.45,0.465116279069767,0.35,0,"orthodox"
"211976",28,24,168,165,165,163,126,126,38,13,4,11,20,5,"win_A",4,3,2,0,0,0,0,0,0.904761904761905,0.541666666666667,0.476190476190476,0.208333333333333,0,"orthodox"
"211977",28,31,168,170,165,165,123,123,37,34,4,25,20,13,"win_A",-3,-2,0,0,0,0,0,0,0.902439024390244,0.576271186440678,0.48780487804878,0.220338983050847,0,"orthodox"
"211983",26,23,168,168,165,165,124,124,32,17,3,10,16,8,"win_A",3,0,0,0,0,0,0,0,0.914285714285714,0.62962962962963,0.457142857142857,0.296296296296296,0,"orthodox"
"212287",28,34,170,171,174,175,159,155,45,63,7,16,34,41,"win_A",-6,-1,-1,4,0,0,0,0,0.865384615384615,0.79746835443038,0.653846153846154,0.518987341772152,0,"orthodox"
"212293",27,33,170,171,174,175,160,154,43,57,6,16,32,35,"win_B",-6,-1,-1,6,0,0,0,0,0.877551020408163,0.780821917808219,0.653061224489796,0.479452054794521,1,"orthodox"
"212307",27,25,171,184,175,185,161,162,43,25,14,4,24,13,"win_B",2,-13,-10,-1,0,0,0,0,0.754385964912281,0.862068965517241,0.421052631578947,0.448275862068966,1,"orthodox"
"212312",26,24,171,177,175,185,162,162,38,51,14,2,20,30,"win_A",2,-6,-10,0,0,0,0,0,0.730769230769231,0.962264150943396,0.384615384615385,0.566037735849057,0,"orthodox"
"212365",33,45,191,192,196,198,253,257,17,55,10,12,3,38,"win_A",-12,-1,-2,-4,0,1,0,0,0.62962962962963,0.82089552238806,0.111111111111111,0.567164179104478,0,"orthodox"
"212366",37,44,195,192,203,198,245,247,42,55,4,11,34,38,"win_A",-7,3,5,-2,1,1,0,0,0.91304347826087,0.833333333333333,0.739130434782609,0.575757575757576,0,"orthodox"
"212367",44,29,192,191,198,185,252,239,54,30,11,2,38,15,"win_A",15,1,13,13,1,0,0,0,0.830769230769231,0.9375,0.584615384615385,0.46875,0,"orthodox"
"212368",44,35,192,183,198,201,249,231,53,26,11,5,37,20,"win_A",9,9,-3,18,1,1,1,0,0.828125,0.838709677419355,0.578125,0.645161290322581,0,"orthodox"
"212369",44,40,192,198,198,206,245,267,52,11,11,6,36,8,"win_A",4,-6,-8,-22,1,1,0,1,0.825396825396825,0.647058823529412,0.571428571428571,0.470588235294118,0,"orthodox"
"212371",30,43,191,192,198,198,235,224,24,51,2,10,15,35,"win_A",-13,-1,0,11,0,1,0,0,0.923076923076923,0.836065573770492,0.576923076923077,0.573770491803279,0,"orthodox"
"212375",42,45,192,185,198,198,257,302,46,12,10,5,31,8,"win_A",-3,7,0,-45,1,1,0,1,0.821428571428571,0.705882352941177,0.553571428571429,0.470588235294118,0,"orthodox"
"212376",41,40,192,188,198,206,237,255,46,55,9,14,31,45,"win_B",1,4,-8,-18,1,1,0,1,0.836363636363636,0.797101449275362,0.563636363636364,0.652173913043478,1,"orthodox"
"212377",34,41,191,192,196,198,230,240,48,46,0,8,32,31,"win_A",-7,-1,-2,-10,0,1,0,0,1,0.851851851851852,0.666666666666667,0.574074074074074,0,"orthodox"
"212378",40,30,192,193,198,201,239,238,46,31,7,3,31,27,"win_B",10,-1,-3,1,1,0,0,0,0.867924528301887,0.911764705882353,0.584905660377358,0.794117647058823,1,"orthodox"
"212379",40,32,192,188,198,196,231,229,46,32,6,9,31,26,"win_B",8,4,2,2,1,0,0,0,0.884615384615385,0.780487804878049,0.596153846153846,0.634146341463415,1,"orthodox"
"212380",39,30,192,191,198,206,237,235,46,29,5,1,31,20,"win_B",9,1,-8,2,1,0,0,0,0.901960784313726,0.966666666666667,0.607843137254902,0.666666666666667,1,"orthodox"
"212381",39,37,192,183,198,191,239,227,45,21,5,14,30,12,"win_A",2,9,7,12,1,1,0,0,0.9,0.6,0.6,0.342857142857143,0,"orthodox"
"212382",38,35,192,185,198,196,230,239,45,23,4,4,30,16,"win_B",3,7,2,-9,1,1,0,0,0.918367346938776,0.851851851851852,0.612244897959184,0.592592592592593,1,"orthodox"
"212383",38,31,192,201,198,208,224,250,44,24,4,1,29,23,"win_A",7,-9,-10,-26,1,0,0,1,0.916666666666667,0.96,0.604166666666667,0.92,0,"orthodox"
"212384",38,31,192,193,198,203,228,215,43,27,4,1,29,13,"win_A",7,-1,-5,13,1,0,0,0,0.914893617021277,0.964285714285714,0.617021276595745,0.464285714285714,0,"orthodox"
"212388",36,38,192,188,198,201,228,231,39,10,4,7,25,6,"win_A",-2,4,-3,-3,1,1,0,0,0.906976744186046,0.588235294117647,0.581395348837209,0.352941176470588,0,"orthodox"
"212389",36,31,192,191,198,198,237,231,38,16,4,3,24,12,"win_A",5,1,0,6,1,0,0,0,0.904761904761905,0.842105263157895,0.571428571428571,0.631578947368421,0,"orthodox"
"212394",33,39,192,198,198,201,238,226,34,19,3,2,22,14,"win_A",-6,-6,-3,12,0,1,0,0,0.918918918918919,0.904761904761905,0.594594594594595,0.666666666666667,0,"orthodox"
"212395",33,31,192,193,198,216,236,236,33,23,3,3,22,18,"win_A",2,-1,-18,0,0,0,0,0,0.916666666666667,0.884615384615385,0.611111111111111,0.692307692307692,0,"orthodox"
"212398",32,35,192,191,198,203,230,209,30,22,3,5,20,20,"win_A",-3,1,-5,21,0,1,1,0,0.909090909090909,0.814814814814815,0.606060606060606,0.740740740740741,0,"orthodox"
"212401",30,26,192,183,198,185,223,248,27,16,3,2,18,10,"win_A",4,9,13,-25,0,0,0,1,0.9,0.888888888888889,0.6,0.555555555555556,0,"orthodox"
"212402",29,25,192,194,198,211,217,222,26,13,3,0,18,9,"win_A",4,-2,-13,-5,0,0,0,0,0.896551724137931,1,0.620689655172414,0.692307692307692,0,"orthodox"
"212406",28,27,192,190,198,201,227,244,23,21,2,0,16,14,"win_A",1,2,-3,-17,0,0,0,1,0.92,1,0.64,0.666666666666667,0,"orthodox"
"212411",27,24,192,185,198,188,230,215,18,4,2,3,12,4,"win_A",3,7,10,15,0,0,1,0,0.9,0.571428571428571,0.6,0.571428571428571,0,"orthodox"
"212412",26,26,192,191,198,196,217,216,18,24,1,0,12,20,"win_B",0,1,2,1,0,0,0,0,0.947368421052632,1,0.631578947368421,0.833333333333333,1,"orthodox"
"212512",21,33,173,160,175,160,115,115,17,44,0,3,12,28,"win_A",-12,13,15,0,0,0,0,0,1,0.936170212765957,0.705882352941177,0.595744680851064,0,"orthodox"
"212515",31,32,160,168,160,168,119,120,40,27,3,25,27,17,"win_A",-1,-8,-8,-1,0,0,0,0,0.930232558139535,0.519230769230769,0.627906976744186,0.326923076923077,0,"southpaw"
"212522",26,32,160,170,160,178,112,111,33,17,1,3,24,10,"win_A",-6,-10,-18,1,0,0,0,0,0.970588235294118,0.85,0.705882352941177,0.5,0,"southpaw"
"212523",26,23,160,173,160,173,112,112,32,14,1,1,24,9,"win_A",3,-13,-13,0,0,0,0,0,0.96969696969697,0.933333333333333,0.727272727272727,0.6,0,"southpaw"
"212525",25,25,165,160,173,160,112,112,33,30,2,1,22,23,"win_B",0,5,13,0,0,0,0,0,0.942857142857143,0.967741935483871,0.628571428571429,0.741935483870968,1,"orthodox"
"212528",24,30,160,160,160,163,112,112,27,27,1,11,20,15,"win_A",-6,0,-3,0,0,0,0,0,0.964285714285714,0.710526315789474,0.714285714285714,0.394736842105263,0,"southpaw"
"212530",24,27,160,160,160,157,112,112,25,24,1,11,18,8,"win_A",-3,0,3,0,0,0,0,0,0.961538461538462,0.685714285714286,0.692307692307692,0.228571428571429,0,"southpaw"
"212538",22,23,160,157,160,157,115,115,17,8,1,6,11,3,"win_A",-1,3,3,0,0,0,0,0,0.944444444444444,0.571428571428571,0.611111111111111,0.214285714285714,0,"southpaw"
"212559",22,33,168,168,163,157,131,130,14,54,0,8,9,35,"win_A",-11,0,6,1,0,0,0,0,1,0.870967741935484,0.642857142857143,0.564516129032258,0,"orthodox"
"212677",37,39,189,191,208,201,254,228,48,22,7,17,39,11,"win_A",-2,-2,7,26,1,1,1,0,0.872727272727273,0.564102564102564,0.709090909090909,0.282051282051282,0,"orthodox"
"212680",35,37,189,193,208,201,243,239,44,23,6,12,35,0,"win_A",-2,-4,7,4,1,1,0,0,0.88,0.657142857142857,0.7,0,0,"orthodox"
"212681",34,28,189,183,208,201,240,239,43,8,6,6,34,8,"win_A",6,6,7,1,0,0,0,0,0.877551020408163,0.571428571428571,0.693877551020408,0.571428571428571,0,"orthodox"
"212682",34,40,189,188,208,193,250,238,42,55,6,9,33,44,"win_A",-6,1,15,12,0,1,0,0,0.875,0.859375,0.6875,0.6875,0,"orthodox"
"212683",34,32,189,188,208,180,261,238,41,25,6,3,33,7,"win_A",2,1,28,23,0,0,1,0,0.872340425531915,0.892857142857143,0.702127659574468,0.25,0,"orthodox"
"212684",37,33,191,189,201,208,235,238,32,41,5,5,25,33,"win_A",4,2,-7,-3,1,0,0,0,0.864864864864865,0.891304347826087,0.675675675675676,0.717391304347826,0,"orthodox"
"212685",32,34,189,191,208,198,236,224,40,31,5,3,33,17,"win_A",-2,-2,10,12,0,0,0,0,0.888888888888889,0.911764705882353,0.733333333333333,0.5,0,"orthodox"
"212686",32,34,189,196,208,206,232,237,39,29,5,2,32,23,"win_A",-2,-7,2,-5,0,0,0,0,0.886363636363636,0.935483870967742,0.727272727272727,0.741935483870968,0,"orthodox"
"212689",31,33,189,183,208,198,257,227,36,22,5,11,29,16,"win_A",-2,6,10,30,0,0,1,0,0.878048780487805,0.666666666666667,0.707317073170732,0.484848484848485,0,"orthodox"
"212691",31,31,188,189,198,208,246,241,38,35,5,4,27,29,"win_A",0,-1,-10,5,0,0,0,0,0.883720930232558,0.897435897435897,0.627906976744186,0.743589743589744,0,"orthodox"
"212693",34,27,193,189,196,208,245,225,36,32,1,2,26,26,"win_B",7,4,-12,20,0,0,1,0,0.972972972972973,0.941176470588235,0.702702702702703,0.764705882352941,1,"southpaw"
"212695",26,30,189,191,208,201,234,236,31,17,1,2,26,12,"win_B",-4,-2,7,-2,0,0,0,0,0.96875,0.894736842105263,0.8125,0.631578947368421,1,"orthodox"
"212700",25,31,189,193,208,193,234,222,27,33,0,3,22,27,"win_A",-6,-4,15,12,0,0,0,0,1,0.916666666666667,0.814814814814815,0.75,0,"orthodox"
"212702",25,40,189,188,208,196,231,230,25,24,0,16,21,16,"win_A",-15,1,12,1,0,1,0,0,1,0.6,0.84,0.4,0,"orthodox"
"212704",29,24,191,189,201,208,230,225,28,23,1,0,19,20,"win_B",5,2,-7,5,0,0,0,0,0.96551724137931,1,0.655172413793103,0.869565217391304,1,"orthodox"
"212705",24,29,189,191,208,193,232,223,22,17,0,3,19,11,"win_A",-5,-2,15,9,0,0,0,0,1,0.85,0.863636363636364,0.55,0,"orthodox"
"212708",24,25,189,185,208,188,238,239,19,17,0,6,16,15,"win_A",-1,4,20,-1,0,0,0,0,1,0.739130434782609,0.842105263157895,0.652173913043478,0,"orthodox"
"212709",24,31,189,188,208,193,235,255,18,9,0,7,15,7,"win_A",-7,1,15,-20,0,0,0,1,1,0.5625,0.833333333333333,0.4375,0,"orthodox"
"212710",42,23,188,189,198,208,233,238,45,17,8,0,32,15,"win_B",19,-1,-10,-5,1,0,0,0,0.849056603773585,1,0.60377358490566,0.882352941176471,1,"orthodox"
"212711",23,32,189,185,208,183,234,237,16,14,0,31,14,9,"win_A",-9,4,25,-3,0,0,0,0,1,0.311111111111111,0.875,0.2,0,"orthodox"
"212715",23,29,189,191,208,203,233,245,12,18,0,8,11,16,"win_A",-6,-2,5,-12,0,0,0,0,1,0.692307692307692,0.916666666666667,0.615384615384615,0,"orthodox"
"212947",28,34,175,185,201,195,175,174,14,21,1,5,8,15,"win_A",-6,-10,6,1,0,0,0,0,0.933333333333333,0.807692307692308,0.533333333333333,0.576923076923077,0,"Unknown"
"213251",23,26,171,168,178,173,136,137,43,86,8,18,10,40,"win_A",-3,3,5,-1,0,0,0,0,0.843137254901961,0.826923076923077,0.196078431372549,0.384615384615385,0,"orthodox"
"213344",22,28,173,161,178,157,138,137,71,48,15,15,9,20,"win_B",-6,12,21,1,0,0,0,0,0.825581395348837,0.761904761904762,0.104651162790698,0.317460317460317,1,"Unknown"
"213435",25,24,168,163,173,165,110,108,16,13,2,5,9,10,"win_A",1,5,8,2,0,0,0,0,0.888888888888889,0.722222222222222,0.5,0.555555555555556,0,"southpaw"
"213521",46,29,190,180,201,183,258,212,43,18,10,0,24,11,"win_A",17,10,18,46,1,0,1,0,0.811320754716981,1,0.452830188679245,0.611111111111111,0,"orthodox"
"213522",46,39,190,188,201,193,253,327,42,16,10,13,23,13,"win_A",7,2,8,-74,1,1,0,1,0.807692307692308,0.551724137931034,0.442307692307692,0.448275862068966,0,"orthodox"
"213524",36,44,180,190,198,201,258,218,14,42,4,8,7,23,"win_A",-8,-10,-3,40,1,1,1,0,0.777777777777778,0.84,0.388888888888889,0.46,0,"southpaw"
"213527",30,37,191,190,196,201,240,258,21,40,0,7,9,21,"win_A",-7,1,-5,-18,0,1,0,1,1,0.851063829787234,0.428571428571429,0.446808510638298,0,"orthodox"
"213530",36,28,190,188,201,196,246,236,39,22,5,5,20,18,"win_B",8,2,5,10,1,0,0,0,0.886363636363636,0.814814814814815,0.454545454545455,0.666666666666667,1,"orthodox"
"213531",36,29,190,182,201,183,245,245,38,18,5,17,20,8,"win_A",7,8,18,0,1,0,0,0,0.883720930232558,0.514285714285714,0.465116279069767,0.228571428571429,0,"orthodox"
"213533",35,30,190,195,201,203,258,241,35,33,5,10,19,23,"win_A",5,-5,-2,17,1,0,1,0,0.875,0.767441860465116,0.475,0.534883720930233,0,"orthodox"
"213534",35,32,190,196,201,203,258,224,36,27,5,6,19,17,"win_A",3,-6,-2,34,1,0,1,0,0.878048780487805,0.818181818181818,0.463414634146341,0.515151515151515,0,"orthodox"
"213536",35,29,190,191,201,183,248,233,34,19,4,3,19,18,"win_B",6,-1,18,15,1,0,1,0,0.894736842105263,0.863636363636364,0.5,0.818181818181818,1,"orthodox"
"213538",34,28,190,196,201,208,234,233,32,14,4,0,19,10,"win_A",6,-6,-7,1,0,0,0,0,0.888888888888889,1,0.527777777777778,0.714285714285714,0,"orthodox"
"213539",34,35,190,188,201,196,233,230,31,18,4,8,19,13,"win_A",-1,2,5,3,0,1,0,0,0.885714285714286,0.692307692307692,0.542857142857143,0.5,0,"orthodox"
"213540",34,25,190,187,201,198,238,227,30,24,4,2,19,20,"win_A",9,3,3,11,0,0,0,0,0.882352941176471,0.923076923076923,0.558823529411765,0.769230769230769,0,"orthodox"
"213541",25,34,180,190,183,201,241,226,12,30,10,3,7,19,"win_A",-9,-10,-18,15,0,0,1,0,0.545454545454545,0.909090909090909,0.318181818181818,0.575757575757576,0,"orthodox"
"213545",31,32,190,178,201,191,238,204,26,21,2,9,15,17,"win_A",-1,12,10,34,0,0,1,0,0.928571428571429,0.7,0.535714285714286,0.566666666666667,0,"orthodox"
"213549",29,23,190,185,201,188,233,219,22,44,1,5,14,34,"win_A",6,5,13,14,0,0,0,0,0.956521739130435,0.897959183673469,0.608695652173913,0.693877551020408,0,"orthodox"
"213550",29,32,190,193,201,201,239,226,21,14,1,12,14,4,"win_A",-3,-3,0,13,0,0,0,0,0.954545454545455,0.538461538461538,0.636363636363636,0.153846153846154,0,"orthodox"
"213651",31,33,175,171,191,178,165,155,113,175,26,18,63,79,"win_A",-2,4,13,10,0,0,0,0,0.81294964028777,0.906735751295337,0.453237410071942,0.409326424870466,0,"orthodox"
"213759",25,28,171,173,178,178,151,150,74,64,10,30,32,6,"win_A",-3,-2,0,1,0,0,0,0,0.880952380952381,0.680851063829787,0.380952380952381,0.0638297872340425,0,"orthodox"
"214252",20,29,174,178,185,184,170,166,18,102,2,13,12,17,"win_A",-9,-4,1,4,0,0,0,0,0.9,0.88695652173913,0.6,0.147826086956522,0,"orthodox"
"214268",26,27,178,173,184,173,159,160,87,55,4,9,17,33,"win_A",-1,5,11,-1,0,0,0,0,0.956043956043956,0.859375,0.186813186813187,0.515625,0,"Unknown"
"214434",23,22,160,168,171,164,115,115,18,22,2,2,12,14,"win_A",1,-8,7,0,0,0,0,0,0.9,0.916666666666667,0.6,0.583333333333333,0,"orthodox"
"214437",21,30,168,163,164,168,112,112,17,36,2,5,11,17,"win_A",-9,5,-4,0,0,0,0,0,0.894736842105263,0.878048780487805,0.578947368421053,0.414634146341463,0,"orthodox"
"214440",33,20,161,168,168,164,112,112,47,15,1,1,20,11,"win_A",13,-7,4,0,0,0,0,0,0.979166666666667,0.9375,0.416666666666667,0.6875,0,"orthodox"
"214446",33,18,163,168,174,164,112,112,31,10,2,0,20,7,"win_A",15,-5,10,0,0,0,0,0,0.939393939393939,1,0.606060606060606,0.7,0,"orthodox"
"214904",27,32,174,173,174,180,140,140,11,32,0,3,9,14,"win_A",-5,1,-6,0,0,0,0,0,1,0.914285714285714,0.818181818181818,0.4,0,"southpaw"
"214942",33,32,170,185,170,183,144,135,29,30,0,2,17,25,"win_A",1,-15,-13,9,0,0,0,0,1,0.9375,0.586206896551724,0.78125,0,"orthodox"
"214948",29,24,170,165,170,164,126,126,23,18,0,0,17,13,"win_A",5,5,6,0,0,0,0,0,1,1,0.739130434782609,0.722222222222222,0,"orthodox"
"214953",27,32,170,168,170,170,126,124,18,30,0,4,14,26,"win_A",-5,2,0,2,0,0,0,0,1,0.882352941176471,0.777777777777778,0.764705882352941,0,"orthodox"
"214957",25,29,170,168,170,173,122,122,14,27,0,1,12,25,"win_A",-4,2,-3,0,0,0,0,0,1,0.964285714285714,0.857142857142857,0.892857142857143,0,"orthodox"
"214998",23,27,168,173,178,185,138,138,58,77,5,17,7,43,"win_A",-4,-5,-7,0,0,0,0,0,0.920634920634921,0.819148936170213,0.111111111111111,0.457446808510638,0,"orthodox"
"214999",24,23,171,168,175,178,137,136,47,56,6,5,17,7,"win_B",1,3,-3,1,0,0,0,0,0.886792452830189,0.918032786885246,0.320754716981132,0.114754098360656,1,"orthodox"
"215027",19,26,168,168,178,165,134,137,29,60,2,13,6,20,"win_A",-7,0,13,-3,0,0,0,0,0.935483870967742,0.821917808219178,0.193548387096774,0.273972602739726,0,"orthodox"
"215293",32,36,191,188,208,196,240,244,36,20,4,11,35,14,"win_A",-4,3,12,-4,0,1,0,0,0.9,0.645161290322581,0.875,0.451612903225806,0,"orthodox"
"215296",30,29,191,195,208,203,234,232,33,31,3,7,32,22,"win_A",1,-4,5,2,0,0,0,0,0.916666666666667,0.815789473684211,0.888888888888889,0.578947368421053,0,"orthodox"
"215301",25,29,191,185,208,203,226,214,28,36,2,11,27,27,"win_A",-4,6,5,12,0,0,0,0,0.933333333333333,0.765957446808511,0.9,0.574468085106383,0,"orthodox"
"215309",22,31,191,193,208,208,222,231,21,13,0,1,21,11,"win_B",-9,-2,0,-9,0,0,0,0,1,0.928571428571429,1,0.785714285714286,1,"orthodox"
"215794",31,27,177,183,185,196,168,165,39,31,2,2,32,29,"win_A",4,-6,-11,3,0,0,0,0,0.951219512195122,0.939393939393939,0.780487804878049,0.878787878787879,0,"orthodox"
"215801",28,25,177,183,185,178,163,162,31,18,2,2,28,8,"win_A",3,-6,7,1,0,0,0,0,0.939393939393939,0.9,0.848484848484849,0.4,0,"orthodox"
"215963",22,29,178,170,178,178,133,132,76,33,2,3,65,29,"win_B",-7,8,0,1,0,0,0,0,0.974358974358974,0.916666666666667,0.833333333333333,0.805555555555556,1,"orthodox"
"215974",25,27,170,175,178,175,136,136,25,15,0,0,23,8,"win_B",-2,-5,3,0,0,0,0,0,1,1,0.92,0.533333333333333,1,"southpaw"
"216182",24,22,182,182,187,187,170,168,78,79,13,8,43,27,"win_A",2,0,0,2,0,0,0,0,0.857142857142857,0.908045977011494,0.472527472527473,0.310344827586207,0,"southpaw"
"216183",22,23,182,182,187,187,168,170,78,78,8,12,27,43,"win_A",-1,0,0,-2,0,0,0,0,0.906976744186046,0.866666666666667,0.313953488372093,0.477777777777778,0,"Unknown"
"216189",21,23,182,182,187,187,173,164,74,72,7,11,25,43,"win_A",-2,0,0,9,0,0,0,0,0.91358024691358,0.867469879518072,0.308641975308642,0.518072289156627,0,"Unknown"
"216205",21,22,182,182,187,187,166,172,68,56,4,11,23,35,"win_B",-1,0,0,-6,0,0,0,0,0.944444444444444,0.835820895522388,0.319444444444444,0.522388059701492,1,"Unknown"
"216208",30,22,180,182,185,187,177,182,67,53,25,11,22,34,"win_B",8,-2,-2,-5,0,0,0,0,0.728260869565217,0.828125,0.239130434782609,0.53125,1,"orthodox"
"216210",20,22,182,182,187,187,171,165,62,51,4,10,22,33,"win_A",-2,0,0,6,0,0,0,0,0.939393939393939,0.836065573770492,0.333333333333333,0.540983606557377,0,"Unknown"
"216228",19,21,182,182,187,187,167,164,45,35,3,8,15,23,"win_A",-2,0,0,3,0,0,0,0,0.9375,0.813953488372093,0.3125,0.534883720930233,0,"Unknown"
"216282",26,30,178,178,180,176,160,159,17,29,0,0,12,20,"win_A",-4,0,4,1,0,0,0,0,1,1,0.705882352941177,0.689655172413793,0,"orthodox"
"216288",25,29,178,176,180,177,149,155,11,21,0,15,10,10,"win_A",-4,2,3,-6,0,0,0,0,1,0.583333333333333,0.909090909090909,0.277777777777778,0,"orthodox"
"216615",27,28,175,178,188,185,140,140,24,28,2,0,13,11,"win_A",-1,-3,3,0,0,0,0,0,0.923076923076923,1,0.5,0.392857142857143,0,"orthodox"
"216617",26,34,175,175,188,180,143,143,22,30,2,8,12,17,"win_A",-8,0,8,0,0,0,0,0,0.916666666666667,0.789473684210526,0.5,0.447368421052632,0,"orthodox"
"216620",25,28,175,173,188,180,140,140,20,25,1,0,12,9,"win_A",-3,2,8,0,0,0,0,0,0.952380952380952,1,0.571428571428571,0.36,0,"orthodox"
"216623",23,28,175,168,188,175,139,139,17,26,1,0,11,14,"win_A",-5,7,13,0,0,0,0,0,0.944444444444444,1,0.611111111111111,0.538461538461538,0,"orthodox"
"216642",24,42,183,188,193,206,238,230,21,58,4,16,13,48,"win_A",-18,-5,-13,8,0,1,0,0,0.84,0.783783783783784,0.52,0.648648648648649,0,"southpaw"
"216644",28,41,191,188,206,206,253,230,21,57,0,15,14,47,"win_A",-13,3,0,23,0,1,1,0,1,0.791666666666667,0.666666666666667,0.652777777777778,0,"orthodox"
"216645",41,27,188,183,206,203,247,246,56,26,15,5,46,19,"win_A",14,5,3,1,1,0,0,0,0.788732394366197,0.838709677419355,0.647887323943662,0.612903225806452,0,"orthodox"
"216646",41,35,188,201,206,208,256,243,56,29,14,5,46,27,"win_B",6,-13,-2,13,1,1,0,0,0.8,0.852941176470588,0.657142857142857,0.794117647058823,1,"orthodox"
"216647",40,28,188,180,206,193,252,217,55,14,13,13,45,14,"win_B",12,8,13,35,1,0,1,0,0.808823529411765,0.518518518518518,0.661764705882353,0.518518518518518,1,"orthodox"
"216649",39,27,188,191,206,198,244,217,54,18,12,0,44,12,"win_B",12,-3,8,27,1,0,1,0,0.818181818181818,1,0.666666666666667,0.666666666666667,1,"orthodox"
"216651",39,41,188,185,206,196,243,209,52,10,12,23,43,4,"win_A",-2,3,10,34,1,1,1,0,0.8125,0.303030303030303,0.671875,0.121212121212121,0,"orthodox"
"216666",34,26,188,187,206,198,236,232,38,27,11,3,30,23,"win_B",8,1,8,4,0,0,0,0,0.775510204081633,0.9,0.612244897959184,0.766666666666667,1,"orthodox"
"216671",33,39,188,193,206,208,230,229,34,33,10,9,27,26,"win_A",-6,-5,-2,1,0,1,0,0,0.772727272727273,0.785714285714286,0.613636363636364,0.619047619047619,0,"orthodox"
"216672",33,28,188,191,206,208,228,239,34,25,9,3,27,18,"win_B",5,-3,-2,-11,0,0,0,0,0.790697674418605,0.892857142857143,0.627906976744186,0.642857142857143,1,"orthodox"
"216675",32,27,188,185,206,183,230,236,31,10,9,16,24,6,"win_A",5,3,23,-6,0,0,0,0,0.775,0.384615384615385,0.6,0.230769230769231,0,"orthodox"
"216676",29,31,185,188,188,206,218,219,10,31,9,8,8,24,"win_A",-2,-3,-18,-1,0,0,0,0,0.526315789473684,0.794871794871795,0.421052631578947,0.615384615384615,0,"orthodox"
"216683",28,23,188,185,206,188,229,211,25,38,6,4,19,28,"win_A",5,3,18,18,0,0,1,0,0.806451612903226,0.904761904761905,0.612903225806452,0.666666666666667,0,"orthodox"
"216684",27,25,188,185,206,188,242,221,25,5,5,5,19,5,"win_B",2,3,18,21,0,0,1,0,0.833333333333333,0.5,0.633333333333333,0.5,1,"orthodox"
"216686",25,27,192,188,211,206,236,230,20,24,3,4,15,19,"win_A",-2,4,5,6,0,0,0,0,0.869565217391304,0.857142857142857,0.652173913043478,0.678571428571429,0,"orthodox"
"216690",24,26,188,188,206,198,227,216,21,23,1,2,17,11,"win_A",-2,0,8,11,0,0,0,0,0.954545454545455,0.92,0.772727272727273,0.44,0,"orthodox"
"216695",23,32,188,187,206,203,231,230,17,28,0,9,15,18,"win_A",-9,1,3,1,0,0,0,0,1,0.756756756756757,0.882352941176471,0.486486486486487,0,"orthodox"
"216967",24,30,174,170,188,173,158,160,21,18,0,4,21,12,"win_A",-6,4,15,-2,0,0,0,0,1,0.818181818181818,1,0.545454545454545,0,"orthodox"
"216969",23,26,174,164,188,173,154,154,19,18,0,3,19,11,"win_A",-3,10,15,0,0,0,0,0,1,0.857142857142857,1,0.523809523809524,0,"orthodox"
"217027",38,41,177,188,179,203,198,195,51,42,3,14,28,29,"win_B",-3,-11,-24,3,1,1,0,0,0.944444444444444,0.75,0.518518518518518,0.517857142857143,1,"orthodox"
"217029",25,40,183,188,191,203,200,196,16,41,0,13,8,29,"win_A",-15,-5,-12,4,0,1,0,0,1,0.759259259259259,0.5,0.537037037037037,0,"southpaw"
"217031",28,40,185,188,191,203,196,191,21,40,1,12,11,28,"win_A",-12,-3,-12,5,0,1,0,0,0.954545454545455,0.769230769230769,0.5,0.538461538461538,0,"orthodox"
"217044",34,36,188,177,203,188,200,200,30,28,5,8,22,14,"win_A",-2,11,15,0,0,1,0,0,0.857142857142857,0.777777777777778,0.628571428571429,0.388888888888889,0,"orthodox"
"217045",34,35,188,180,203,183,203,218,29,33,4,13,21,17,"win_A",-1,8,20,-15,0,1,0,1,0.878787878787879,0.717391304347826,0.636363636363636,0.369565217391304,0,"orthodox"
"217047",30,33,182,188,193,203,188,190,26,27,4,4,15,20,"win_B",-3,-6,-10,-2,0,0,0,0,0.866666666666667,0.870967741935484,0.5,0.645161290322581,1,"orthodox"
"217050",30,28,188,183,203,180,195,195,24,8,4,8,18,3,"win_A",2,5,23,0,0,0,0,0,0.857142857142857,0.5,0.642857142857143,0.1875,0,"orthodox"
"217054",29,34,188,188,203,196,199,192,20,9,1,9,15,5,"win_A",-5,0,7,7,0,0,0,0,0.952380952380952,0.5,0.714285714285714,0.277777777777778,0,"orthodox"
"217081",20,23,168,178,180,188,162,160,34,49,4,11,20,42,"win_A",-3,-10,-8,2,0,0,0,0,0.894736842105263,0.816666666666667,0.526315789473684,0.7,0,"orthodox"
"217083",19,23,168,178,180,188,159,160,31,49,4,9,19,42,"win_A",-4,-10,-8,-1,0,0,0,0,0.885714285714286,0.844827586206897,0.542857142857143,0.724137931034483,0,"orthodox"
"217084",19,22,168,174,180,180,159,159,29,18,4,5,17,12,"win_A",-3,-6,0,0,0,0,0,0,0.878787878787879,0.782608695652174,0.515151515151515,0.521739130434783,0,"orthodox"
"217094",18,34,168,171,180,165,153,147,19,22,1,13,12,13,"win_A",-16,-3,15,6,0,0,0,0,0.95,0.628571428571429,0.6,0.371428571428571,0,"orthodox"
"217097",18,34,168,171,180,165,147,146,17,21,0,12,10,13,"win_B",-16,-3,15,1,0,0,0,0,1,0.636363636363636,0.588235294117647,0.393939393939394,1,"orthodox"
"217127",34,25,168,173,171,170,128,127,54,17,16,4,40,9,"win_A",9,-5,1,1,0,0,0,0,0.771428571428571,0.80952380952381,0.571428571428571,0.428571428571429,0,"orthodox"
"217129",26,32,168,168,177,171,128,128,32,54,5,12,13,40,"win_A",-6,0,6,0,0,0,0,0,0.864864864864865,0.818181818181818,0.351351351351351,0.606060606060606,0,"orthodox"
"217132",26,27,168,163,171,165,125,126,52,43,7,1,40,30,"win_A",-1,5,6,-1,0,0,0,0,0.88135593220339,0.977272727272727,0.677966101694915,0.681818181818182,0,"orthodox"
"217135",26,30,168,168,171,170,127,127,49,20,7,1,38,14,"win_A",-4,0,1,0,0,0,0,0,0.875,0.952380952380952,0.678571428571429,0.666666666666667,0,"orthodox"
"217138",25,27,168,162,171,163,127,125,46,20,7,6,36,11,"win_A",-2,6,8,2,0,0,0,0,0.867924528301887,0.769230769230769,0.679245283018868,0.423076923076923,0,"orthodox"
"217141",25,27,168,183,171,182,130,129,43,25,7,5,34,15,"win_A",-2,-15,-11,1,0,0,0,0,0.86,0.833333333333333,0.68,0.5,0,"orthodox"
"217143",24,25,168,165,171,180,128,129,41,40,6,18,32,31,"win_A",-1,3,-9,-1,0,0,0,0,0.872340425531915,0.689655172413793,0.680851063829787,0.53448275862069,0,"orthodox"
"217146",20,22,173,168,173,171,126,126,32,39,2,5,23,31,"win_A",-2,5,2,0,0,0,0,0,0.941176470588235,0.886363636363636,0.676470588235294,0.704545454545455,0,"orthodox"
"217153",21,28,168,168,171,161,122,122,31,30,5,7,24,21,"win_A",-7,0,10,0,0,0,0,0,0.861111111111111,0.810810810810811,0.666666666666667,0.567567567567568,0,"orthodox"
"217814",25,24,178,178,184,183,157,158,64,115,16,2,18,52,"win_B",1,0,1,-1,0,0,0,0,0.8,0.982905982905983,0.225,0.444444444444444,1,"Unknown"
"217815",30,24,175,178,191,183,157,153,111,114,25,2,61,52,"win_B",6,-3,8,4,0,0,0,0,0.816176470588235,0.982758620689655,0.448529411764706,0.448275862068966,1,"orthodox"
"217823",24,23,178,178,184,183,161,162,60,105,12,2,17,49,"win_B",1,0,1,-1,0,0,0,0,0.833333333333333,0.981308411214953,0.236111111111111,0.457943925233645,1,"Unknown"
"217927",30,37,188,182,183,188,228,218,27,23,1,12,22,12,"win_A",-7,6,-5,10,0,1,0,0,0.964285714285714,0.657142857142857,0.785714285714286,0.342857142857143,0,"orthodox"
"217928",32,37,193,182,216,188,228,226,24,23,5,11,19,12,"win_A",-5,11,28,2,0,1,0,0,0.827586206896552,0.676470588235294,0.655172413793103,0.352941176470588,0,"orthodox"
"217931",23,34,187,182,198,188,221,223,12,22,0,8,10,11,"win_A",-11,5,10,-2,0,0,0,0,1,0.733333333333333,0.833333333333333,0.366666666666667,0,"orthodox"
"217932",29,34,196,182,203,188,236,224,16,22,3,7,11,11,"win_A",-5,14,15,12,0,0,0,0,0.842105263157895,0.758620689655172,0.578947368421053,0.379310344827586,0,"orthodox"
"217933",28,34,185,182,196,188,227,210,11,22,0,6,9,11,"win_A",-6,3,8,17,0,0,1,0,1,0.785714285714286,0.818181818181818,0.392857142857143,0,"orthodox"
"217971",32,19,180,178,188,185,195,185,72,45,46,12,17,16,"win_A",13,2,3,10,0,0,0,0,0.610169491525424,0.789473684210526,0.144067796610169,0.280701754385965,0,"orthodox"
"217972",22,31,187,180,222,188,193,181,48,72,13,45,15,17,"win_A",-9,7,34,12,0,0,0,0,0.786885245901639,0.615384615384615,0.245901639344262,0.145299145299145,0,"Unknown"
"217973",22,31,187,180,222,188,195,185,44,71,13,44,15,17,"win_A",-9,7,34,10,0,0,0,0,0.771929824561403,0.617391304347826,0.263157894736842,0.147826086956522,0,"Unknown"
"217978",30,28,180,183,188,201,210,206,69,48,41,38,16,16,"win_A",2,-3,-13,4,0,0,0,0,0.627272727272727,0.558139534883721,0.145454545454545,0.186046511627907,0,"orthodox"
"217979",21,30,187,180,222,188,198,182,38,68,12,40,13,16,"win_A",-9,7,34,16,0,0,1,0,0.76,0.62962962962963,0.26,0.148148148148148,0,"Unknown"
"217982",29,21,180,180,188,188,196,200,66,41,39,18,16,22,"win_A",8,0,0,-4,0,0,0,0,0.628571428571429,0.694915254237288,0.152380952380952,0.372881355932203,0,"orthodox"
"217986",21,28,175,180,183,188,185,220,31,61,9,37,18,16,"win_B",-7,-5,-5,-35,0,0,0,1,0.775,0.622448979591837,0.45,0.163265306122449,1,"orthodox"
"217994",22,27,193,180,209,188,195,193,52,57,6,30,24,16,"win_A",-5,13,21,2,0,0,0,0,0.896551724137931,0.655172413793103,0.413793103448276,0.183908045977011,0,"orthodox"
"218000",26,21,180,188,188,191,195,200,53,26,28,8,16,8,"win_A",5,-8,-3,-5,0,0,0,0,0.654320987654321,0.764705882352941,0.197530864197531,0.235294117647059,0,"orthodox"
"218008",26,28,180,179,188,203,190,190,49,70,23,35,15,48,"win_A",-2,1,-15,0,0,0,0,0,0.680555555555556,0.666666666666667,0.208333333333333,0.457142857142857,0,"orthodox"
"218011",25,28,180,179,188,203,196,196,48,70,21,34,15,48,"win_A",-3,1,-15,0,0,0,0,0,0.695652173913043,0.673076923076923,0.217391304347826,0.461538461538462,0,"orthodox"
"218020",24,20,180,183,188,193,190,175,39,47,19,7,15,14,"win_A",4,-3,-5,15,0,0,1,0,0.672413793103448,0.87037037037037,0.258620689655172,0.259259259259259,0,"orthodox"
"218239",24,23,171,173,188,179,134,134,34,26,7,3,11,14,"win_A",1,-2,9,0,0,0,0,0,0.829268292682927,0.896551724137931,0.268292682926829,0.482758620689655,0,"Unknown"
"218363",30,31,175,173,175,178,152,148,58,85,37,17,28,59,"win_A",-1,2,-3,4,0,0,0,0,0.610526315789474,0.833333333333333,0.294736842105263,0.57843137254902,0,"orthodox"
"218413",22,25,173,173,178,185,135,135,38,67,9,11,25,40,"win_A",-3,0,-7,0,0,0,0,0,0.808510638297872,0.858974358974359,0.531914893617021,0.512820512820513,0,"orthodox"
"218709",36,27,179,173,181,178,153,153,44,29,3,1,27,15,"win_A",9,6,3,0,1,0,0,0,0.936170212765957,0.966666666666667,0.574468085106383,0.5,0,"orthodox"
"218710",32,35,175,179,175,181,154,154,26,44,5,2,22,27,"win_A",-3,-4,-6,0,0,1,0,0,0.838709677419355,0.956521739130435,0.709677419354839,0.58695652173913,0,"orthodox"
"218727",27,27,179,178,181,183,146,146,24,18,1,4,17,7,"win_A",0,1,-2,0,0,0,0,0,0.96,0.818181818181818,0.68,0.318181818181818,0,"orthodox"
"218742",24,20,179,179,181,175,140,140,10,16,0,12,7,9,"win_A",4,0,6,0,0,0,0,0,1,0.571428571428571,0.7,0.321428571428571,0,"orthodox"
"218771",20,21,185,187,193,191,185,190,7,6,1,1,7,5,"win_A",-1,-2,2,-5,0,0,0,0,0.875,0.857142857142857,0.875,0.714285714285714,0,"orthodox"
"218803",34,24,185,193,193,208,199,222,39,48,10,6,23,29,"win_B",10,-8,-15,-23,0,0,0,1,0.795918367346939,0.888888888888889,0.469387755102041,0.537037037037037,1,"orthodox"
"218817",31,26,185,193,193,203,198,207,28,36,6,8,13,19,"win_A",5,-8,-10,-9,0,0,0,0,0.823529411764706,0.818181818181818,0.382352941176471,0.431818181818182,0,"orthodox"
"218860",26,33,179,178,203,193,166,190,65,119,24,16,44,51,"win_B",-7,1,10,-24,0,0,0,1,0.730337078651685,0.881481481481482,0.49438202247191,0.377777777777778,1,"Unknown"
"218900",24,31,179,178,203,193,167,192,57,71,16,9,41,29,"win_B",-7,1,10,-25,0,0,0,1,0.780821917808219,0.8875,0.561643835616438,0.3625,1,"Unknown"
"219001",26,29,178,165,185,175,130,129,26,28,2,5,21,20,"win_A",-3,13,10,1,0,0,0,0,0.928571428571429,0.848484848484849,0.75,0.606060606060606,0,"orthodox"
"219004",26,28,165,163,175,170,128,128,25,23,3,3,18,14,"win_A",-2,2,5,0,0,0,0,0,0.892857142857143,0.884615384615385,0.642857142857143,0.538461538461538,0,"orthodox"
"219006",25,35,165,180,175,185,127,128,23,36,1,9,16,28,"win_A",-10,-15,-10,-1,0,1,0,0,0.958333333333333,0.8,0.666666666666667,0.622222222222222,0,"orthodox"
"219007",25,25,172,165,175,175,126,126,35,23,5,0,21,16,"win_A",0,7,0,0,0,0,0,0,0.875,1,0.525,0.695652173913043,0,"orthodox"
"219009",24,30,165,175,175,170,126,125,21,38,0,6,14,24,"win_A",-6,-10,5,1,0,0,0,0,1,0.863636363636364,0.666666666666667,0.545454545454545,0,"orthodox"
"219010",24,27,165,168,175,178,126,126,20,25,0,0,14,15,"win_A",-3,-3,-3,0,0,0,0,0,1,1,0.7,0.6,0,"orthodox"
"219014",23,27,165,169,175,168,127,126,15,22,0,3,11,13,"win_A",-4,-4,7,1,0,0,0,0,1,0.88,0.733333333333333,0.52,0,"orthodox"
"219017",22,36,165,170,175,178,128,126,12,41,0,8,9,22,"win_A",-14,-5,-3,2,0,1,0,0,1,0.836734693877551,0.75,0.448979591836735,0,"orthodox"
"219018",22,33,165,170,175,160,129,130,11,18,0,10,8,8,"win_A",-11,-5,15,-1,0,0,0,0,1,0.642857142857143,0.727272727272727,0.285714285714286,0,"orthodox"
"219019",22,31,165,166,175,175,124,124,10,15,0,8,7,8,"win_A",-9,-1,0,0,0,0,0,0,1,0.652173913043478,0.7,0.347826086956522,0,"orthodox"
"219020",22,28,165,163,175,160,126,128,9,18,0,12,6,6,"win_A",-6,2,15,-2,0,0,0,0,1,0.6,0.666666666666667,0.2,0,"orthodox"
"219024",21,26,165,169,175,168,126,125,4,5,0,2,3,3,"win_A",-5,-4,7,1,0,0,0,0,1,0.714285714285714,0.75,0.428571428571429,0,"orthodox"
"219036",29,18,159,163,173,170,117,116,38,6,9,1,25,2,"win_A",11,-4,3,1,0,0,0,0,0.808510638297872,0.857142857142857,0.531914893617021,0.285714285714286,0,"southpaw"
"219294",23,24,182,166,183,183,157,160,12,45,6,13,8,22,"win_B",-1,16,0,-3,0,0,0,0,0.666666666666667,0.775862068965517,0.444444444444444,0.379310344827586,1,"Unknown"
"220103",23,24,165,170,173,170,138,136,72,45,5,11,38,19,"win_A",-1,-5,3,2,0,0,0,0,0.935064935064935,0.803571428571429,0.493506493506494,0.339285714285714,0,"orthodox"
"220300",24,24,178,183,185,178,160,160,25,17,0,0,15,8,"win_A",0,-5,7,0,0,0,0,0,1,1,0.6,0.470588235294118,0,"orthodox"
"220301",24,28,178,179,185,187,163,159,23,11,0,3,13,8,"win_A",-4,-1,-2,4,0,0,0,0,1,0.785714285714286,0.565217391304348,0.571428571428571,0,"orthodox"
"220423",25,29,173,179,182,193,147,147,36,57,11,10,22,35,"win_A",-4,-6,-11,0,0,0,0,0,0.765957446808511,0.850746268656716,0.468085106382979,0.522388059701492,0,"Unknown"
"220447",20,28,173,170,182,170,148,146,17,117,6,33,13,57,"win_A",-8,3,12,2,0,0,0,0,0.739130434782609,0.78,0.565217391304348,0.38,0,"Unknown"
"220473",26,31,178,175,184,191,152,170,64,121,20,27,18,66,"win_A",-5,3,-7,-18,0,0,0,1,0.761904761904762,0.817567567567568,0.214285714285714,0.445945945945946,0,"Unknown"
"220479",23,31,173,175,193,191,154,156,113,116,34,26,63,64,"win_A",-8,-2,2,-2,0,0,0,0,0.768707482993197,0.816901408450704,0.428571428571429,0.450704225352113,0,"southpaw"
"220496",27,23,175,177,191,180,158,162,101,71,21,15,53,41,"win_A",4,-2,11,-4,0,0,0,0,0.827868852459016,0.825581395348837,0.434426229508197,0.476744186046512,0,"orthodox"
"221043",30,24,157,173,168,180,132,130,66,57,24,9,36,11,"win_B",6,-16,-12,2,0,0,0,0,0.733333333333333,0.863636363636364,0.4,0.166666666666667,1,"Unknown"
"221058",29,23,157,173,168,180,128,126,59,50,16,4,34,9,"win_B",6,-16,-12,2,0,0,0,0,0.786666666666667,0.925925925925926,0.453333333333333,0.166666666666667,1,"Unknown"
"221075",25,26,165,157,174,168,127,125,27,47,9,7,7,31,"win_A",-1,8,6,2,0,0,0,0,0.75,0.87037037037037,0.194444444444444,0.574074074074074,0,"orthodox"
"221089",27,25,157,157,183,168,128,130,63,36,16,4,25,27,"win_B",2,0,15,-2,0,0,0,0,0.79746835443038,0.9,0.316455696202532,0.675,1,"orthodox"
"221462",22,29,175,168,185,168,153,158,41,87,2,58,23,41,"win_A",-7,7,17,-5,0,0,0,0,0.953488372093023,0.6,0.534883720930233,0.282758620689655,0,"orthodox"
"221463",22,29,175,168,185,168,154,157,40,84,2,55,23,40,"win_A",-7,7,17,-3,0,0,0,0,0.952380952380952,0.60431654676259,0.547619047619048,0.287769784172662,0,"orthodox"
"221592",31,28,175,184,175,178,155,160,32,23,10,12,17,13,"win_A",3,-9,-3,-5,0,0,0,0,0.761904761904762,0.657142857142857,0.404761904761905,0.371428571428571,0,"Unknown"
"221602",29,31,175,178,175,175,156,149,25,26,7,9,13,18,"win_A",-2,-3,0,7,0,0,0,0,0.78125,0.742857142857143,0.40625,0.514285714285714,0,"Unknown"
"221605",28,26,175,174,175,173,155,151,24,19,5,11,13,16,"win_A",2,1,2,4,0,0,0,0,0.827586206896552,0.633333333333333,0.448275862068966,0.533333333333333,0,"Unknown"
"221606",28,29,175,178,175,175,159,154,23,19,5,5,13,14,"win_A",-1,-3,0,5,0,0,0,0,0.821428571428571,0.791666666666667,0.464285714285714,0.583333333333333,0,"Unknown"
"221610",33,27,177,175,183,175,156,155,22,19,22,5,12,12,"win_B",6,2,8,1,0,0,0,0,0.5,0.791666666666667,0.272727272727273,0.5,1,"Unknown"
"221613",27,25,175,174,175,173,154,152,16,19,4,9,10,16,"win_A",2,1,2,2,0,0,0,0,0.8,0.678571428571429,0.5,0.571428571428571,0,"Unknown"
"221614",27,28,175,178,175,175,157,157,15,14,4,2,10,11,"win_A",-1,-3,0,0,0,0,0,0,0.789473684210526,0.875,0.526315789473684,0.6875,0,"Unknown"
"221617",31,26,177,175,183,175,154,152,19,13,19,3,11,9,"win_A",5,2,8,2,0,0,0,0,0.5,0.8125,0.289473684210526,0.5625,0,"Unknown"
"221618",25,25,178,175,191,175,156,172,8,11,0,3,5,9,"win_B",0,3,16,-16,0,0,0,1,1,0.785714285714286,0.625,0.642857142857143,1,"orthodox"
"221799",23,28,178,175,180,185,154,154,10,40,0,1,7,19,"win_A",-5,3,-5,0,0,0,0,0,1,0.975609756097561,0.7,0.463414634146341,0,"orthodox"
"222016",34,33,182,178,196,178,168,167,47,40,2,4,37,18,"win_A",1,4,18,1,0,0,0,0,0.959183673469388,0.909090909090909,0.755102040816326,0.409090909090909,0,"southpaw"
"222023",29,27,182,175,196,183,168,168,40,17,1,5,34,6,"win_A",2,7,13,0,0,0,0,0,0.975609756097561,0.772727272727273,0.829268292682927,0.272727272727273,0,"southpaw"
"222048",23,22,182,173,196,173,171,168,13,7,1,12,11,5,"win_A",1,9,23,3,0,0,0,0,0.928571428571429,0.368421052631579,0.785714285714286,0.263157894736842,0,"southpaw"
"222323",29,34,173,163,173,157,136,137,48,23,5,10,33,11,"win_A",-5,10,16,-1,0,0,0,0,0.905660377358491,0.696969696969697,0.622641509433962,0.333333333333333,0,"orthodox"
"222324",28,34,173,170,173,175,138,138,46,17,4,6,32,9,"win_A",-6,3,-2,0,0,0,0,0,0.92,0.739130434782609,0.64,0.391304347826087,0,"orthodox"
"222333",23,23,173,173,173,180,133,135,37,14,4,4,26,6,"win_A",0,0,-7,-2,0,0,0,0,0.902439024390244,0.777777777777778,0.634146341463415,0.333333333333333,0,"orthodox"
"222374",44,37,188,203,208,213,238,253,53,34,9,5,37,28,"win_A",7,-15,-5,-15,1,1,0,1,0.854838709677419,0.871794871794872,0.596774193548387,0.717948717948718,0,"orthodox"
"222376",44,34,188,184,208,179,242,246,51,11,9,2,36,11,"win_A",10,4,29,-4,1,0,0,0,0.85,0.846153846153846,0.6,0.846153846153846,0,"orthodox"
"222377",32,42,191,188,193,208,236,253,27,50,3,8,15,36,"win_B",-10,3,-15,-17,0,1,0,1,0.9,0.862068965517241,0.5,0.620689655172414,1,"orthodox"
"222378",41,50,188,185,208,196,257,223,49,12,8,40,36,5,"win_A",-9,3,12,34,1,1,1,0,0.859649122807018,0.230769230769231,0.631578947368421,0.0961538461538462,0,"orthodox"
"222379",41,30,188,193,208,208,259,246,48,12,8,4,35,8,"win_A",11,-5,0,13,1,0,0,0,0.857142857142857,0.75,0.625,0.5,0,"orthodox"
"222380",41,40,188,183,208,201,249,220,47,27,8,8,34,21,"win_A",1,5,7,29,1,1,1,0,0.854545454545454,0.771428571428571,0.618181818181818,0.6,0,"orthodox"
"222387",39,36,188,193,208,203,233,220,41,20,7,3,31,17,"win_B",3,-5,5,13,1,1,0,0,0.854166666666667,0.869565217391304,0.645833333333333,0.739130434782609,1,"orthodox"
"222390",36,39,188,201,208,218,238,237,38,40,7,1,28,26,"win_A",-3,-13,-10,1,1,1,0,0,0.844444444444444,0.975609756097561,0.622222222222222,0.634146341463415,0,"orthodox"
"222392",35,27,188,185,208,196,248,228,36,10,7,10,27,8,"win_A",8,3,12,20,1,0,1,0,0.837209302325581,0.5,0.627906976744186,0.4,0,"orthodox"
"222393",35,30,188,193,208,196,220,278,35,18,7,2,26,8,"win_A",5,-5,12,-58,1,0,0,1,0.833333333333333,0.9,0.619047619047619,0.4,0,"orthodox"
"222395",34,33,188,188,208,188,246,262,33,17,7,14,24,9,"win_A",1,0,20,-16,0,0,0,1,0.825,0.548387096774194,0.6,0.290322580645161,0,"orthodox"
"222398",32,33,188,180,208,185,235,215,30,11,7,15,22,9,"win_A",-1,8,23,20,0,0,1,0,0.810810810810811,0.423076923076923,0.594594594594595,0.346153846153846,0,"orthodox"
"222410",34,26,188,188,196,208,231,231,17,17,5,4,12,11,"win_B",8,0,-12,0,0,0,0,0,0.772727272727273,0.80952380952381,0.545454545454545,0.523809523809524,1,"orthodox"
"222412",25,24,188,187,208,198,221,221,15,18,4,0,9,15,"win_A",1,1,10,0,0,0,0,0,0.789473684210526,1,0.473684210526316,0.833333333333333,0,"orthodox"
"222413",25,22,188,180,208,183,232,228,14,5,3,6,9,1,"win_A",3,8,25,4,0,0,0,0,0.823529411764706,0.454545454545455,0.529411764705882,0.0909090909090909,0,"orthodox"
"222495",20,28,192,193,204,201,196,186,11,15,1,8,8,12,"win_A",-8,-1,3,10,0,0,0,0,0.916666666666667,0.652173913043478,0.666666666666667,0.521739130434783,0,"orthodox"
"222516",28,32,173,175,183,180,154,155,26,59,10,16,18,24,"win_B",-4,-2,3,-1,0,0,0,0,0.722222222222222,0.786666666666667,0.5,0.32,1,"orthodox"
"222526",25,26,178,173,185,183,158,161,36,17,1,3,7,11,"win_A",-1,5,2,-3,0,0,0,0,0.972972972972973,0.85,0.189189189189189,0.55,0,"orthodox"
"222780",36,38,188,187,191,188,178,184,35,31,3,11,22,20,"win_A",-2,1,3,-6,1,1,0,0,0.921052631578947,0.738095238095238,0.578947368421053,0.476190476190476,0,"southpaw"
"222781",37,26,187,185,188,193,190,190,31,15,10,0,20,12,"win_B",11,2,-5,0,1,0,0,0,0.75609756097561,1,0.48780487804878,0.8,1,"orthodox"
"222799",25,25,187,187,192,188,177,178,8,18,2,1,7,12,"win_B",0,0,4,-1,0,0,0,0,0.8,0.947368421052632,0.7,0.631578947368421,1,"orthodox"
"222800",24,33,187,183,188,183,175,175,17,34,0,2,12,28,"win_A",-9,4,5,0,0,0,0,0,1,0.944444444444444,0.705882352941177,0.777777777777778,0,"orthodox"
"222819",32,21,172,178,175,175,147,146,58,17,8,2,34,10,"win_A",11,-6,0,1,0,0,0,0,0.878787878787879,0.894736842105263,0.515151515151515,0.526315789473684,0,"orthodox"
"222820",31,34,172,172,175,178,141,140,56,29,7,6,33,23,"win_A",-3,0,-3,1,0,0,0,0,0.888888888888889,0.828571428571429,0.523809523809524,0.657142857142857,0,"orthodox"
"222822",30,24,172,175,175,173,135,135,50,31,7,5,32,19,"win_A",6,-3,2,0,0,0,0,0,0.87719298245614,0.861111111111111,0.56140350877193,0.527777777777778,0,"orthodox"
"222824",29,37,172,165,175,165,137,137,48,44,7,6,32,30,"win_A",-8,7,10,0,0,1,0,0,0.872727272727273,0.88,0.581818181818182,0.6,0,"orthodox"
"222825",28,29,172,175,175,172,130,129,46,20,7,1,30,7,"win_A",-1,-3,3,1,0,0,0,0,0.867924528301887,0.952380952380952,0.566037735849057,0.333333333333333,0,"orthodox"
"222827",28,37,172,166,175,178,130,129,44,33,7,4,29,14,"win_A",-9,6,-3,1,0,1,0,0,0.862745098039216,0.891891891891892,0.568627450980392,0.378378378378378,0,"orthodox"
"222828",28,36,172,166,175,178,130,130,43,32,6,4,28,14,"win_B",-8,6,-3,0,0,1,0,0,0.877551020408163,0.888888888888889,0.571428571428571,0.388888888888889,1,"orthodox"
"222831",27,27,172,168,175,173,131,131,40,29,5,12,25,14,"win_A",0,4,2,0,0,0,0,0,0.888888888888889,0.707317073170732,0.555555555555556,0.341463414634146,0,"orthodox"
"222833",25,31,172,168,175,180,125,126,37,27,5,4,22,18,"win_A",-6,4,-5,-1,0,0,0,0,0.880952380952381,0.870967741935484,0.523809523809524,0.580645161290323,0,"orthodox"
"222836",24,26,172,168,175,173,130,130,33,15,5,9,19,11,"win_A",-2,4,2,0,0,0,0,0,0.868421052631579,0.625,0.5,0.458333333333333,0,"orthodox"
"222843",23,28,172,173,175,178,127,127,26,20,5,10,16,15,"win_A",-5,-1,-3,0,0,0,0,0,0.838709677419355,0.666666666666667,0.516129032258065,0.5,0,"orthodox"
"222845",22,25,172,165,175,178,127,127,24,24,5,1,14,17,"win_A",-3,7,-3,0,0,0,0,0,0.827586206896552,0.96,0.482758620689655,0.68,0,"orthodox"
"222850",21,29,172,175,175,180,131,131,19,10,4,3,10,6,"win_A",-8,-3,-5,0,0,0,0,0,0.826086956521739,0.769230769230769,0.434782608695652,0.461538461538462,0,"orthodox"
"222856",20,18,172,175,175,183,130,130,13,13,4,1,5,13,"win_A",2,-3,-8,0,0,0,0,0,0.764705882352941,0.928571428571429,0.294117647058824,0.928571428571429,0,"orthodox"
"222864",19,21,172,168,175,173,124,126,7,8,2,2,2,6,"win_A",-2,4,2,-2,0,0,0,0,0.777777777777778,0.8,0.222222222222222,0.6,0,"orthodox"
"222973",25,29,160,168,168,178,110,111,18,23,0,2,14,16,"win_A",-4,-8,-10,-1,0,0,0,0,1,0.92,0.777777777777778,0.64,0,"southpaw"
"222974",25,35,160,152,168,165,108,107,17,38,0,4,13,30,"win_A",-10,8,3,1,0,1,0,0,1,0.904761904761905,0.764705882352941,0.714285714285714,0,"southpaw"
"222976",24,23,160,165,168,168,108,108,15,12,0,1,12,9,"win_A",1,-5,0,0,0,0,0,0,1,0.923076923076923,0.8,0.692307692307692,0,"southpaw"
"222977",24,27,160,160,168,163,111,112,14,23,0,5,11,16,"win_A",-3,0,5,-1,0,0,0,0,1,0.821428571428571,0.785714285714286,0.571428571428571,0,"southpaw"
"222980",23,26,160,165,168,175,113,110,11,1,0,11,8,0,"win_A",-3,-5,-7,3,0,0,0,0,1,0.0833333333333333,0.727272727272727,0,0,"southpaw"
"222984",23,28,160,163,168,165,111,111,7,14,0,15,5,10,"win_A",-5,-3,3,0,0,0,0,0,1,0.482758620689655,0.714285714285714,0.344827586206897,0,"southpaw"
"222989",21,20,160,160,168,165,113,112,1,7,0,1,0,1,"win_A",1,0,3,1,0,0,0,0,1,0.875,0,0.125,0,"southpaw"
"222993",33,30,175,185,180,191,163,163,35,9,1,6,19,8,"win_B",3,-10,-11,0,0,0,0,0,0.972222222222222,0.6,0.527777777777778,0.533333333333333,1,"southpaw"
"222996",31,37,175,164,180,173,165,162,32,22,1,8,19,15,"win_A",-6,11,7,3,0,1,0,0,0.96969696969697,0.733333333333333,0.575757575757576,0.5,0,"southpaw"
"222997",27,31,173,175,175,180,160,160,95,32,4,0,66,19,"win_A",-4,-2,-5,0,0,0,0,0,0.95959595959596,1,0.666666666666667,0.59375,0,"orthodox"
"223193",24,27,174,171,180,168,129,129,29,47,2,10,23,34,"win_A",-3,3,12,0,0,0,0,0,0.935483870967742,0.824561403508772,0.741935483870968,0.596491228070175,0,"southpaw"
"223248",25,34,171,170,173,170,140,140,32,27,1,4,16,19,"win_A",-9,1,3,0,0,0,0,0,0.96969696969697,0.870967741935484,0.484848484848485,0.612903225806452,0,"orthodox"
"223251",33,27,170,165,170,178,143,143,25,21,2,13,19,10,"win_A",6,5,-8,0,0,0,0,0,0.925925925925926,0.617647058823529,0.703703703703704,0.294117647058824,0,"orthodox"
"223253",32,28,170,175,170,183,141,143,23,16,2,3,18,12,"win_A",4,-5,-13,-2,0,0,0,0,0.92,0.842105263157895,0.72,0.631578947368421,0,"orthodox"
"223256",29,35,170,173,170,183,140,140,19,43,1,22,15,31,"win_A",-6,-3,-13,0,0,1,0,0,0.95,0.661538461538462,0.75,0.476923076923077,0,"orthodox"
"223261",28,23,170,175,170,175,141,140,14,8,1,3,11,8,"win_A",5,-5,-5,1,0,0,0,0,0.933333333333333,0.727272727272727,0.733333333333333,0.727272727272727,0,"orthodox"
"223461",31,25,178,175,183,175,159,159,39,28,6,7,20,24,"win_A",6,3,8,0,0,0,0,0,0.866666666666667,0.8,0.444444444444444,0.685714285714286,0,"orthodox"
"223463",30,24,178,175,183,175,160,160,37,25,5,6,19,21,"win_A",6,3,8,0,0,0,0,0,0.880952380952381,0.806451612903226,0.452380952380952,0.67741935483871,0,"orthodox"
"223552",27,22,169,163,177,173,123,116,71,75,18,1,54,26,"win_B",5,6,4,7,0,0,0,0,0.797752808988764,0.986842105263158,0.606741573033708,0.342105263157895,1,"orthodox"
"223563",26,21,169,163,177,173,121,116,66,64,15,1,52,24,"win_B",5,6,4,5,0,0,0,0,0.814814814814815,0.984615384615385,0.641975308641975,0.369230769230769,1,"orthodox"
"223606",25,19,169,163,177,173,121,117,57,21,13,1,46,7,"win_B",6,6,4,4,0,0,0,0,0.814285714285714,0.954545454545455,0.657142857142857,0.318181818181818,1,"orthodox"
"224080",22,24,173,166,185,170,134,134,45,100,7,19,24,19,"win_A",-2,7,15,0,0,0,0,0,0.865384615384615,0.840336134453782,0.461538461538462,0.159663865546218,0,"orthodox"
"224083",22,34,173,169,185,175,135,131,42,164,7,41,22,84,"win_A",-12,4,10,4,0,0,0,0,0.857142857142857,0.8,0.448979591836735,0.409756097560976,0,"orthodox"
"224088",21,37,173,165,185,165,134,131,37,99,7,33,19,19,"win_A",-16,8,20,3,0,1,0,0,0.840909090909091,0.75,0.431818181818182,0.143939393939394,0,"orthodox"
"224299",30,30,188,178,191,187,173,180,53,77,12,11,37,62,"win_A",0,10,4,-7,0,0,0,0,0.815384615384615,0.875,0.569230769230769,0.704545454545455,0,"orthodox"
"224378",17,20,178,183,187,185,161,156,4,1,0,1,2,0,"win_A",-3,-5,2,5,0,0,0,0,1,0.5,0.5,0,0,"orthodox"
"224385",37,37,178,182,183,180,178,174,32,28,0,7,17,21,"win_A",0,-4,3,4,1,1,0,0,1,0.8,0.53125,0.6,0,"orthodox"
"224394",27,25,182,185,180,198,168,168,22,14,1,2,16,13,"win_A",2,-3,-18,0,0,0,0,0,0.956521739130435,0.875,0.695652173913043,0.8125,0,"orthodox"
"224473",31,27,177,178,185,189,160,159,23,19,3,0,19,11,"win_A",4,-1,-4,1,0,0,0,0,0.884615384615385,1,0.730769230769231,0.578947368421053,0,"southpaw"
"224475",26,30,177,177,180,185,159,160,22,21,0,3,15,17,"win_B",-4,0,-5,-1,0,0,0,0,1,0.875,0.681818181818182,0.708333333333333,1,"southpaw"
"224515",23,28,171,163,178,166,144,144,43,110,12,42,20,11,"win_B",-5,8,12,0,0,0,0,0,0.781818181818182,0.723684210526316,0.363636363636364,0.0723684210526316,1,"orthodox"
"224541",20,25,171,163,178,166,137,138,26,95,4,29,11,9,"win_A",-5,8,12,-1,0,0,0,0,0.866666666666667,0.766129032258065,0.366666666666667,0.0725806451612903,0,"orthodox"
"224648",18,19,163,165,166,168,122,121,11,9,0,2,3,3,"win_A",-1,-2,-2,1,0,0,0,0,1,0.818181818181818,0.272727272727273,0.272727272727273,0,"orthodox"
"224662",27,35,170,175,178,170,126,126,21,45,1,7,13,28,"win_A",-8,-5,8,0,0,1,0,0,0.954545454545455,0.865384615384615,0.590909090909091,0.538461538461538,0,"orthodox"
"224681",21,25,170,168,178,175,132,132,1,2,0,4,1,1,"win_A",-4,2,3,0,0,0,0,0,1,0.333333333333333,1,0.166666666666667,0,"orthodox"
"224684",21,42,178,179,178,185,152,152,11,65,1,24,8,50,"win_A",-21,-1,-7,0,0,1,0,0,0.916666666666667,0.730337078651685,0.666666666666667,0.561797752808989,0,"orthodox"
"224685",24,41,180,179,168,185,147,147,26,65,0,23,22,50,"win_A",-17,1,-17,0,0,1,0,0,1,0.738636363636364,0.846153846153846,0.568181818181818,0,"orthodox"
"224698",31,37,172,179,175,185,155,154,35,56,7,18,23,47,"win_A",-6,-7,-10,1,0,1,0,0,0.833333333333333,0.756756756756757,0.547619047619048,0.635135135135135,0,"southpaw"
"224699",23,37,173,179,178,185,153,154,38,56,3,17,29,47,"win_A",-14,-6,-7,-1,0,1,0,0,0.926829268292683,0.767123287671233,0.707317073170732,0.643835616438356,0,"orthodox"
"224707",23,34,179,179,188,185,153,155,17,51,0,13,14,42,"win_A",-11,0,3,-2,0,0,0,0,1,0.796875,0.823529411764706,0.65625,0,"southpaw"
"224709",22,34,171,179,173,185,150,149,54,50,0,12,48,41,"win_A",-12,-8,-12,1,0,0,0,0,1,0.806451612903226,0.888888888888889,0.661290322580645,0,"orthodox"
"224967",26,25,170,169,180,174,137,134,98,53,9,7,46,20,"win_A",1,1,6,3,0,0,0,0,0.91588785046729,0.883333333333333,0.429906542056075,0.333333333333333,0,"orthodox"
"225105",33,25,180,191,178,211,180,210,32,8,20,2,12,7,"win_A",8,-11,-33,-30,0,0,0,1,0.615384615384615,0.8,0.230769230769231,0.7,0,"Unknown"
"225115",29,23,180,191,178,202,180,170,24,11,14,2,10,4,"win_A",6,-11,-24,10,0,0,0,0,0.631578947368421,0.846153846153846,0.263157894736842,0.307692307692308,0,"Unknown"
"225303",41,36,175,185,175,198,172,165,29,9,8,23,23,1,"win_A",5,-10,-23,7,1,1,0,0,0.783783783783784,0.28125,0.621621621621622,0.03125,0,"orthodox"
"225311",27,26,175,175,175,183,148,154,16,19,3,4,16,15,"win_A",1,0,-8,-6,0,0,0,0,0.842105263157895,0.826086956521739,0.842105263157895,0.652173913043478,0,"orthodox"
"225332",25,28,170,168,170,180,137,137,18,42,1,6,10,31,"win_A",-3,2,-10,0,0,0,0,0,0.947368421052632,0.875,0.526315789473684,0.645833333333333,0,"orthodox"
"225338",26,28,168,170,180,180,135,135,37,26,5,5,29,18,"win_A",-2,-2,0,0,0,0,0,0,0.880952380952381,0.838709677419355,0.69047619047619,0.580645161290323,0,"orthodox"
"225347",25,32,168,168,180,170,132,132,28,24,4,2,22,18,"win_A",-7,0,10,0,0,0,0,0,0.875,0.923076923076923,0.6875,0.692307692307692,0,"orthodox"
"225348",24,26,168,165,180,173,136,138,27,29,3,15,21,21,"win_A",-2,3,7,-2,0,0,0,0,0.9,0.659090909090909,0.7,0.477272727272727,0,"orthodox"
"225351",23,30,168,163,180,157,130,130,24,18,2,4,20,9,"win_A",-7,5,23,0,0,0,0,0,0.923076923076923,0.818181818181818,0.769230769230769,0.409090909090909,0,"orthodox"
"225352",23,23,168,180,180,185,135,135,23,12,2,8,19,2,"win_A",0,-12,-5,0,0,0,0,0,0.92,0.6,0.76,0.1,0,"orthodox"
"225353",22,31,168,165,180,173,130,130,21,59,2,11,17,40,"win_A",-9,3,7,0,0,0,0,0,0.91304347826087,0.842857142857143,0.739130434782609,0.571428571428571,0,"orthodox"
"226164",41,36,175,185,175,198,172,165,29,9,8,23,23,1,"win_A",5,-10,-23,7,1,1,0,0,0.783783783783784,0.28125,0.621621621621622,0.03125,0,"orthodox"
"226172",27,26,175,175,175,183,148,154,16,19,3,4,16,15,"win_A",1,0,-8,-6,0,0,0,0,0.842105263157895,0.826086956521739,0.842105263157895,0.652173913043478,0,"orthodox"
"226193",25,28,170,168,170,180,137,137,18,42,1,6,10,31,"win_A",-3,2,-10,0,0,0,0,0,0.947368421052632,0.875,0.526315789473684,0.645833333333333,0,"orthodox"
"226199",26,28,168,170,180,180,135,135,37,26,5,5,29,18,"win_A",-2,-2,0,0,0,0,0,0,0.880952380952381,0.838709677419355,0.69047619047619,0.580645161290323,0,"orthodox"
"226208",25,32,168,168,180,170,132,132,28,24,4,2,22,18,"win_A",-7,0,10,0,0,0,0,0,0.875,0.923076923076923,0.6875,0.692307692307692,0,"orthodox"
"226209",24,26,168,165,180,173,136,138,27,29,3,15,21,21,"win_A",-2,3,7,-2,0,0,0,0,0.9,0.659090909090909,0.7,0.477272727272727,0,"orthodox"
"226212",23,30,168,163,180,157,130,130,24,18,2,4,20,9,"win_A",-7,5,23,0,0,0,0,0,0.923076923076923,0.818181818181818,0.769230769230769,0.409090909090909,0,"orthodox"
"226213",23,23,168,180,180,185,135,135,23,12,2,8,19,2,"win_A",0,-12,-5,0,0,0,0,0,0.92,0.6,0.76,0.1,0,"orthodox"
"226214",22,31,168,165,180,173,130,130,21,59,2,11,17,40,"win_A",-9,3,7,0,0,0,0,0,0.91304347826087,0.842857142857143,0.739130434782609,0.571428571428571,0,"orthodox"
"226878",23,37,150,165,155,165,125,119,44,100,24,36,25,19,"win_A",-14,-15,-10,6,0,1,0,0,0.647058823529412,0.735294117647059,0.367647058823529,0.139705882352941,0,"orthodox"
"226891",20,34,166,165,170,165,127,131,76,94,5,25,14,19,"win_B",-14,1,5,-4,0,0,0,0,0.938271604938272,0.789915966386555,0.172839506172839,0.159663865546218,1,"orthodox"
"226902",29,32,169,165,175,165,130,131,119,88,28,18,54,17,"win_A",-3,4,10,-1,0,0,0,0,0.80952380952381,0.830188679245283,0.36734693877551,0.160377358490566,0,"orthodox"
"226914",30,23,165,168,165,175,124,127,75,106,14,25,17,21,"win_A",7,-3,-10,-3,0,0,0,0,0.842696629213483,0.809160305343511,0.191011235955056,0.16030534351145,0,"Unknown"
"226924",29,24,165,170,165,170,126,132,65,46,13,12,15,19,"win_A",5,-5,-5,-6,0,0,0,0,0.833333333333333,0.793103448275862,0.192307692307692,0.327586206896552,0,"Unknown"
"227207",27,23,178,184,184,185,157,163,65,9,23,0,18,6,"win_B",4,-6,-1,-6,0,0,0,0,0.738636363636364,1,0.204545454545455,0.666666666666667,1,"Unknown"
"227249",25,24,169,168,184,169,138,131,22,11,9,2,9,10,"win_A",1,1,15,7,0,0,0,0,0.709677419354839,0.846153846153846,0.290322580645161,0.769230769230769,0,"Unknown"
"227345",29,24,187,189,202,201,223,184,32,29,11,7,22,17,"win_A",5,-2,1,39,0,0,1,0,0.744186046511628,0.805555555555556,0.511627906976744,0.472222222222222,0,"orthodox"
"227354",28,29,187,191,202,202,219,170,24,43,9,21,20,14,"win_A",-1,-4,0,49,0,0,1,0,0.727272727272727,0.671875,0.606060606060606,0.21875,0,"orthodox"
"227367",32,27,192,187,211,202,218,215,60,14,33,6,47,11,"win_A",5,5,9,3,0,0,0,0,0.645161290322581,0.7,0.505376344086022,0.55,0,"Unknown"
"227849",23,37,168,171,173,176,143,138,22,116,16,61,3,16,"win_A",-14,-3,-3,5,0,1,0,0,0.578947368421053,0.655367231638418,0.0789473684210526,0.0903954802259887,0,"Unknown"
"227862",35,22,171,171,176,175,139,136,110,34,54,9,14,21,"win_B",13,0,1,3,1,0,0,0,0.670731707317073,0.790697674418605,0.0853658536585366,0.488372093023256,1,"orthodox"
"227875",33,19,171,171,176,165,138,137,101,11,50,0,13,4,"win_A",14,0,11,1,0,0,0,0,0.66887417218543,1,0.0860927152317881,0.363636363636364,0,"orthodox"
"227883",32,24,171,178,176,178,138,137,96,13,47,2,12,9,"win_B",8,-7,-2,1,0,0,0,0,0.671328671328671,0.866666666666667,0.0839160839160839,0.6,1,"orthodox"
"227897",32,31,179,171,187,176,135,156,40,84,21,42,15,11,"win_B",1,8,11,-21,0,0,0,1,0.655737704918033,0.666666666666667,0.245901639344262,0.0873015873015873,1,"Unknown"
"227899",32,30,179,171,187,176,134,155,40,82,20,42,15,11,"win_B",2,8,11,-21,0,0,0,1,0.666666666666667,0.661290322580645,0.25,0.0887096774193548,1,"Unknown"
"227902",30,31,171,170,176,173,136,140,79,18,42,15,10,4,"win_A",-1,1,3,-4,0,0,0,0,0.652892561983471,0.545454545454545,0.0826446280991736,0.121212121212121,0,"orthodox"
"228084",20,22,159,160,161,164,105,105,10,14,4,0,7,6,"win_A",-2,-1,-3,0,0,0,0,0,0.714285714285714,1,0.5,0.428571428571429,0,"orthodox"
"228094",16,19,168,160,165,164,109,111,1,3,0,0,1,1,"win_B",-3,8,1,-2,0,0,0,0,1,1,1,0.333333333333333,1,"orthodox"
"228492",26,21,165,173,170,178,132,135,79,63,8,13,23,8,"win_B",5,-8,-8,-3,0,0,0,0,0.908045977011494,0.828947368421053,0.264367816091954,0.105263157894737,1,"orthodox"
"228860",42,29,193,188,208,201,250,270,40,3,15,1,29,3,"win_A",13,5,7,-20,1,0,0,1,0.727272727272727,0.75,0.527272727272727,0.75,0,"orthodox"
"228862",29,41,191,193,196,208,267,265,12,39,0,14,4,29,"win_A",-12,-2,-12,2,0,1,0,0,1,0.735849056603774,0.333333333333333,0.547169811320755,0,"orthodox"
"228863",41,25,193,191,208,193,270,215,39,20,13,1,29,10,"win_B",16,2,15,55,1,0,1,0,0.75,0.952380952380952,0.557692307692308,0.476190476190476,1,"orthodox"
"228864",26,40,180,193,183,208,250,249,19,39,10,12,14,29,"win_A",-14,-13,-25,1,0,1,0,0,0.655172413793103,0.764705882352941,0.482758620689655,0.568627450980392,0,"orthodox"
"228868",40,36,193,189,208,198,256,224,36,23,11,6,28,15,"win_A",4,4,10,32,1,1,1,0,0.765957446808511,0.793103448275862,0.595744680851064,0.517241379310345,0,"orthodox"
"228870",40,30,193,193,208,203,265,236,34,14,11,3,27,10,"win_A",10,0,5,29,1,0,1,0,0.755555555555556,0.823529411764706,0.6,0.588235294117647,0,"orthodox"
"228871",40,31,193,185,208,185,260,213,33,21,11,4,26,10,"win_A",9,8,23,47,1,0,1,0,0.75,0.84,0.590909090909091,0.4,0,"orthodox"
"228872",25,39,188,193,198,208,246,218,30,33,0,10,28,26,"win_A",-14,-5,-10,28,0,1,1,0,1,0.767441860465116,0.933333333333333,0.604651162790698,0,"southpaw"
"228874",38,31,193,185,208,188,237,227,31,11,9,9,25,9,"win_A",7,8,20,10,1,0,0,0,0.775,0.55,0.625,0.45,0,"orthodox"
"228886",36,27,193,198,208,201,238,238,19,12,8,2,14,7,"win_A",9,-5,7,0,1,0,0,0,0.703703703703704,0.857142857142857,0.518518518518518,0.5,0,"orthodox"
"228887",36,25,193,191,208,208,249,227,19,21,7,1,14,14,"win_B",11,2,0,22,1,0,1,0,0.730769230769231,0.954545454545455,0.538461538461538,0.636363636363636,1,"orthodox"
"228890",33,29,193,188,208,196,243,217,16,14,5,2,13,10,"win_A",4,5,12,26,0,0,1,0,0.761904761904762,0.875,0.619047619047619,0.625,0,"orthodox"
"228891",32,25,193,184,208,193,234,206,15,15,4,1,12,7,"win_B",7,9,15,28,0,0,1,0,0.789473684210526,0.9375,0.631578947368421,0.4375,1,"orthodox"
"228892",32,22,193,195,208,203,236,219,14,17,3,1,12,12,"win_A",10,-2,5,17,0,0,1,0,0.823529411764706,0.944444444444444,0.705882352941177,0.666666666666667,0,"orthodox"
"228905",28,25,193,183,208,185,252,196,0,2,1,0,0,2,"win_A",3,10,23,56,0,0,1,0,0,1,0,1,0,"orthodox"
"229050",23,28,180,174,183,179,152,154,61,43,1,1,44,28,"win_A",-5,6,4,-2,0,0,0,0,0.983870967741935,0.977272727272727,0.709677419354839,0.636363636363636,0,"orthodox"
"229076",21,32,180,170,183,175,149,153,35,51,1,12,24,13,"win_A",-11,10,8,-4,0,0,0,0,0.972222222222222,0.80952380952381,0.666666666666667,0.206349206349206,0,"orthodox"
"229406",21,27,198,199,206,213,280,213,12,8,13,4,9,6,"win_A",-6,-1,-7,67,0,0,1,0,0.48,0.666666666666667,0.36,0.5,0,"orthodox"
"229426",31,31,168,164,170,165,140,140,29,29,4,4,14,23,"win_A",0,4,5,0,0,0,0,0,0.878787878787879,0.878787878787879,0.424242424242424,0.696969696969697,0,"orthodox"
"229600",37,33,165,161,173,163,141,143,77,25,14,4,52,12,"win_A",4,4,10,-2,1,0,0,0,0.846153846153846,0.862068965517241,0.571428571428571,0.413793103448276,0,"orthodox"
"229606",36,37,165,166,173,177,129,128,70,51,14,9,47,28,"win_A",-1,-1,-4,1,1,1,0,0,0.833333333333333,0.85,0.55952380952381,0.466666666666667,0,"orthodox"
"229620",31,25,165,174,173,188,130,130,57,13,11,3,39,5,"win_A",6,-9,-15,0,0,0,0,0,0.838235294117647,0.8125,0.573529411764706,0.3125,0,"orthodox"
"229622",30,30,165,165,173,175,130,130,56,40,10,20,38,26,"win_A",0,0,-2,0,0,0,0,0,0.848484848484849,0.666666666666667,0.575757575757576,0.433333333333333,0,"orthodox"
"229635",27,30,165,173,173,183,135,135,46,34,5,17,31,23,"win_B",-3,-8,-10,0,0,0,0,0,0.901960784313726,0.666666666666667,0.607843137254902,0.450980392156863,1,"orthodox"
"229684",26,26,165,176,168,179,118,118,28,31,1,1,17,28,"win_A",0,-11,-11,0,0,0,0,0,0.96551724137931,0.96875,0.586206896551724,0.875,0,"southpaw"
"229685",24,23,165,163,168,159,118,118,25,23,1,0,16,16,"win_A",1,2,9,0,0,0,0,0,0.961538461538462,1,0.615384615384615,0.695652173913043,0,"southpaw"
"229686",23,35,165,163,168,174,112,112,21,35,0,2,14,22,"win_A",-12,2,-6,0,0,1,0,0,1,0.945945945945946,0.666666666666667,0.594594594594595,0,"southpaw"
"229852",30,39,183,171,188,179,167,168,34,49,4,9,13,30,"win_A",-9,12,9,-1,0,1,0,0,0.894736842105263,0.844827586206897,0.342105263157895,0.517241379310345,0,"orthodox"
"229859",36,27,171,188,179,208,170,170,44,26,7,3,29,19,"win_A",9,-17,-29,0,1,0,0,0,0.862745098039216,0.896551724137931,0.568627450980392,0.655172413793103,0,"orthodox"
"229860",36,24,171,175,179,180,168,167,43,21,7,8,28,17,"win_A",12,-4,-1,1,1,0,0,0,0.86,0.724137931034483,0.56,0.586206896551724,0,"orthodox"
"229862",35,31,171,171,179,184,169,169,41,47,7,10,28,29,"win_A",4,0,-5,0,1,0,0,0,0.854166666666667,0.824561403508772,0.583333333333333,0.508771929824561,0,"orthodox"
"229866",31,27,171,183,179,178,165,164,35,22,5,5,26,10,"win_A",4,-12,1,1,0,0,0,0,0.875,0.814814814814815,0.65,0.37037037037037,0,"orthodox"
"229872",27,29,171,168,179,170,142,141,28,25,4,2,23,13,"win_A",-2,3,9,1,0,0,0,0,0.875,0.925925925925926,0.71875,0.481481481481481,0,"orthodox"
"229878",27,25,168,171,170,179,135,135,20,23,1,1,10,18,"win_A",2,-3,-9,0,0,0,0,0,0.952380952380952,0.958333333333333,0.476190476190476,0.75,0,"orthodox"
"229995",37,31,168,175,178,174,139,139,34,17,3,4,21,11,"win_A",6,-7,4,0,1,0,0,0,0.918918918918919,0.80952380952381,0.567567567567568,0.523809523809524,0,"orthodox"
"230000",31,22,168,175,178,173,137,136,28,23,2,2,16,15,"win_A",9,-7,5,1,0,0,0,0,0.933333333333333,0.92,0.533333333333333,0.6,0,"orthodox"
"230002",27,33,168,161,178,163,135,148,24,25,0,5,14,12,"win_A",-6,7,15,-13,0,0,0,0,1,0.833333333333333,0.583333333333333,0.4,0,"orthodox"
"230006",26,31,168,166,178,175,130,132,20,15,0,11,11,8,"win_A",-5,2,3,-2,0,0,0,0,1,0.576923076923077,0.55,0.307692307692308,0,"orthodox"
"230007",25,27,168,170,178,173,125,124,18,17,0,6,10,4,"win_A",-2,-2,5,1,0,0,0,0,1,0.739130434782609,0.555555555555556,0.173913043478261,0,"orthodox"
"230010",24,30,168,168,178,168,127,123,15,24,0,20,7,16,"win_A",-6,0,10,4,0,0,0,0,1,0.545454545454545,0.466666666666667,0.363636363636364,0,"orthodox"
"230175",30,33,178,168,191,175,129,129,30,35,1,4,16,22,"win_A",-3,10,16,0,0,0,0,0,0.967741935483871,0.897435897435897,0.516129032258065,0.564102564102564,0,"orthodox"
"230347",29,33,168,168,175,168,117,117,16,36,0,32,12,18,"win_A",-4,0,7,0,0,0,0,0,1,0.529411764705882,0.75,0.264705882352941,0,"orthodox"
"230354",28,32,168,168,175,168,117,117,9,35,0,28,7,18,"win_A",-4,0,7,0,0,0,0,0,1,0.555555555555556,0.777777777777778,0.285714285714286,0,"orthodox"
"230360",27,22,168,165,175,173,117,117,3,3,0,3,3,1,"win_A",5,3,2,0,0,0,0,0,1,0.5,1,0.166666666666667,0,"orthodox"
"230445",31,28,194,180,215,196,210,186,75,33,8,25,62,15,"win_A",3,14,19,24,0,0,1,0,0.903614457831325,0.568965517241379,0.746987951807229,0.258620689655172,0,"southpaw"
"230451",30,34,194,198,215,213,207,205,69,16,8,8,56,12,"win_A",-4,-4,2,2,0,0,0,0,0.896103896103896,0.666666666666667,0.727272727272727,0.5,0,"southpaw"
"230465",28,32,194,187,215,197,214,194,52,36,7,17,42,28,"win_A",-4,7,18,20,0,0,1,0,0.88135593220339,0.679245283018868,0.711864406779661,0.528301886792453,0,"southpaw"
"230478",26,30,194,187,215,197,215,198,38,32,6,15,31,24,"win_A",-4,7,18,17,0,0,1,0,0.863636363636364,0.680851063829787,0.704545454545455,0.51063829787234,0,"southpaw"
"230480",26,29,194,188,215,198,215,206,36,11,6,4,29,7,"win_A",-3,6,17,9,0,0,0,0,0.857142857142857,0.733333333333333,0.69047619047619,0.466666666666667,0,"southpaw"
"230860",28,31,180,188,185,191,207,185,32,42,15,6,18,29,"win_A",-3,-8,-6,22,0,0,1,0,0.680851063829787,0.875,0.382978723404255,0.604166666666667,0,"orthodox"
"230881",25,25,188,185,191,198,199,203,20,68,1,28,13,17,"win_A",0,3,-7,-4,0,0,0,0,0.952380952380952,0.708333333333333,0.619047619047619,0.177083333333333,0,"orthodox"
"230885",25,23,188,183,191,183,203,194,16,21,1,12,9,14,"win_A",2,5,8,9,0,0,0,0,0.941176470588235,0.636363636363636,0.529411764705882,0.424242424242424,0,"orthodox"
"230888",24,24,188,183,191,198,186,187,13,41,0,12,8,23,"win_A",0,5,-7,-1,0,0,0,0,1,0.773584905660377,0.615384615384615,0.433962264150943,0,"orthodox"
"230931",25,25,179,180,183,183,135,135,18,27,0,2,13,24,"win_A",0,-1,0,0,0,0,0,0,1,0.931034482758621,0.722222222222222,0.827586206896552,0,"Unknown"
"231746",28,27,213,193,216,191,319,216,27,2,0,0,22,2,"win_A",1,20,25,103,0,0,1,0,1,1,0.814814814814815,1,0,"orthodox"
"232152",39,35,188,180,198,185,250,239,47,25,4,10,37,13,"win_A",4,8,13,11,1,1,0,0,0.92156862745098,0.714285714285714,0.725490196078431,0.371428571428571,0,"southpaw"
"232157",29,34,178,188,178,198,224,243,40,43,3,2,35,34,"win_A",-5,-10,-20,-19,0,0,0,1,0.930232558139535,0.955555555555556,0.813953488372093,0.755555555555556,0,"orthodox"
"232161",22,29,180,188,193,198,212,212,27,38,0,1,21,31,"win_B",-7,-8,-5,0,0,0,0,0,1,0.974358974358974,0.777777777777778,0.794871794871795,1,"orthodox"
"232162",28,28,188,188,198,188,219,224,37,35,1,0,30,21,"win_A",0,0,10,-5,0,0,0,0,0.973684210526316,1,0.789473684210526,0.6,0,"southpaw"
"232165",26,34,188,188,198,201,216,244,33,29,0,7,30,20,"win_A",-8,0,-3,-28,0,0,0,1,1,0.805555555555556,0.909090909090909,0.555555555555556,0,"southpaw"
"232167",25,29,188,178,198,185,215,204,31,27,0,8,28,19,"win_A",-4,10,13,11,0,0,0,0,1,0.771428571428571,0.903225806451613,0.542857142857143,0,"southpaw"
"232170",24,27,188,182,198,183,224,235,27,17,0,12,26,8,"win_A",-3,6,15,-11,0,0,0,0,1,0.586206896551724,0.962962962962963,0.275862068965517,0,"southpaw"
"232171",24,35,188,208,198,216,225,275,26,26,0,10,26,19,"win_A",-11,-20,-18,-50,0,1,0,1,1,0.722222222222222,1,0.527777777777778,0,"southpaw"
"232174",23,31,188,183,198,191,214,215,23,15,0,4,23,9,"win_A",-8,5,7,-1,0,0,0,0,1,0.789473684210526,1,0.473684210526316,0,"southpaw"
"232182",21,25,188,180,198,196,171,171,14,16,0,0,14,15,"win_A",-4,8,2,0,0,0,0,0,1,1,1,0.9375,0,"southpaw"
"232183",21,25,188,178,198,185,174,175,13,15,0,2,13,10,"win_A",-4,10,13,-1,0,0,0,0,1,0.882352941176471,1,0.588235294117647,0,"southpaw"
"232307",26,25,163,168,170,168,133,139,90,48,15,26,7,23,"win_A",1,-5,2,-6,0,0,0,0,0.857142857142857,0.648648648648649,0.0666666666666667,0.310810810810811,0,"Unknown"
"232316",25,27,163,168,170,178,135,130,80,66,15,25,5,23,"win_A",-2,-5,-8,5,0,0,0,0,0.842105263157895,0.725274725274725,0.0526315789473684,0.252747252747253,0,"Unknown"
"232343",23,26,163,179,170,180,134,138,63,74,5,10,4,20,"win_B",-3,-16,-10,-4,0,0,0,0,0.926470588235294,0.880952380952381,0.0588235294117647,0.238095238095238,1,"Unknown"
"232583",21,33,165,167,168,171,132,131,22,44,0,7,18,30,"win_A",-12,-2,-3,1,0,0,0,0,1,0.862745098039216,0.818181818181818,0.588235294117647,0,"orthodox"
"232592",25,26,168,167,168,171,134,133,22,34,1,5,13,24,"win_A",-1,1,-3,1,0,0,0,0,0.956521739130435,0.871794871794872,0.565217391304348,0.615384615384615,0,"orthodox"
"232606",20,24,167,168,171,173,126,126,19,19,3,2,13,16,"win_A",-4,-1,-2,0,0,0,0,0,0.863636363636364,0.904761904761905,0.590909090909091,0.761904761904762,0,"orthodox"
"232729",19,23,164,161,164,165,113,115,7,62,0,6,7,26,"win_B",-4,3,-1,-2,0,0,0,0,1,0.911764705882353,1,0.382352941176471,1,"Unknown"
"232860",34,30,175,173,183,173,136,135,40,27,7,5,24,22,"win_A",4,2,10,1,0,0,0,0,0.851063829787234,0.84375,0.51063829787234,0.6875,0,"southpaw"
"232862",30,29,175,168,183,180,126,126,38,24,5,2,24,16,"win_A",1,7,3,0,0,0,0,0,0.883720930232558,0.923076923076923,0.558139534883721,0.615384615384615,0,"southpaw"
"232873",26,38,175,161,183,170,130,130,26,40,4,10,17,20,"win_A",-12,14,13,0,0,1,0,0,0.866666666666667,0.8,0.566666666666667,0.4,0,"southpaw"
"232874",26,25,175,174,183,175,132,132,25,20,4,6,16,15,"win_A",1,1,8,0,0,0,0,0,0.862068965517241,0.769230769230769,0.551724137931034,0.576923076923077,0,"southpaw"
"232875",25,24,175,165,183,178,127,125,24,15,4,3,16,7,"win_A",1,10,5,2,0,0,0,0,0.857142857142857,0.833333333333333,0.571428571428571,0.388888888888889,0,"southpaw"
"232876",25,29,175,170,183,180,131,131,22,29,4,4,15,19,"win_A",-4,5,3,0,0,0,0,0,0.846153846153846,0.878787878787879,0.576923076923077,0.575757575757576,0,"southpaw"
"232882",23,25,175,172,183,193,127,127,15,18,3,2,8,11,"win_A",-2,3,-10,0,0,0,0,0,0.833333333333333,0.9,0.444444444444444,0.55,0,"southpaw"
"232884",22,34,175,161,183,170,126,126,13,33,3,7,7,15,"win_A",-12,14,13,0,0,0,0,0,0.8125,0.825,0.4375,0.375,0,"southpaw"
"232886",19,22,171,175,170,183,128,126,16,12,0,2,13,6,"win_A",-3,-4,-13,2,0,0,0,0,1,0.857142857142857,0.8125,0.428571428571429,0,"orthodox"
"232972",33,31,191,179,193,185,207,216,26,51,1,8,19,40,"win_A",2,12,8,-9,0,0,0,0,0.962962962962963,0.864406779661017,0.703703703703704,0.677966101694915,0,"orthodox"
"232988",25,29,179,184,185,193,205,199,36,26,4,4,28,16,"win_A",-4,-5,-8,6,0,0,0,0,0.9,0.866666666666667,0.7,0.533333333333333,0,"orthodox"
"233010",22,30,179,183,185,196,204,186,14,48,1,4,13,23,"win_A",-8,-4,-11,18,0,0,1,0,0.933333333333333,0.923076923076923,0.866666666666667,0.442307692307692,0,"orthodox"
"233671",29,23,163,178,163,180,131,140,56,55,19,11,10,7,"win_B",6,-15,-17,-9,0,0,0,0,0.746666666666667,0.833333333333333,0.133333333333333,0.106060606060606,1,"orthodox"
"233676",22,27,178,163,180,163,130,134,32,56,3,14,4,10,"win_A",-5,15,17,-4,0,0,0,0,0.914285714285714,0.8,0.114285714285714,0.142857142857143,0,"Unknown"
"234261",34,27,180,178,188,180,154,154,29,15,9,2,21,12,"win_A",7,2,8,0,0,0,0,0,0.763157894736842,0.882352941176471,0.552631578947368,0.705882352941177,0,"orthodox"
"234971",43,39,174,165,180,173,154,159,39,40,2,15,23,22,"win_A",4,9,7,-5,1,1,0,0,0.951219512195122,0.727272727272727,0.560975609756098,0.4,0,"orthodox"
"234975",24,33,178,165,188,173,140,140,29,39,1,12,18,21,"win_A",-9,13,15,0,0,0,0,0,0.966666666666667,0.764705882352941,0.6,0.411764705882353,0,"orthodox"
"234976",33,25,165,175,173,180,139,139,38,19,12,2,20,12,"win_A",8,-10,-7,0,0,0,0,0,0.76,0.904761904761905,0.4,0.571428571428571,0,"orthodox"
"234977",33,25,165,173,173,178,141,143,37,36,12,5,19,25,"win_A",8,-8,-5,-2,0,0,0,0,0.755102040816326,0.878048780487805,0.387755102040816,0.609756097560976,0,"orthodox"
"234978",25,32,173,165,173,173,139,138,22,37,1,10,10,19,"win_A",-7,8,0,1,0,0,0,0,0.956521739130435,0.787234042553192,0.434782608695652,0.404255319148936,0,"orthodox"
"235338",23,27,179,170,193,170,138,138,32,70,3,43,23,27,"win_A",-4,9,23,0,0,0,0,0,0.914285714285714,0.619469026548673,0.657142857142857,0.238938053097345,0,"orthodox"
"235389",22,23,180,182,188,187,174,171,79,87,18,14,27,30,"win_A",-1,-2,1,3,0,0,0,0,0.814432989690722,0.861386138613861,0.278350515463918,0.297029702970297,0,"Unknown"
"235392",23,21,182,180,187,185,174,177,85,25,12,1,30,10,"win_A",2,2,2,-3,0,0,0,0,0.876288659793814,0.961538461538462,0.309278350515464,0.384615384615385,0,"Unknown"
"235394",25,23,178,182,183,187,178,179,43,85,13,10,19,30,"win_A",2,-4,-4,-1,0,0,0,0,0.767857142857143,0.894736842105263,0.339285714285714,0.315789473684211,0,"orthodox"
"235395",25,23,178,182,183,187,179,173,42,85,13,9,18,30,"win_A",2,-4,-4,6,0,0,0,0,0.763636363636364,0.904255319148936,0.327272727272727,0.319148936170213,0,"orthodox"
"235909",29,25,178,187,183,222,185,189,52,54,21,15,22,18,"win_A",4,-9,-39,-4,0,0,0,0,0.712328767123288,0.782608695652174,0.301369863013699,0.260869565217391,0,"orthodox"
"236405",22,29,175,173,183,178,145,135,83,141,25,20,49,49,"win_A",-7,2,5,10,0,0,0,0,0.768518518518518,0.875776397515528,0.453703703703704,0.304347826086957,0,"Unknown"
"236407",22,28,175,173,183,178,141,138,79,141,25,18,46,49,"win_A",-6,2,5,3,0,0,0,0,0.759615384615385,0.886792452830189,0.442307692307692,0.308176100628931,0,"Unknown"
"236817",32,35,165,175,165,178,135,135,41,34,3,4,28,26,"win_A",-3,-10,-13,0,0,1,0,0,0.931818181818182,0.894736842105263,0.636363636363636,0.684210526315789,0,"orthodox"
"236818",32,34,165,168,165,168,129,129,40,41,3,4,28,24,"win_A",-2,-3,-3,0,0,0,0,0,0.930232558139535,0.911111111111111,0.651162790697674,0.533333333333333,0,"orthodox"
"236828",32,27,163,165,160,165,130,130,24,29,34,1,16,19,"win_B",5,-2,-5,0,0,0,0,0,0.413793103448276,0.966666666666667,0.275862068965517,0.633333333333333,1,"orthodox"
"236833",25,24,165,168,165,170,130,130,24,8,1,6,15,5,"win_A",1,-3,-5,0,0,0,0,0,0.96,0.571428571428571,0.6,0.357142857142857,0,"orthodox"
"236842",23,22,165,170,165,180,126,126,15,35,1,5,9,28,"win_A",1,-5,-15,0,0,0,0,0,0.9375,0.875,0.5625,0.7,0,"orthodox"
"237312",28,31,175,170,178,173,148,149,51,20,22,9,17,8,"win_B",-3,5,5,-1,0,0,0,0,0.698630136986301,0.689655172413793,0.232876712328767,0.275862068965517,1,"orthodox"
"238054",22,28,164,170,174,170,135,135,21,69,5,30,13,20,"win_B",-6,-6,4,0,0,0,0,0,0.807692307692308,0.696969696969697,0.5,0.202020202020202,1,"Unknown"
"238056",28,20,170,164,170,164,135,135,67,14,30,10,20,9,"win_A",8,6,6,0,0,0,0,0,0.690721649484536,0.583333333333333,0.206185567010309,0.375,0,"Unknown"
"238502",28,38,188,191,196,201,243,235,30,22,3,16,23,11,"win_A",-10,-3,-5,8,0,1,0,0,0.909090909090909,0.578947368421053,0.696969696969697,0.289473684210526,0,"orthodox"
"238503",26,28,185,188,191,196,265,223,33,30,1,2,18,23,"win_A",-2,-3,-5,42,0,0,1,0,0.970588235294118,0.9375,0.529411764705882,0.71875,0,"orthodox"
"238505",27,37,188,198,196,208,250,266,28,38,1,7,22,23,"win_A",-10,-10,-12,-16,0,1,0,1,0.96551724137931,0.844444444444444,0.758620689655172,0.511111111111111,0,"orthodox"
"238508",24,30,188,188,196,180,243,235,23,23,0,1,20,6,"win_A",-6,0,16,8,0,0,0,0,1,0.958333333333333,0.869565217391304,0.25,0,"orthodox"
"238509",24,38,188,180,196,198,250,227,22,18,0,8,19,7,"win_A",-14,8,-2,23,0,1,1,0,1,0.692307692307692,0.863636363636364,0.269230769230769,0,"orthodox"
"238510",24,28,188,193,196,208,247,232,21,12,0,1,18,8,"win_A",-4,-5,-12,15,0,0,1,0,1,0.923076923076923,0.857142857142857,0.615384615384615,0,"orthodox"
"238511",24,32,188,185,196,191,247,226,20,41,0,4,17,35,"win_A",-8,3,5,21,0,0,1,0,1,0.911111111111111,0.85,0.777777777777778,0,"orthodox"
"238513",23,31,188,191,196,203,248,237,18,20,0,5,17,9,"win_A",-8,-3,-7,11,0,0,0,0,1,0.8,0.944444444444444,0.36,0,"orthodox"
"238519",22,26,188,183,196,193,247,225,12,24,0,6,11,15,"win_A",-4,5,3,22,0,0,1,0,1,0.8,0.916666666666667,0.5,0,"orthodox"
"238523",21,45,188,185,196,196,241,219,7,11,0,37,7,4,"win_A",-24,3,0,22,0,1,1,0,1,0.229166666666667,1,0.0833333333333333,0,"orthodox"
"238534",37,29,192,188,211,196,235,228,35,19,5,5,22,14,"win_A",8,4,15,7,1,0,0,0,0.875,0.791666666666667,0.55,0.583333333333333,0,"orthodox"
"238535",37,29,192,180,211,203,233,224,34,6,5,6,22,3,"win_A",8,12,8,9,1,0,0,0,0.871794871794872,0.5,0.564102564102564,0.25,0,"orthodox"
"238536",36,28,192,196,211,208,240,272,33,22,5,3,21,13,"win_A",8,-4,3,-32,1,0,0,1,0.868421052631579,0.88,0.552631578947368,0.52,0,"orthodox"
"238537",36,29,192,188,211,193,255,226,32,40,5,2,21,33,"win_A",7,4,18,29,1,0,1,0,0.864864864864865,0.952380952380952,0.567567567567568,0.785714285714286,0,"orthodox"
"238538",36,32,192,191,211,208,261,242,31,19,5,9,21,18,"win_A",4,1,3,19,1,0,1,0,0.861111111111111,0.678571428571429,0.583333333333333,0.642857142857143,0,"orthodox"
"238539",36,28,192,178,211,183,244,227,30,24,5,5,20,16,"win_A",8,14,28,17,1,0,1,0,0.857142857142857,0.827586206896552,0.571428571428571,0.551724137931034,0,"orthodox"
"238540",28,34,192,188,211,198,226,219,27,35,4,6,19,26,"win_A",-6,4,13,7,0,0,0,0,0.870967741935484,0.853658536585366,0.612903225806452,0.634146341463415,0,"orthodox"
"238541",28,26,192,194,211,211,232,217,26,16,4,1,18,11,"win_A",2,-2,0,15,0,0,1,0,0.866666666666667,0.941176470588235,0.6,0.647058823529412,0,"orthodox"
"238698",31,26,173,165,170,165,135,135,27,12,2,9,16,9,"win_A",5,8,5,0,0,0,0,0,0.931034482758621,0.571428571428571,0.551724137931034,0.428571428571429,0,"orthodox"
"238699",30,26,173,168,170,175,130,130,26,23,1,0,16,9,"win_A",4,5,-5,0,0,0,0,0,0.962962962962963,1,0.592592592592593,0.391304347826087,0,"orthodox"
"238700",28,32,173,170,170,170,129,129,24,26,1,7,15,9,"win_A",-4,3,0,0,0,0,0,0,0.96,0.787878787878788,0.6,0.272727272727273,0,"orthodox"
"238709",23,25,173,173,170,180,130,126,13,15,0,7,8,7,"win_A",-2,0,-10,4,0,0,0,0,1,0.681818181818182,0.615384615384615,0.318181818181818,0,"orthodox"
"238712",22,22,173,168,170,173,132,133,10,9,0,6,7,2,"win_A",0,5,-3,-1,0,0,0,0,1,0.6,0.7,0.133333333333333,0,"orthodox"
"238891",20,22,192,192,204,201,210,190,10,19,1,4,7,8,"win_A",-2,0,3,20,0,0,1,0,0.909090909090909,0.826086956521739,0.636363636363636,0.347826086956522,0,"orthodox"
"238982",36,29,170,168,173,183,157,152,43,15,11,6,13,13,"win_A",7,2,-10,5,1,0,0,0,0.796296296296296,0.714285714285714,0.240740740740741,0.619047619047619,0,"orthodox"
"239039",23,23,187,188,203,191,208,201,26,53,4,11,12,20,"win_A",0,-1,12,7,0,0,0,0,0.866666666666667,0.828125,0.4,0.3125,0,"Unknown"
"239040",22,23,175,188,183,191,212,224,38,52,11,11,24,20,"win_B",-1,-13,-8,-12,0,0,0,0,0.775510204081633,0.825396825396825,0.489795918367347,0.317460317460317,1,"orthodox"
"239058",22,21,193,188,209,191,198,194,51,30,6,9,24,8,"win_A",1,5,18,4,0,0,0,0,0.894736842105263,0.769230769230769,0.421052631578947,0.205128205128205,0,"orthodox"
"239093",26,25,170,180,175,185,140,140,27,24,1,0,26,16,"win_A",1,-10,-10,0,0,0,0,0,0.964285714285714,1,0.928571428571429,0.666666666666667,0,"orthodox"
"239738",29,35,163,166,168,177,128,128,17,47,6,6,8,26,"win_A",-6,-3,-9,0,0,1,0,0,0.739130434782609,0.886792452830189,0.347826086956522,0.490566037735849,0,"orthodox"
"239752",29,25,166,170,177,180,126,126,34,22,2,0,21,16,"win_A",4,-4,-3,0,0,0,0,0,0.944444444444444,1,0.583333333333333,0.727272727272727,0,"orthodox"
"239755",28,22,166,165,177,180,128,128,29,31,2,8,20,24,"win_A",6,1,-3,0,0,0,0,0,0.935483870967742,0.794871794871795,0.645161290322581,0.615384615384615,0,"orthodox"
"239756",27,29,166,168,177,166,127,127,28,27,2,17,19,22,"win_A",-2,-2,11,0,0,0,0,0,0.933333333333333,0.613636363636364,0.633333333333333,0.5,0,"orthodox"
"239875",32,26,165,163,165,168,118,118,31,1,6,3,21,0,"win_A",6,2,-3,0,0,0,0,0,0.837837837837838,0.25,0.567567567567568,0,0,"orthodox"
"239925",25,22,170,175,170,180,140,141,36,20,4,0,25,16,"win_A",3,-5,-10,-1,0,0,0,0,0.9,1,0.625,0.8,0,"orthodox"
"240510",31,35,182,180,193,183,192,198,26,33,6,12,15,17,"win_A",-4,2,10,-6,0,1,0,0,0.8125,0.733333333333333,0.46875,0.377777777777778,0,"orthodox"
"240511",36,29,187,182,192,193,190,187,25,26,12,3,24,15,"win_A",7,5,-1,3,1,0,0,0,0.675675675675676,0.896551724137931,0.648648648648649,0.517241379310345,0,"orthodox"
"240513",28,25,182,180,193,193,195,189,24,9,3,5,15,9,"win_A",3,2,0,6,0,0,0,0,0.888888888888889,0.642857142857143,0.555555555555556,0.642857142857143,0,"orthodox"
"240514",27,24,182,183,193,183,190,188,23,16,2,0,14,14,"win_A",3,-1,10,2,0,0,0,0,0.92,1,0.56,0.875,0,"orthodox"
"240523",24,22,182,185,193,191,186,185,13,4,1,0,9,4,"win_A",2,-3,2,1,0,0,0,0,0.928571428571429,1,0.642857142857143,1,0,"orthodox"
"240540",30,24,179,169,183,176,146,143,78,55,11,26,37,20,"win_A",6,10,7,3,0,0,0,0,0.876404494382023,0.679012345679012,0.415730337078652,0.246913580246914,0,"orthodox"
"240552",27,22,179,179,183,188,154,160,64,31,11,4,32,20,"win_A",5,0,-5,-6,0,0,0,0,0.853333333333333,0.885714285714286,0.426666666666667,0.571428571428571,0,"orthodox"
"240558",26,27,179,171,183,175,150,149,58,65,11,19,29,22,"win_A",-1,8,8,1,0,0,0,0,0.840579710144927,0.773809523809524,0.420289855072464,0.261904761904762,0,"orthodox"
"240569",24,24,179,173,183,175,143,146,49,39,9,15,24,26,"win_A",0,6,8,-3,0,0,0,0,0.844827586206897,0.722222222222222,0.413793103448276,0.481481481481481,0,"orthodox"
"240692",34,30,185,178,193,191,215,201,18,19,9,6,11,16,"win_B",4,7,2,14,0,0,0,0,0.666666666666667,0.76,0.407407407407407,0.64,1,"orthodox"
"241102",28,25,164,162,165,164,115,115,21,13,3,2,14,7,"win_B",3,2,1,0,0,0,0,0,0.875,0.866666666666667,0.583333333333333,0.466666666666667,1,"Unknown"
"241260",25,24,173,175,178,183,139,135,87,105,24,31,10,63,"win_A",1,-2,-5,4,0,0,0,0,0.783783783783784,0.772058823529412,0.0900900900900901,0.463235294117647,0,"Unknown"
"241620",25,28,188,191,200,192,198,199,11,11,0,1,9,4,"win_B",-3,-3,8,-1,0,0,0,0,1,0.916666666666667,0.818181818181818,0.333333333333333,1,"orthodox"
"241623",24,36,191,180,192,188,200,206,7,18,1,19,2,5,"win_A",-12,11,4,-6,0,1,0,0,0.875,0.486486486486487,0.25,0.135135135135135,0,"orthodox"
"241690",27,19,175,178,185,188,180,181,15,21,16,8,3,14,"win_A",8,-3,-3,-1,0,0,0,0,0.483870967741935,0.724137931034483,0.0967741935483871,0.482758620689655,0,"Unknown"
"242450",27,39,168,180,165,188,154,153,6,35,12,13,0,25,"win_A",-12,-12,-23,1,0,1,0,0,0.333333333333333,0.729166666666667,0,0.520833333333333,0,"orthodox"
"242570",37,26,185,183,189,191,188,182,40,16,5,4,19,9,"win_A",11,2,-2,6,1,0,0,0,0.888888888888889,0.8,0.422222222222222,0.45,0,"southpaw"
"242803",25,29,169,179,165,180,138,140,126,91,21,25,74,22,"win_A",-4,-10,-15,-2,0,0,0,0,0.857142857142857,0.78448275862069,0.503401360544218,0.189655172413793,0,"orthodox"
"242819",23,27,169,179,165,180,136,136,110,81,15,15,63,21,"win_A",-4,-10,-15,0,0,0,0,0,0.88,0.84375,0.504,0.21875,0,"orthodox"
"242824",22,26,169,179,165,180,140,140,97,77,12,12,53,20,"win_B",-4,-10,-15,0,0,0,0,0,0.889908256880734,0.865168539325843,0.486238532110092,0.224719101123595,1,"orthodox"
"243216",36,32,183,193,201,208,216,245,65,53,10,8,61,33,"win_A",4,-10,-7,-29,1,0,0,1,0.866666666666667,0.868852459016393,0.813333333333333,0.540983606557377,0,"orthodox"
"243218",36,27,183,191,201,203,214,214,63,12,10,2,60,12,"win_A",9,-8,-2,0,1,0,0,0,0.863013698630137,0.857142857142857,0.821917808219178,0.857142857142857,0,"orthodox"
"243234",34,30,191,183,193,201,206,216,30,49,3,4,21,48,"win_A",4,8,-8,-10,0,0,0,0,0.909090909090909,0.924528301886792,0.636363636363636,0.905660377358491,0,"orthodox"
"243268",25,25,183,188,201,193,205,200,14,13,2,9,14,10,"win_A",0,-5,8,5,0,0,0,0,0.875,0.590909090909091,0.875,0.454545454545455,0,"orthodox"
"243271",25,24,180,183,178,201,205,216,9,12,0,1,7,12,"win_A",1,-3,-23,-11,0,0,0,0,1,0.923076923076923,0.777777777777778,0.923076923076923,0,"orthodox"
"243976",28,30,177,171,185,178,165,158,55,56,7,19,34,22,"win_A",-2,6,7,7,0,0,0,0,0.887096774193548,0.746666666666667,0.548387096774194,0.293333333333333,0,"orthodox"
"244074",26,24,164,169,165,170,122,122,28,9,1,4,19,4,"win_A",2,-5,-5,0,0,0,0,0,0.96551724137931,0.692307692307692,0.655172413793103,0.307692307692308,0,"orthodox"
"244098",29,34,180,182,183,188,154,154,27,32,0,3,8,23,"win_A",-5,-2,-5,0,0,0,0,0,1,0.914285714285714,0.296296296296296,0.657142857142857,0,"orthodox"
"244099",32,32,180,182,185,188,153,153,30,31,0,3,19,22,"win_B",0,-2,-3,0,0,0,0,0,1,0.911764705882353,0.633333333333333,0.647058823529412,1,"orthodox"
"244100",31,34,182,173,188,178,153,154,30,38,3,5,21,24,"win_A",-3,9,10,-1,0,0,0,0,0.909090909090909,0.883720930232558,0.636363636363636,0.558139534883721,0,"southpaw"
"244102",29,30,183,182,173,188,154,154,30,29,0,2,22,20,"win_A",-1,1,-15,0,0,0,0,0,1,0.935483870967742,0.733333333333333,0.645161290322581,0,"southpaw"
"244104",26,26,182,175,188,183,154,154,25,19,2,2,20,15,"win_A",0,7,5,0,0,0,0,0,0.925925925925926,0.904761904761905,0.740740740740741,0.714285714285714,0,"southpaw"
"244106",25,26,182,179,188,183,147,146,23,19,2,2,18,16,"win_A",-1,3,5,1,0,0,0,0,0.92,0.904761904761905,0.72,0.761904761904762,0,"southpaw"
"244112",23,29,182,171,188,168,147,147,19,23,0,2,14,12,"win_A",-6,11,20,0,0,0,0,0,1,0.92,0.736842105263158,0.48,0,"southpaw"
"244115",22,30,182,175,188,180,149,150,16,23,0,10,12,13,"win_A",-8,7,8,-1,0,0,0,0,1,0.696969696969697,0.75,0.393939393939394,0,"southpaw"
"244127",21,27,182,179,188,178,144,146,4,2,0,2,4,0,"win_A",-6,3,10,-2,0,0,0,0,1,0.5,1,0,0,"southpaw"
"244300",23,31,160,156,168,165,135,125,99,134,15,34,28,76,"win_B",-8,4,3,10,0,0,0,0,0.868421052631579,0.797619047619048,0.245614035087719,0.452380952380952,1,"southpaw"
"244757",26,26,174,173,180,174,133,135,35,23,3,2,28,18,"win_A",0,1,6,-2,0,0,0,0,0.921052631578947,0.92,0.736842105263158,0.72,0,"southpaw"
"245033",30,27,178,178,180,183,159,160,41,22,10,1,34,10,"win_B",3,0,-3,-1,0,0,0,0,0.803921568627451,0.956521739130435,0.666666666666667,0.434782608695652,1,"orthodox"
"245170",35,28,183,176,188,183,147,149,34,52,3,3,28,31,"win_A",7,7,5,-2,1,0,0,0,0.918918918918919,0.945454545454545,0.756756756756757,0.563636363636364,0,"Unknown"
"245176",31,25,183,180,188,193,154,153,29,24,2,1,27,23,"win_A",6,3,-5,1,0,0,0,0,0.935483870967742,0.96,0.870967741935484,0.92,0,"Unknown"
"245406",31,39,203,193,213,203,234,252,26,34,2,11,22,16,"win_A",-8,10,10,-18,0,1,0,1,0.928571428571429,0.755555555555556,0.785714285714286,0.355555555555556,0,"orthodox"
"245408",38,34,193,191,203,211,224,225,32,27,11,5,16,23,"win_A",4,2,-8,-1,1,0,0,0,0.744186046511628,0.84375,0.372093023255814,0.71875,0,"orthodox"
"245412",31,37,198,193,208,203,232,262,24,31,2,7,15,16,"win_A",-6,5,5,-30,0,1,0,1,0.923076923076923,0.815789473684211,0.576923076923077,0.421052631578947,0,"orthodox"
"245413",28,36,196,193,193,203,228,242,24,31,2,6,13,16,"win_A",-8,3,-10,-14,0,1,0,0,0.923076923076923,0.837837837837838,0.5,0.432432432432432,0,"orthodox"
"245414",27,36,183,193,203,203,238,249,27,31,7,5,19,16,"win_A",-9,-10,0,-11,0,1,0,0,0.794117647058823,0.861111111111111,0.558823529411765,0.444444444444444,0,"orthodox"
"245418",34,31,193,198,203,201,225,247,29,18,3,13,14,16,"win_A",3,-5,2,-22,0,0,0,1,0.90625,0.580645161290323,0.4375,0.516129032258065,0,"orthodox"
"245421",34,31,187,193,192,203,190,188,23,26,10,1,22,13,"win_B",3,-6,-11,2,0,0,0,0,0.696969696969697,0.962962962962963,0.666666666666667,0.481481481481481,1,"orthodox"
"245425",32,28,187,193,192,203,190,189,22,21,9,1,21,11,"win_B",4,-6,-11,1,0,0,0,0,0.709677419354839,0.954545454545455,0.67741935483871,0.5,1,"orthodox"
"245429",27,27,193,178,203,185,188,190,17,19,1,5,8,13,"win_A",0,15,18,-2,0,0,0,0,0.944444444444444,0.791666666666667,0.444444444444444,0.541666666666667,0,"orthodox"
"245432",26,30,193,188,203,196,189,189,14,8,0,2,7,4,"win_A",-4,5,7,0,0,0,0,0,1,0.8,0.5,0.4,0,"orthodox"
"245445",25,28,193,185,203,193,179,180,1,8,0,0,1,6,"win_A",-3,8,10,-1,0,0,0,0,1,1,1,0.75,0,"orthodox"
"245826",30,26,178,184,175,178,155,148,25,17,7,11,17,10,"win_B",4,-6,-3,7,0,0,0,0,0.78125,0.607142857142857,0.53125,0.357142857142857,1,"Unknown"
"245827",24,25,185,184,194,178,159,183,12,17,4,10,9,10,"win_A",-1,1,16,-24,0,0,0,1,0.75,0.62962962962963,0.5625,0.37037037037037,0,"orthodox"
"245828",30,25,178,184,175,178,157,150,20,16,7,9,15,10,"win_A",5,-6,-3,7,0,0,0,0,0.740740740740741,0.64,0.555555555555556,0.4,0,"Unknown"
"245829",29,25,178,184,175,178,155,149,19,15,6,9,14,10,"win_B",4,-6,-3,6,0,0,0,0,0.76,0.625,0.56,0.416666666666667,1,"Unknown"
"245830",28,24,178,184,175,178,159,158,16,14,3,6,11,10,"win_B",4,-6,-3,1,0,0,0,0,0.842105263157895,0.7,0.578947368421053,0.5,1,"Unknown"
"245831",26,24,178,184,191,178,162,182,15,14,1,5,12,10,"win_A",2,-6,13,-20,0,0,0,1,0.9375,0.736842105263158,0.75,0.526315789473684,0,"orthodox"
"245832",22,23,185,184,194,178,154,168,2,13,1,5,2,10,"win_B",-1,1,16,-14,0,0,0,0,0.666666666666667,0.722222222222222,0.666666666666667,0.555555555555556,1,"orthodox"
"245834",23,24,184,174,178,173,154,149,11,15,3,8,10,13,"win_B",-1,10,5,5,0,0,0,0,0.785714285714286,0.652173913043478,0.714285714285714,0.565217391304348,1,"Unknown"
"246356",28,31,180,175,188,183,140,140,27,37,2,3,18,27,"win_A",-3,5,5,0,0,0,0,0,0.931034482758621,0.925,0.620689655172414,0.675,0,"orthodox"
"246359",30,27,175,170,183,170,141,139,34,21,3,4,26,11,"win_A",3,5,13,2,0,0,0,0,0.918918918918919,0.84,0.702702702702703,0.44,0,"orthodox"
"246365",26,29,175,171,183,175,134,135,27,24,2,7,20,18,"win_A",-3,4,8,-1,0,0,0,0,0.931034482758621,0.774193548387097,0.689655172413793,0.580645161290323,0,"orthodox"
"246369",24,39,175,170,183,183,137,139,19,33,2,22,14,14,"win_A",-15,5,0,-2,0,1,0,0,0.904761904761905,0.6,0.666666666666667,0.254545454545455,0,"orthodox"
"246375",23,23,175,173,183,178,135,135,14,12,1,1,9,8,"win_B",0,2,5,0,0,0,0,0,0.933333333333333,0.923076923076923,0.6,0.615384615384615,1,"orthodox"
"246376",22,27,175,172,183,193,133,132,13,22,1,7,9,13,"win_A",-5,3,-10,1,0,0,0,0,0.928571428571429,0.758620689655172,0.642857142857143,0.448275862068966,0,"orthodox"
"246377",21,24,175,175,183,173,135,135,12,11,1,3,8,4,"win_A",-3,0,10,0,0,0,0,0,0.923076923076923,0.785714285714286,0.615384615384615,0.285714285714286,0,"orthodox"
"246378",21,20,175,175,183,178,136,138,11,10,1,1,8,8,"win_A",1,0,5,-2,0,0,0,0,0.916666666666667,0.909090909090909,0.666666666666667,0.727272727272727,0,"orthodox"
"246973",30,35,175,173,193,175,168,168,30,63,3,3,23,42,"win_A",-5,2,18,0,0,1,0,0,0.909090909090909,0.954545454545455,0.696969696969697,0.636363636363636,0,"orthodox"
"247005",27,31,170,168,175,175,126,126,23,35,2,2,13,23,"win_A",-4,2,0,0,0,0,0,0,0.92,0.945945945945946,0.52,0.621621621621622,0,"orthodox"
"247013",23,33,170,173,175,178,126,125,12,24,1,5,4,10,"win_A",-10,-3,-3,1,0,0,0,0,0.923076923076923,0.827586206896552,0.307692307692308,0.344827586206897,0,"orthodox"
"247536",28,28,165,165,173,170,128,128,41,40,3,19,24,31,"win_A",0,0,3,0,0,0,0,0,0.931818181818182,0.677966101694915,0.545454545454545,0.525423728813559,0,"orthodox"
"247537",28,24,165,157,173,152,112,112,40,25,3,7,23,13,"win_A",4,8,21,0,0,0,0,0,0.930232558139535,0.78125,0.534883720930233,0.40625,0,"orthodox"
"247541",22,27,159,165,157,173,112,112,15,36,6,3,8,22,"win_B",-5,-6,-16,0,0,0,0,0,0.714285714285714,0.923076923076923,0.380952380952381,0.564102564102564,1,"orthodox"
"247544",25,24,165,157,173,168,115,116,33,17,3,5,22,7,"win_A",1,8,5,-1,0,0,0,0,0.916666666666667,0.772727272727273,0.611111111111111,0.318181818181818,0,"orthodox"
"247548",24,30,165,160,173,163,112,112,29,27,2,9,19,15,"win_A",-6,5,10,0,0,0,0,0,0.935483870967742,0.75,0.612903225806452,0.416666666666667,0,"orthodox"
"247551",23,26,165,160,173,157,112,111,26,24,2,8,17,8,"win_A",-3,5,16,1,0,0,0,0,0.928571428571429,0.75,0.607142857142857,0.25,0,"orthodox"
"247556",21,27,165,160,173,163,108,108,23,25,0,5,15,13,"win_B",-6,5,10,0,0,0,0,0,1,0.833333333333333,0.652173913043478,0.433333333333333,1,"orthodox"
"247558",21,23,165,160,173,160,108,108,21,15,0,1,15,12,"win_A",-2,5,13,0,0,0,0,0,1,0.9375,0.714285714285714,0.75,0,"orthodox"
"247580",30,33,173,167,180,173,147,147,28,32,4,2,6,24,"win_A",-3,6,7,0,0,0,0,0,0.875,0.941176470588235,0.1875,0.705882352941177,0,"orthodox"
"247584",28,33,173,175,180,178,141,142,25,16,2,6,5,9,"win_A",-5,-2,2,-1,0,0,0,0,0.925925925925926,0.727272727272727,0.185185185185185,0.409090909090909,0,"orthodox"
"247586",27,28,173,175,180,185,139,140,23,16,1,1,5,9,"win_A",-1,-2,-5,-1,0,0,0,0,0.958333333333333,0.941176470588235,0.208333333333333,0.529411764705882,0,"orthodox"
"247588",25,23,173,173,180,191,140,139,20,16,0,1,5,9,"win_A",2,0,-11,1,0,0,0,0,1,0.941176470588235,0.25,0.529411764705882,0,"orthodox"
"247725",26,32,178,188,188,201,174,174,18,41,0,5,17,25,"win_A",-6,-10,-13,0,0,0,0,0,1,0.891304347826087,0.944444444444444,0.543478260869565,0,"orthodox"
"248296",25,31,198,175,213,183,247,240,54,77,5,25,48,54,"win_A",-6,23,30,7,0,0,0,0,0.915254237288136,0.754901960784314,0.813559322033898,0.529411764705882,0,"orthodox"
"248299",28,23,175,191,183,208,232,216,73,13,23,6,50,5,"win_A",5,-16,-25,16,0,0,1,0,0.760416666666667,0.684210526315789,0.520833333333333,0.263157894736842,0,"orthodox"
"248301",28,27,175,180,183,193,227,208,71,15,23,2,48,5,"win_A",1,-5,-10,19,0,0,1,0,0.75531914893617,0.882352941176471,0.51063829787234,0.294117647058824,0,"orthodox"
"248328",24,22,175,187,183,222,216,185,49,46,17,13,32,15,"win_B",2,-12,-39,31,0,0,1,0,0.742424242424242,0.779661016949153,0.484848484848485,0.254237288135593,1,"orthodox"
"248329",24,26,175,189,183,185,216,206,49,36,16,21,32,16,"win_B",-2,-14,-2,10,0,0,0,0,0.753846153846154,0.631578947368421,0.492307692307692,0.280701754385965,1,"orthodox"
"248331",24,26,175,189,183,185,223,204,48,36,15,20,32,16,"win_A",-2,-14,-2,19,0,0,1,0,0.761904761904762,0.642857142857143,0.507936507936508,0.285714285714286,0,"orthodox"
"248504",28,31,180,175,188,183,140,140,27,37,2,3,18,27,"win_A",-3,5,5,0,0,0,0,0,0.931034482758621,0.925,0.620689655172414,0.675,0,"orthodox"
"248507",30,27,175,170,183,170,141,139,34,21,3,4,26,11,"win_A",3,5,13,2,0,0,0,0,0.918918918918919,0.84,0.702702702702703,0.44,0,"orthodox"
"248513",26,29,175,171,183,175,134,135,27,24,2,7,20,18,"win_A",-3,4,8,-1,0,0,0,0,0.931034482758621,0.774193548387097,0.689655172413793,0.580645161290323,0,"orthodox"
"248517",24,39,175,170,183,183,137,139,19,33,2,22,14,14,"win_A",-15,5,0,-2,0,1,0,0,0.904761904761905,0.6,0.666666666666667,0.254545454545455,0,"orthodox"
"248523",23,23,175,173,183,178,135,135,14,12,1,1,9,8,"win_B",0,2,5,0,0,0,0,0,0.933333333333333,0.923076923076923,0.6,0.615384615384615,1,"orthodox"
"248524",22,27,175,172,183,193,133,132,13,22,1,7,9,13,"win_A",-5,3,-10,1,0,0,0,0,0.928571428571429,0.758620689655172,0.642857142857143,0.448275862068966,0,"orthodox"
"248525",21,24,175,175,183,173,135,135,12,11,1,3,8,4,"win_A",-3,0,10,0,0,0,0,0,0.923076923076923,0.785714285714286,0.615384615384615,0.285714285714286,0,"orthodox"
"248526",21,20,175,175,183,178,136,138,11,10,1,1,8,8,"win_A",1,0,5,-2,0,0,0,0,0.916666666666667,0.909090909090909,0.666666666666667,0.727272727272727,0,"orthodox"
"249121",30,35,175,173,193,175,168,168,30,63,3,3,23,42,"win_A",-5,2,18,0,0,1,0,0,0.909090909090909,0.954545454545455,0.696969696969697,0.636363636363636,0,"orthodox"
"249153",27,31,170,168,175,175,126,126,23,35,2,2,13,23,"win_A",-4,2,0,0,0,0,0,0,0.92,0.945945945945946,0.52,0.621621621621622,0,"orthodox"
"249161",23,33,170,173,175,178,126,125,12,24,1,5,4,10,"win_A",-10,-3,-3,1,0,0,0,0,0.923076923076923,0.827586206896552,0.307692307692308,0.344827586206897,0,"orthodox"
"249684",28,28,165,165,173,170,128,128,41,40,3,19,24,31,"win_A",0,0,3,0,0,0,0,0,0.931818181818182,0.677966101694915,0.545454545454545,0.525423728813559,0,"orthodox"
"249685",28,24,165,157,173,152,112,112,40,25,3,7,23,13,"win_A",4,8,21,0,0,0,0,0,0.930232558139535,0.78125,0.534883720930233,0.40625,0,"orthodox"
"249689",22,27,159,165,157,173,112,112,15,36,6,3,8,22,"win_B",-5,-6,-16,0,0,0,0,0,0.714285714285714,0.923076923076923,0.380952380952381,0.564102564102564,1,"orthodox"
"249692",25,24,165,157,173,168,115,116,33,17,3,5,22,7,"win_A",1,8,5,-1,0,0,0,0,0.916666666666667,0.772727272727273,0.611111111111111,0.318181818181818,0,"orthodox"
"249696",24,30,165,160,173,163,112,112,29,27,2,9,19,15,"win_A",-6,5,10,0,0,0,0,0,0.935483870967742,0.75,0.612903225806452,0.416666666666667,0,"orthodox"
"249699",23,26,165,160,173,157,112,111,26,24,2,8,17,8,"win_A",-3,5,16,1,0,0,0,0,0.928571428571429,0.75,0.607142857142857,0.25,0,"orthodox"
"249704",21,27,165,160,173,163,108,108,23,25,0,5,15,13,"win_B",-6,5,10,0,0,0,0,0,1,0.833333333333333,0.652173913043478,0.433333333333333,1,"orthodox"
"249706",21,23,165,160,173,160,108,108,21,15,0,1,15,12,"win_A",-2,5,13,0,0,0,0,0,1,0.9375,0.714285714285714,0.75,0,"orthodox"
"249728",30,33,173,167,180,173,147,147,28,32,4,2,6,24,"win_A",-3,6,7,0,0,0,0,0,0.875,0.941176470588235,0.1875,0.705882352941177,0,"orthodox"
"249732",28,33,173,175,180,178,141,142,25,16,2,6,5,9,"win_A",-5,-2,2,-1,0,0,0,0,0.925925925925926,0.727272727272727,0.185185185185185,0.409090909090909,0,"orthodox"
"249734",27,28,173,175,180,185,139,140,23,16,1,1,5,9,"win_A",-1,-2,-5,-1,0,0,0,0,0.958333333333333,0.941176470588235,0.208333333333333,0.529411764705882,0,"orthodox"
"249736",25,23,173,173,180,191,140,139,20,16,0,1,5,9,"win_A",2,0,-11,1,0,0,0,0,1,0.941176470588235,0.25,0.529411764705882,0,"orthodox"
"249873",26,32,178,188,188,201,174,174,18,41,0,5,17,25,"win_A",-6,-10,-13,0,0,0,0,0,1,0.891304347826087,0.944444444444444,0.543478260869565,0,"orthodox"
"250444",25,31,198,175,213,183,247,240,54,77,5,25,48,54,"win_A",-6,23,30,7,0,0,0,0,0.915254237288136,0.754901960784314,0.813559322033898,0.529411764705882,0,"orthodox"
"250447",28,23,175,191,183,208,232,216,73,13,23,6,50,5,"win_A",5,-16,-25,16,0,0,1,0,0.760416666666667,0.684210526315789,0.520833333333333,0.263157894736842,0,"orthodox"
"250449",28,27,175,180,183,193,227,208,71,15,23,2,48,5,"win_A",1,-5,-10,19,0,0,1,0,0.75531914893617,0.882352941176471,0.51063829787234,0.294117647058824,0,"orthodox"
"250476",24,22,175,187,183,222,216,185,49,46,17,13,32,15,"win_B",2,-12,-39,31,0,0,1,0,0.742424242424242,0.779661016949153,0.484848484848485,0.254237288135593,1,"orthodox"
"250477",24,26,175,189,183,185,216,206,49,36,16,21,32,16,"win_B",-2,-14,-2,10,0,0,0,0,0.753846153846154,0.631578947368421,0.492307692307692,0.280701754385965,1,"orthodox"
"250479",24,26,175,189,183,185,223,204,48,36,15,20,32,16,"win_A",-2,-14,-2,19,0,0,1,0,0.761904761904762,0.642857142857143,0.507936507936508,0.285714285714286,0,"orthodox"
"250659",31,25,198,188,208,193,215,198,40,13,7,10,18,10,"win_A",6,10,15,17,0,0,1,0,0.851063829787234,0.565217391304348,0.382978723404255,0.434782608695652,0,"orthodox"
"250679",32,21,185,198,196,208,198,208,13,19,13,3,9,10,"win_B",11,-13,-12,-10,0,0,0,0,0.5,0.863636363636364,0.346153846153846,0.454545454545455,1,"orthodox"
"250720",24,27,175,168,170,168,123,122,26,20,2,16,17,13,"win_A",-3,7,2,1,0,0,0,0,0.928571428571429,0.555555555555556,0.607142857142857,0.361111111111111,0,"orthodox"
"250721",23,25,175,170,170,170,124,125,25,19,2,6,17,8,"win_A",-2,5,0,-1,0,0,0,0,0.925925925925926,0.76,0.62962962962963,0.32,0,"orthodox"
"250722",23,28,175,162,170,163,124,123,24,21,2,8,17,11,"win_A",-5,13,7,1,0,0,0,0,0.923076923076923,0.724137931034483,0.653846153846154,0.379310344827586,0,"orthodox"
"250723",23,26,175,170,170,168,126,126,23,29,2,7,16,25,"win_A",-3,5,2,0,0,0,0,0,0.92,0.805555555555556,0.64,0.694444444444444,0,"orthodox"
"250727",22,22,175,168,170,175,126,128,19,16,1,3,15,10,"win_A",0,7,-5,-2,0,0,0,0,0.95,0.842105263157895,0.75,0.526315789473684,0,"orthodox"
"250728",21,28,175,163,170,160,126,127,19,21,0,21,15,14,"win_B",-7,12,10,-1,0,0,0,0,1,0.5,0.789473684210526,0.333333333333333,1,"orthodox"
"250754",28,38,179,191,188,203,168,168,20,29,0,3,16,24,"win_A",-10,-12,-15,0,0,1,0,0,1,0.90625,0.8,0.75,0,"orthodox"
"250755",27,28,179,185,188,191,167,167,18,26,0,1,14,15,"win_A",-1,-6,-3,0,0,0,0,0,1,0.962962962962963,0.777777777777778,0.555555555555556,0,"orthodox"
"250756",27,27,179,183,188,178,168,166,17,26,0,6,14,17,"win_A",0,-4,10,2,0,0,0,0,1,0.8125,0.823529411764706,0.53125,0,"orthodox"
"250757",27,32,179,175,188,191,168,167,16,35,0,2,13,23,"win_A",-5,4,-3,1,0,0,0,0,1,0.945945945945946,0.8125,0.621621621621622,0,"orthodox"
"250761",25,33,179,180,188,178,168,166,12,37,0,3,10,16,"win_A",-8,-1,10,2,0,0,0,0,1,0.925,0.833333333333333,0.4,0,"orthodox"
"250771",24,36,179,178,188,188,168,165,2,14,0,7,2,11,"win_A",-12,1,0,3,0,1,0,0,1,0.666666666666667,1,0.523809523809524,0,"orthodox"
"251257",26,33,185,179,185,188,178,212,8,38,0,0,2,32,"win_A",-7,6,-3,-34,0,0,0,1,1,1,0.25,0.842105263157895,0,"orthodox"
"251377",34,35,173,184,193,188,185,200,178,85,53,18,108,48,"win_A",-1,-11,5,-15,0,1,0,1,0.770562770562771,0.825242718446602,0.467532467532468,0.466019417475728,0,"southpaw"
"251400",23,29,196,173,211,193,175,203,10,166,1,41,7,100,"win_A",-6,23,18,-28,0,0,0,1,0.909090909090909,0.801932367149758,0.636363636363636,0.483091787439614,0,"orthodox"
"251410",29,30,173,179,193,183,165,181,157,10,40,1,94,8,"win_A",-1,-6,10,-16,0,0,0,1,0.796954314720812,0.909090909090909,0.477157360406091,0.727272727272727,0,"southpaw"
"251421",27,26,187,173,188,193,162,182,40,146,12,39,31,86,"win_A",1,14,-5,-20,0,0,0,1,0.769230769230769,0.789189189189189,0.596153846153846,0.464864864864865,0,"orthodox"
"251437",24,25,183,173,188,193,172,180,29,131,12,38,3,75,"win_B",-1,10,-5,-8,0,0,0,0,0.707317073170732,0.775147928994083,0.0731707317073171,0.443786982248521,1,"Unknown"
"251438",25,24,173,183,193,188,173,181,130,29,38,11,75,3,"win_A",1,-10,5,-8,0,0,0,0,0.773809523809524,0.725,0.446428571428571,0.075,0,"southpaw"
"252363",26,26,171,171,180,178,145,147,63,55,11,23,18,10,"win_A",0,0,2,-2,0,0,0,0,0.851351351351351,0.705128205128205,0.243243243243243,0.128205128205128,0,"Unknown"
"252454",26,28,180,193,188,209,204,207,72,88,30,32,38,39,"win_A",-2,-13,-21,-3,0,0,0,0,0.705882352941177,0.733333333333333,0.372549019607843,0.325,0,"Unknown"
"252464",27,25,189,180,185,188,204,207,38,65,21,26,17,36,"win_A",2,9,-3,-3,0,0,0,0,0.644067796610169,0.714285714285714,0.288135593220339,0.395604395604396,0,"Unknown"
"252471",24,26,180,193,188,209,204,196,58,82,25,24,32,37,"win_A",-2,-13,-21,8,0,0,0,0,0.698795180722892,0.773584905660377,0.385542168674699,0.349056603773585,0,"Unknown"
"252487",22,25,180,183,188,193,201,178,42,77,19,30,23,22,"win_B",-3,-3,-5,23,0,0,1,0,0.688524590163934,0.719626168224299,0.377049180327869,0.205607476635514,1,"Unknown"
"252703",27,21,180,173,188,178,143,143,25,22,2,19,17,5,"win_A",6,7,10,0,0,0,0,0,0.925925925925926,0.536585365853659,0.62962962962963,0.121951219512195,0,"orthodox"
"252704",33,27,179,180,185,188,139,139,19,25,2,1,17,17,"win_A",6,-1,-3,0,0,0,0,0,0.904761904761905,0.961538461538462,0.80952380952381,0.653846153846154,0,"orthodox"
"252709",23,28,180,173,188,175,139,137,18,22,1,3,15,19,"win_A",-5,7,13,2,0,0,0,0,0.947368421052632,0.88,0.789473684210526,0.76,0,"orthodox"
"252710",22,26,180,173,188,178,140,138,17,20,1,4,14,14,"win_A",-4,7,10,2,0,0,0,0,0.944444444444444,0.833333333333333,0.777777777777778,0.583333333333333,0,"orthodox"
"252712",31,21,180,180,185,188,140,141,37,16,7,0,16,13,"win_A",10,0,-3,-1,0,0,0,0,0.840909090909091,1,0.363636363636364,0.8125,0,"orthodox"
"252914",20,26,171,168,180,170,145,145,8,22,1,3,2,18,"win_A",-6,3,10,0,0,0,0,0,0.888888888888889,0.88,0.222222222222222,0.72,0,"Unknown"
"252968",31,28,166,173,180,180,118,117,24,37,0,3,21,23,"win_A",3,-7,0,1,0,0,0,0,1,0.925,0.875,0.575,0,"southpaw"
"252970",30,31,166,168,180,180,118,118,22,18,0,3,20,16,"win_A",-1,-2,0,0,0,0,0,0,1,0.857142857142857,0.909090909090909,0.761904761904762,0,"southpaw"
"252971",29,28,166,168,180,173,117,117,21,20,0,0,19,11,"win_A",1,-2,7,0,0,0,0,0,1,1,0.904761904761905,0.55,0,"southpaw"
"252977",26,24,166,165,180,178,118,118,15,21,0,0,14,13,"win_A",2,1,2,0,0,0,0,0,1,1,0.933333333333333,0.619047619047619,0,"southpaw"
"253072",29,32,180,175,185,185,189,182,53,33,19,39,17,7,"win_A",-3,5,0,7,0,0,0,0,0.736111111111111,0.458333333333333,0.236111111111111,0.0972222222222222,0,"orthodox"
"253119",22,28,175,178,185,183,180,174,3,24,10,11,2,11,"win_A",-6,-3,2,6,0,0,0,0,0.230769230769231,0.685714285714286,0.153846153846154,0.314285714285714,0,"Unknown"
"253120",22,33,175,179,185,187,180,158,2,41,10,23,1,16,"win_A",-11,-4,-2,22,0,0,1,0,0.166666666666667,0.640625,0.0833333333333333,0.25,0,"Unknown"
"253122",21,32,175,179,185,187,186,165,2,38,6,20,1,14,"win_B",-11,-4,-2,21,0,0,1,0,0.25,0.655172413793103,0.125,0.241379310344828,1,"Unknown"
"253123",21,27,175,178,185,183,190,176,2,18,5,8,1,8,"win_B",-6,-3,2,14,0,0,0,0,0.285714285714286,0.692307692307692,0.142857142857143,0.307692307692308,1,"Unknown"
"253126",20,34,175,180,185,185,189,187,1,38,3,16,1,25,"win_B",-14,-5,0,2,0,0,0,0,0.25,0.703703703703704,0.25,0.462962962962963,1,"Unknown"
"253127",34,20,180,175,185,185,190,195,37,1,16,2,25,1,"win_A",14,5,0,-5,0,0,0,0,0.69811320754717,0.333333333333333,0.471698113207547,0.333333333333333,0,"Unknown"
"253129",24,19,178,175,183,185,180,170,11,0,4,1,3,0,"win_A",5,3,-2,10,0,0,0,0,0.733333333333333,0,0.2,0,0,"Unknown"
"253180",28,39,174,168,174,170,146,145,14,40,0,9,12,19,"win_A",-11,6,4,1,0,1,0,0,1,0.816326530612245,0.857142857142857,0.387755102040816,0,"southpaw"
"253202",26,27,168,175,170,183,135,135,18,26,0,1,9,19,"win_A",-1,-7,-13,0,0,0,0,0,1,0.962962962962963,0.5,0.703703703703704,0,"orthodox"
"253431",41,28,199,189,211,201,242,214,25,21,6,2,20,18,"win_B",13,10,10,28,1,0,1,0,0.806451612903226,0.91304347826087,0.645161290322581,0.782608695652174,1,"orthodox"
"253435",32,26,199,198,211,213,236,207,20,15,5,3,16,12,"win_A",6,1,-2,29,0,0,1,0,0.8,0.833333333333333,0.64,0.666666666666667,0,"orthodox"
"253445",30,26,199,179,211,185,221,196,11,13,2,4,8,12,"win_A",4,20,26,25,0,0,1,0,0.846153846153846,0.764705882352941,0.615384615384615,0.705882352941177,0,"orthodox"
"253447",30,27,199,187,211,196,224,204,9,13,2,3,7,9,"win_A",3,12,15,20,0,0,1,0,0.818181818181818,0.8125,0.636363636363636,0.5625,0,"orthodox"
"253697",27,37,175,173,180,183,140,141,20,46,1,24,12,34,"win_A",-10,2,-3,-1,0,1,0,0,0.952380952380952,0.657142857142857,0.571428571428571,0.485714285714286,0,"orthodox"
"253722",27,25,177,173,173,183,140,140,38,23,4,15,26,14,"win_A",2,4,-10,0,0,0,0,0,0.904761904761905,0.605263157894737,0.619047619047619,0.368421052631579,0,"orthodox"
"254177",25,21,161,163,178,170,111,112,20,14,0,3,14,5,"win_A",4,-2,8,-1,0,0,0,0,1,0.823529411764706,0.7,0.294117647058824,0,"orthodox"
"254249",32,27,187,185,190,180,154,154,29,39,2,7,16,23,"win_B",5,2,10,0,0,0,0,0,0.935483870967742,0.847826086956522,0.516129032258065,0.5,1,"Unknown"
"254255",27,21,187,171,190,178,155,156,22,12,0,0,11,9,"win_A",6,16,12,-1,0,0,0,0,1,1,0.5,0.75,0,"Unknown"
"254270",24,24,187,173,190,178,156,154,7,7,0,3,3,1,"win_A",0,14,12,2,0,0,0,0,1,0.7,0.428571428571429,0.1,0,"Unknown"
"254350",23,38,160,160,163,150,105,105,23,62,4,8,13,32,"win_A",-15,0,13,0,0,1,0,0,0.851851851851852,0.885714285714286,0.481481481481481,0.457142857142857,0,"southpaw"
"254355",32,32,160,152,150,165,105,105,58,34,5,1,30,29,"win_A",0,8,-15,0,0,0,0,0,0.920634920634921,0.971428571428571,0.476190476190476,0.828571428571429,0,"orthodox"
"254358",31,27,160,160,150,178,105,108,55,25,5,12,28,9,"win_A",4,0,-28,-3,0,0,0,0,0.916666666666667,0.675675675675676,0.466666666666667,0.243243243243243,0,"orthodox"
"254665",33,21,169,178,173,178,160,163,56,18,9,0,42,11,"win_B",12,-9,-5,-3,0,0,0,0,0.861538461538462,1,0.646153846153846,0.611111111111111,1,"Unknown"
"254728",25,30,183,193,185,193,159,160,18,26,0,2,4,17,"win_A",-5,-10,-8,-1,0,0,0,0,1,0.928571428571429,0.222222222222222,0.607142857142857,0,"orthodox"
"254980",35,31,163,156,168,152,107,106,17,37,2,13,7,22,"win_A",4,7,16,1,1,0,0,0,0.894736842105263,0.74,0.368421052631579,0.44,0,"orthodox"
"254982",28,29,156,159,152,163,107,107,35,29,13,2,20,20,"win_A",-1,-3,-11,0,0,0,0,0,0.729166666666667,0.935483870967742,0.416666666666667,0.645161290322581,0,"orthodox"
"254984",27,30,156,160,152,152,109,108,33,28,13,5,19,20,"win_A",-3,-4,0,1,0,0,0,0,0.717391304347826,0.848484848484849,0.41304347826087,0.606060606060606,0,"orthodox"
"254998",23,22,159,156,163,152,105,105,24,22,1,7,18,11,"win_A",1,3,11,0,0,0,0,0,0.96,0.758620689655172,0.72,0.379310344827586,0,"orthodox"
"255001",22,21,156,163,152,163,107,107,19,14,7,3,9,10,"win_A",1,-7,-11,0,0,0,0,0,0.730769230769231,0.823529411764706,0.346153846153846,0.588235294117647,0,"orthodox"
"255004",21,21,157,156,152,152,108,108,12,16,4,7,7,8,"win_B",0,1,0,0,0,0,0,0,0.75,0.695652173913043,0.4375,0.347826086956522,1,"orthodox"
"255011",20,19,156,159,152,157,115,112,9,1,7,1,4,0,"win_A",1,-3,-5,3,0,0,0,0,0.5625,0.5,0.25,0,0,"orthodox"
"255024",19,19,156,160,152,163,107,109,0,9,3,1,0,7,"win_B",0,-4,-11,-2,0,0,0,0,0,0.9,0,0.7,1,"orthodox"
"255033",24,21,175,173,175,178,131,135,9,5,0,3,6,1,"win_A",3,2,-3,-4,0,0,0,0,1,0.625,0.666666666666667,0.125,0,"orthodox"
"255037",23,26,175,175,175,178,133,136,5,4,0,5,2,2,"win_A",-3,0,-3,-3,0,0,0,0,1,0.444444444444444,0.4,0.222222222222222,0,"orthodox"
"255232",29,31,173,170,178,178,150,150,31,22,2,5,20,16,"win_A",-2,3,0,0,0,0,0,0,0.939393939393939,0.814814814814815,0.606060606060606,0.592592592592593,0,"orthodox"
"255235",26,31,173,183,178,188,147,147,26,18,1,7,19,12,"win_A",-5,-10,-10,0,0,0,0,0,0.962962962962963,0.72,0.703703703703704,0.48,0,"orthodox"
"255473",31,34,187,183,185,188,175,175,41,31,3,2,7,21,"win_A",-3,4,-3,0,0,0,0,0,0.931818181818182,0.939393939393939,0.159090909090909,0.636363636363636,0,"Unknown"
"255530",27,30,163,162,165,162,125,126,28,36,15,25,6,12,"win_A",-3,1,3,-1,0,0,0,0,0.651162790697674,0.590163934426229,0.13953488372093,0.19672131147541,0,"Unknown"
"255578",22,18,162,150,162,160,111,111,6,3,2,3,1,3,"win_A",4,12,2,0,0,0,0,0,0.75,0.5,0.125,0.5,0,"orthodox"
"255582",21,17,162,150,162,160,111,111,3,1,1,1,0,1,"win_A",4,12,2,0,0,0,0,0,0.75,0.5,0,0.5,0,"orthodox"
"255723",29,30,173,180,173,183,155,154,28,28,1,1,18,8,"win_A",-1,-7,-10,1,0,0,0,0,0.96551724137931,0.96551724137931,0.620689655172414,0.275862068965517,0,"orthodox"
"255725",28,33,180,175,183,188,155,153,25,22,0,6,8,11,"win_A",-5,5,-5,2,0,0,0,0,1,0.785714285714286,0.32,0.392857142857143,0,"orthodox"
"255733",24,25,180,180,183,188,156,154,17,16,0,0,7,12,"win_A",-1,0,-5,2,0,0,0,0,1,1,0.411764705882353,0.75,0,"orthodox"
"256059",27,31,173,166,180,170,117,118,35,42,2,2,22,31,"win_A",-4,7,10,-1,0,0,0,0,0.945945945945946,0.954545454545455,0.594594594594595,0.704545454545455,0,"orthodox"
"256060",26,31,173,170,180,160,118,118,34,17,2,4,22,8,"win_A",-5,3,20,0,0,0,0,0,0.944444444444444,0.80952380952381,0.611111111111111,0.380952380952381,0,"orthodox"
"256061",32,26,163,173,160,180,120,124,24,32,33,1,16,22,"win_B",6,-10,-20,-4,0,0,0,0,0.421052631578947,0.96969696969697,0.280701754385965,0.666666666666667,1,"orthodox"
"256062",25,33,173,164,180,163,120,124,31,29,1,14,21,18,"win_A",-8,9,17,-4,0,0,0,0,0.96875,0.674418604651163,0.65625,0.418604651162791,0,"orthodox"
"256065",22,24,168,173,173,180,117,118,11,28,1,1,9,19,"win_B",-2,-5,-7,-1,0,0,0,0,0.916666666666667,0.96551724137931,0.75,0.655172413793103,1,"orthodox"
"256069",23,29,173,165,180,168,119,120,24,22,1,4,19,13,"win_A",-6,8,12,-1,0,0,0,0,0.96,0.846153846153846,0.76,0.5,0,"orthodox"
"256076",22,24,173,169,180,173,117,118,17,24,1,4,15,19,"win_A",-2,4,7,-1,0,0,0,0,0.944444444444444,0.857142857142857,0.833333333333333,0.678571428571429,0,"orthodox"
"256090",22,19,165,173,173,180,123,126,10,4,0,0,7,4,"win_A",3,-8,-7,-3,0,0,0,0,1,1,0.7,1,0,"southpaw"
"256897",31,26,162,175,163,183,137,138,17,17,0,0,6,14,"win_A",5,-13,-20,-1,0,0,0,0,1,1,0.352941176470588,0.823529411764706,0,"orthodox"
"257244",30,34,185,183,188,183,177,178,19,41,2,4,16,24,"win_A",-4,2,5,-1,0,0,0,0,0.904761904761905,0.911111111111111,0.761904761904762,0.533333333333333,0,"orthodox"
"257251",31,29,183,183,183,185,174,174,34,20,4,3,20,10,"win_A",2,0,-2,0,0,0,0,0,0.894736842105263,0.869565217391304,0.526315789473684,0.434782608695652,0,"orthodox"
"257259",30,26,187,183,192,183,175,175,19,26,8,2,18,15,"win_B",4,4,9,0,0,0,0,0,0.703703703703704,0.928571428571429,0.666666666666667,0.535714285714286,1,"orthodox"
"257407",49,39,193,183,208,191,273,248,68,21,13,21,41,12,"win_A",10,10,17,25,1,1,1,0,0.839506172839506,0.5,0.506172839506173,0.285714285714286,0,"orthodox"
"257484",34,24,160,168,168,168,112,112,31,22,10,18,27,12,"win_B",10,-8,0,0,0,0,0,0,0.75609756097561,0.55,0.658536585365854,0.3,1,"Unknown"
"257485",33,22,160,160,168,168,112,112,31,16,9,1,27,4,"win_B",11,0,0,0,0,0,0,0,0.775,0.941176470588235,0.675,0.235294117647059,1,"Unknown"
"257489",31,28,160,160,168,170,106,107,28,16,7,2,24,13,"win_A",3,0,-2,-1,0,0,0,0,0.8,0.888888888888889,0.685714285714286,0.722222222222222,0,"Unknown"
"257492",30,20,160,157,168,152,108,108,27,10,5,4,23,6,"win_B",10,3,16,0,0,0,0,0,0.84375,0.714285714285714,0.71875,0.428571428571429,1,"Unknown"
"257493",29,29,160,160,168,163,108,108,26,27,5,7,22,15,"win_A",0,0,5,0,0,0,0,0,0.838709677419355,0.794117647058823,0.709677419354839,0.441176470588235,0,"Unknown"
"257494",29,20,160,157,168,152,108,108,25,7,5,3,22,4,"win_A",9,3,16,0,0,0,0,0,0.833333333333333,0.7,0.733333333333333,0.4,0,"Unknown"
"257499",28,24,160,160,168,160,108,108,20,17,5,2,17,13,"win_A",4,0,8,0,0,0,0,0,0.8,0.894736842105263,0.68,0.684210526315789,0,"Unknown"
"257501",28,27,160,160,168,163,108,108,18,26,5,5,15,14,"win_A",1,0,5,0,0,0,0,0,0.782608695652174,0.838709677419355,0.652173913043478,0.451612903225806,0,"Unknown"
"257573",23,20,157,166,183,170,131,124,14,69,4,4,4,12,"win_A",3,-9,13,7,0,0,0,0,0.777777777777778,0.945205479452055,0.222222222222222,0.164383561643836,0,"orthodox"
"257592",30,19,169,166,175,170,128,128,128,52,31,0,59,10,"win_A",11,3,5,0,0,0,0,0,0.805031446540881,1,0.371069182389937,0.192307692307692,0,"orthodox"
"257645",23,27,180,180,183,188,183,186,46,115,8,27,17,46,"win_A",-4,0,-5,-3,0,0,0,0,0.851851851851852,0.809859154929577,0.314814814814815,0.323943661971831,0,"orthodox"
"257793",29,35,177,180,180,185,189,182,28,15,3,11,16,9,"win_A",-6,-3,-5,7,0,1,0,0,0.903225806451613,0.576923076923077,0.516129032258065,0.346153846153846,0,"orthodox"
"258225",36,38,177,175,183,178,172,157,25,20,29,6,14,19,"win_B",-2,2,5,15,1,1,1,0,0.462962962962963,0.769230769230769,0.259259259259259,0.730769230769231,1,"Unknown"
"258229",35,38,177,175,183,178,168,152,24,16,28,5,13,15,"win_B",-3,2,5,16,1,1,1,0,0.461538461538462,0.761904761904762,0.25,0.714285714285714,1,"Unknown"
"258287",25,29,175,173,183,175,154,153,35,55,1,2,22,38,"win_B",-4,2,8,1,0,0,0,0,0.972222222222222,0.964912280701754,0.611111111111111,0.666666666666667,1,"southpaw"
"258297",26,27,178,173,188,175,153,154,38,44,1,1,23,32,"win_B",-1,5,13,-1,0,0,0,0,0.974358974358974,0.977777777777778,0.58974358974359,0.711111111111111,1,"orthodox"
"258446",28,26,171,168,179,170,115,115,25,19,2,0,12,12,"win_A",2,3,9,0,0,0,0,0,0.925925925925926,1,0.444444444444444,0.631578947368421,0,"orthodox"
"258936",41,23,170,180,175,193,136,136,45,12,8,2,37,9,"win_B",18,-10,-18,0,1,0,0,0,0.849056603773585,0.857142857142857,0.69811320754717,0.642857142857143,1,"orthodox"
"259814",27,34,183,178,188,183,187,177,17,51,6,31,8,21,"win_A",-7,5,5,10,0,0,0,0,0.739130434782609,0.621951219512195,0.347826086956522,0.25609756097561,0,"Unknown"
"260680",27,34,183,178,188,183,187,177,17,51,6,31,8,21,"win_A",-7,5,5,10,0,0,0,0,0.739130434782609,0.621951219512195,0.347826086956522,0.25609756097561,0,"Unknown"
"260864",33,34,166,163,170,160,124,129,43,24,3,39,32,16,"win_A",-1,3,10,-5,0,0,0,0,0.934782608695652,0.380952380952381,0.695652173913043,0.253968253968254,0,"orthodox"
"260871",28,19,166,170,170,175,118,118,36,17,1,5,28,13,"win_A",9,-4,-5,0,0,0,0,0,0.972972972972973,0.772727272727273,0.756756756756757,0.590909090909091,0,"orthodox"
"260874",27,26,166,159,170,160,119,118,33,36,1,5,25,25,"win_A",1,7,10,1,0,0,0,0,0.970588235294118,0.878048780487805,0.735294117647059,0.609756097560976,0,"orthodox"
"260940",36,25,187,191,192,198,190,188,26,16,12,1,24,13,"win_B",11,-4,-6,2,1,0,0,0,0.684210526315789,0.941176470588235,0.631578947368421,0.764705882352941,1,"orthodox"
"260941",35,26,187,180,192,183,188,190,24,27,12,5,23,26,"win_A",9,7,9,-2,1,0,0,0,0.666666666666667,0.84375,0.638888888888889,0.8125,0,"orthodox"
"260949",28,25,187,185,192,193,174,172,17,11,6,8,16,2,"win_B",3,2,-1,2,0,0,0,0,0.739130434782609,0.578947368421053,0.695652173913043,0.105263157894737,1,"orthodox"
"260957",26,27,187,185,192,193,174,175,12,15,3,2,11,7,"win_A",-1,2,-1,-1,0,0,0,0,0.8,0.882352941176471,0.733333333333333,0.411764705882353,0,"orthodox"
"261152",29,25,169,173,178,173,130,130,26,24,2,3,19,20,"win_A",4,-4,5,0,0,0,0,0,0.928571428571429,0.888888888888889,0.678571428571429,0.740740740740741,0,"southpaw"
"261419",30,30,173,175,173,185,140,140,36,18,6,3,26,10,"win_A",0,-2,-12,0,0,0,0,0,0.857142857142857,0.857142857142857,0.619047619047619,0.476190476190476,0,"orthodox"
"261422",28,34,173,173,173,185,134,132,35,30,4,13,26,18,"win_A",-6,0,-12,2,0,0,0,0,0.897435897435897,0.697674418604651,0.666666666666667,0.418604651162791,0,"orthodox"
"261424",24,27,168,173,170,173,135,135,32,34,0,3,16,25,"win_A",-3,-5,-3,0,0,0,0,0,1,0.918918918918919,0.5,0.675675675675676,0,"orthodox"
"261425",26,36,173,175,173,180,134,135,32,39,3,6,24,8,"win_A",-10,-2,-7,-1,0,1,0,0,0.914285714285714,0.866666666666667,0.685714285714286,0.177777777777778,0,"orthodox"
"261430",23,26,173,180,173,185,135,135,26,32,2,6,19,29,"win_A",-3,-7,-12,0,0,0,0,0,0.928571428571429,0.842105263157895,0.678571428571429,0.763157894736842,0,"orthodox"
"261431",22,27,173,170,173,178,136,138,25,12,2,2,18,7,"win_A",-5,3,-5,-2,0,0,0,0,0.925925925925926,0.857142857142857,0.666666666666667,0.5,0,"orthodox"
"261432",22,32,173,172,173,193,135,136,24,33,2,15,18,20,"win_A",-10,1,-20,-1,0,0,0,0,0.923076923076923,0.6875,0.692307692307692,0.416666666666667,0,"orthodox"
"261435",21,27,173,175,173,188,135,135,22,24,0,0,16,20,"win_A",-6,-2,-15,0,0,0,0,0,1,1,0.727272727272727,0.833333333333333,0,"orthodox"
"261436",21,21,173,180,173,180,134,134,21,16,0,0,15,9,"win_A",0,-7,-7,0,0,0,0,0,1,1,0.714285714285714,0.5625,0,"orthodox"
"261437",21,26,173,165,173,178,136,141,20,19,0,12,15,10,"win_A",-5,8,-5,-5,0,0,0,0,1,0.612903225806452,0.75,0.32258064516129,0,"orthodox"
"261525",30,30,180,178,180,168,157,157,22,14,4,5,15,8,"win_A",0,2,12,0,0,0,0,0,0.846153846153846,0.736842105263158,0.576923076923077,0.421052631578947,0,"orthodox"
"261549",33,27,170,171,170,175,134,132,48,18,4,12,44,9,"win_B",6,-1,-5,2,0,0,0,0,0.923076923076923,0.6,0.846153846153846,0.3,1,"orthodox"
"261562",23,22,170,168,170,170,122,120,37,23,0,2,35,11,"win_A",1,2,0,2,0,0,0,0,1,0.92,0.945945945945946,0.44,0,"orthodox"
"261690",30,25,191,189,202,201,187,176,49,34,25,8,17,19,"win_A",5,2,1,11,0,0,0,0,0.662162162162162,0.80952380952381,0.22972972972973,0.452380952380952,0,"Unknown"
"262045",40,29,165,169,165,175,137,133,46,94,28,45,10,30,"win_A",11,-4,-10,4,1,0,0,0,0.621621621621622,0.676258992805755,0.135135135135135,0.215827338129496,0,"Unknown"
"262063",29,25,169,168,175,173,137,147,84,49,37,17,29,41,"win_A",4,1,2,-10,0,0,0,0,0.694214876033058,0.742424242424242,0.239669421487603,0.621212121212121,0,"orthodox"
"262070",23,27,173,169,203,175,129,143,3,83,2,31,3,29,"win_A",-4,4,28,-14,0,0,0,0,0.6,0.728070175438597,0.6,0.254385964912281,0,"southpaw"
"262072",23,27,160,169,160,175,127,127,47,82,7,30,15,29,"win_A",-4,-9,-15,0,0,0,0,0,0.87037037037037,0.732142857142857,0.277777777777778,0.258928571428571,0,"orthodox"
"262075",22,27,160,169,160,175,128,126,44,81,7,28,13,29,"win_A",-5,-9,-15,2,0,0,0,0,0.862745098039216,0.743119266055046,0.254901960784314,0.26605504587156,0,"orthodox"
"262077",22,27,160,169,160,175,127,126,43,80,7,27,12,29,"win_A",-5,-9,-15,1,0,0,0,0,0.86,0.747663551401869,0.24,0.271028037383178,0,"orthodox"
"262078",27,22,169,160,175,160,126,126,79,43,27,6,29,12,"win_A",5,9,15,0,0,0,0,0,0.745283018867924,0.877551020408163,0.273584905660377,0.244897959183673,0,"orthodox"
"262107",24,34,169,165,175,165,129,135,59,30,14,17,22,11,"win_A",-10,4,10,-6,0,0,0,0,0.808219178082192,0.638297872340426,0.301369863013699,0.234042553191489,0,"orthodox"
"262124",22,28,169,161,175,165,127,128,41,17,12,12,15,4,"win_A",-6,8,10,-1,0,0,0,0,0.773584905660377,0.586206896551724,0.283018867924528,0.137931034482759,0,"orthodox"
"262131",21,28,169,165,175,165,127,128,34,56,12,12,13,24,"win_A",-7,4,10,-1,0,0,0,0,0.739130434782609,0.823529411764706,0.282608695652174,0.352941176470588,0,"orthodox"
"262142",27,20,165,169,165,175,124,128,48,25,11,10,20,10,"win_A",7,-4,-10,-4,0,0,0,0,0.813559322033898,0.714285714285714,0.338983050847458,0.285714285714286,0,"Unknown"
"263050",27,34,183,178,188,183,187,177,17,51,6,31,8,21,"win_A",-7,5,5,10,0,0,0,0,0.739130434782609,0.621951219512195,0.347826086956522,0.25609756097561,0,"Unknown"
"263234",33,34,166,163,170,160,124,129,43,24,3,39,32,16,"win_A",-1,3,10,-5,0,0,0,0,0.934782608695652,0.380952380952381,0.695652173913043,0.253968253968254,0,"orthodox"
"263241",28,19,166,170,170,175,118,118,36,17,1,5,28,13,"win_A",9,-4,-5,0,0,0,0,0,0.972972972972973,0.772727272727273,0.756756756756757,0.590909090909091,0,"orthodox"
"263244",27,26,166,159,170,160,119,118,33,36,1,5,25,25,"win_A",1,7,10,1,0,0,0,0,0.970588235294118,0.878048780487805,0.735294117647059,0.609756097560976,0,"orthodox"
"263310",36,25,187,191,192,198,190,188,26,16,12,1,24,13,"win_B",11,-4,-6,2,1,0,0,0,0.684210526315789,0.941176470588235,0.631578947368421,0.764705882352941,1,"orthodox"
"263311",35,26,187,180,192,183,188,190,24,27,12,5,23,26,"win_A",9,7,9,-2,1,0,0,0,0.666666666666667,0.84375,0.638888888888889,0.8125,0,"orthodox"
"263319",28,25,187,185,192,193,174,172,17,11,6,8,16,2,"win_B",3,2,-1,2,0,0,0,0,0.739130434782609,0.578947368421053,0.695652173913043,0.105263157894737,1,"orthodox"
"263327",26,27,187,185,192,193,174,175,12,15,3,2,11,7,"win_A",-1,2,-1,-1,0,0,0,0,0.8,0.882352941176471,0.733333333333333,0.411764705882353,0,"orthodox"
"263522",29,25,169,173,178,173,130,130,26,24,2,3,19,20,"win_A",4,-4,5,0,0,0,0,0,0.928571428571429,0.888888888888889,0.678571428571429,0.740740740740741,0,"southpaw"
"263789",30,30,173,175,173,185,140,140,36,18,6,3,26,10,"win_A",0,-2,-12,0,0,0,0,0,0.857142857142857,0.857142857142857,0.619047619047619,0.476190476190476,0,"orthodox"
"263792",28,34,173,173,173,185,134,132,35,30,4,13,26,18,"win_A",-6,0,-12,2,0,0,0,0,0.897435897435897,0.697674418604651,0.666666666666667,0.418604651162791,0,"orthodox"
"263794",24,27,168,173,170,173,135,135,32,34,0,3,16,25,"win_A",-3,-5,-3,0,0,0,0,0,1,0.918918918918919,0.5,0.675675675675676,0,"orthodox"
"263795",26,36,173,175,173,180,134,135,32,39,3,6,24,8,"win_A",-10,-2,-7,-1,0,1,0,0,0.914285714285714,0.866666666666667,0.685714285714286,0.177777777777778,0,"orthodox"
"263800",23,26,173,180,173,185,135,135,26,32,2,6,19,29,"win_A",-3,-7,-12,0,0,0,0,0,0.928571428571429,0.842105263157895,0.678571428571429,0.763157894736842,0,"orthodox"
"263801",22,27,173,170,173,178,136,138,25,12,2,2,18,7,"win_A",-5,3,-5,-2,0,0,0,0,0.925925925925926,0.857142857142857,0.666666666666667,0.5,0,"orthodox"
"263802",22,32,173,172,173,193,135,136,24,33,2,15,18,20,"win_A",-10,1,-20,-1,0,0,0,0,0.923076923076923,0.6875,0.692307692307692,0.416666666666667,0,"orthodox"
"263805",21,27,173,175,173,188,135,135,22,24,0,0,16,20,"win_A",-6,-2,-15,0,0,0,0,0,1,1,0.727272727272727,0.833333333333333,0,"orthodox"
"263806",21,21,173,180,173,180,134,134,21,16,0,0,15,9,"win_A",0,-7,-7,0,0,0,0,0,1,1,0.714285714285714,0.5625,0,"orthodox"
"263807",21,26,173,165,173,178,136,141,20,19,0,12,15,10,"win_A",-5,8,-5,-5,0,0,0,0,1,0.612903225806452,0.75,0.32258064516129,0,"orthodox"
"263895",30,30,180,178,180,168,157,157,22,14,4,5,15,8,"win_A",0,2,12,0,0,0,0,0,0.846153846153846,0.736842105263158,0.576923076923077,0.421052631578947,0,"orthodox"
"263919",33,27,170,171,170,175,134,132,48,18,4,12,44,9,"win_B",6,-1,-5,2,0,0,0,0,0.923076923076923,0.6,0.846153846153846,0.3,1,"orthodox"
"263932",23,22,170,168,170,170,122,120,37,23,0,2,35,11,"win_A",1,2,0,2,0,0,0,0,1,0.92,0.945945945945946,0.44,0,"orthodox"
"264060",30,25,191,189,202,201,187,176,49,34,25,8,17,19,"win_A",5,2,1,11,0,0,0,0,0.662162162162162,0.80952380952381,0.22972972972973,0.452380952380952,0,"Unknown"
"264415",40,29,165,169,165,175,137,133,46,94,28,45,10,30,"win_A",11,-4,-10,4,1,0,0,0,0.621621621621622,0.676258992805755,0.135135135135135,0.215827338129496,0,"Unknown"
"264433",29,25,169,168,175,173,137,147,84,49,37,17,29,41,"win_A",4,1,2,-10,0,0,0,0,0.694214876033058,0.742424242424242,0.239669421487603,0.621212121212121,0,"orthodox"
"264440",23,27,173,169,203,175,129,143,3,83,2,31,3,29,"win_A",-4,4,28,-14,0,0,0,0,0.6,0.728070175438597,0.6,0.254385964912281,0,"southpaw"
"264442",23,27,160,169,160,175,127,127,47,82,7,30,15,29,"win_A",-4,-9,-15,0,0,0,0,0,0.87037037037037,0.732142857142857,0.277777777777778,0.258928571428571,0,"orthodox"
"264445",22,27,160,169,160,175,128,126,44,81,7,28,13,29,"win_A",-5,-9,-15,2,0,0,0,0,0.862745098039216,0.743119266055046,0.254901960784314,0.26605504587156,0,"orthodox"
"264447",22,27,160,169,160,175,127,126,43,80,7,27,12,29,"win_A",-5,-9,-15,1,0,0,0,0,0.86,0.747663551401869,0.24,0.271028037383178,0,"orthodox"
"264448",27,22,169,160,175,160,126,126,79,43,27,6,29,12,"win_A",5,9,15,0,0,0,0,0,0.745283018867924,0.877551020408163,0.273584905660377,0.244897959183673,0,"orthodox"
"264477",24,34,169,165,175,165,129,135,59,30,14,17,22,11,"win_A",-10,4,10,-6,0,0,0,0,0.808219178082192,0.638297872340426,0.301369863013699,0.234042553191489,0,"orthodox"
"264494",22,28,169,161,175,165,127,128,41,17,12,12,15,4,"win_A",-6,8,10,-1,0,0,0,0,0.773584905660377,0.586206896551724,0.283018867924528,0.137931034482759,0,"orthodox"
"264501",21,28,169,165,175,165,127,128,34,56,12,12,13,24,"win_A",-7,4,10,-1,0,0,0,0,0.739130434782609,0.823529411764706,0.282608695652174,0.352941176470588,0,"orthodox"
"264512",27,20,165,169,165,175,124,128,48,25,11,10,20,10,"win_A",7,-4,-10,-4,0,0,0,0,0.813559322033898,0.714285714285714,0.338983050847458,0.285714285714286,0,"Unknown"
"264597",20,26,174,171,185,178,164,166,21,54,2,17,14,20,"win_A",-6,3,7,-2,0,0,0,0,0.91304347826087,0.76056338028169,0.608695652173913,0.28169014084507,0,"orthodox"
"264618",22,25,171,168,178,168,147,141,36,51,5,29,14,25,"win_A",-3,3,10,6,0,0,0,0,0.878048780487805,0.6375,0.341463414634146,0.3125,0,"Unknown"
"264663",25,31,169,159,174,161,111,112,9,28,1,19,5,16,"win_A",-6,10,13,-1,0,0,0,0,0.9,0.595744680851064,0.5,0.340425531914894,0,"orthodox"
"264674",21,25,168,159,160,161,112,112,10,21,2,9,4,12,"win_A",-4,9,-1,0,0,0,0,0,0.833333333333333,0.7,0.333333333333333,0.4,0,"orthodox"
"264677",23,24,166,159,170,161,112,113,16,20,1,7,12,12,"win_A",-1,7,9,-1,0,0,0,0,0.941176470588235,0.740740740740741,0.705882352941177,0.444444444444444,0,"orthodox"
"264680",25,22,168,159,168,161,112,112,23,17,20,5,13,12,"win_A",3,9,7,0,0,0,0,0,0.534883720930233,0.772727272727273,0.302325581395349,0.545454545454545,0,"orthodox"
"264682",21,26,159,157,161,160,112,112,15,14,5,5,11,8,"win_A",-5,2,1,0,0,0,0,0,0.75,0.736842105263158,0.55,0.421052631578947,0,"orthodox"
"266210",24,24,192,193,206,203,240,222,22,19,0,0,12,15,"win_B",0,-1,3,18,0,0,1,0,1,1,0.545454545454545,0.789473684210526,1,"orthodox"
"266344",27,33,165,165,173,165,122,122,19,28,0,13,7,24,"win_A",-6,0,8,0,0,0,0,0,1,0.682926829268293,0.368421052631579,0.585365853658537,0,"southpaw"
"266346",32,35,165,157,165,168,120,120,26,26,13,34,22,16,"win_A",-3,8,-3,0,0,1,0,0,0.666666666666667,0.433333333333333,0.564102564102564,0.266666666666667,0,"orthodox"
"266348",27,31,168,165,178,165,118,117,17,25,0,12,15,21,"win_A",-4,3,13,1,0,0,0,0,1,0.675675675675676,0.882352941176471,0.567567567567568,0,"orthodox"
"266351",29,22,165,170,165,173,118,118,23,27,11,4,19,25,"win_A",7,-5,-8,0,0,0,0,0,0.676470588235294,0.870967741935484,0.558823529411765,0.806451612903226,0,"orthodox"
"266361",24,20,165,164,165,168,117,118,15,15,8,1,13,11,"win_A",4,1,-3,-1,0,0,0,0,0.652173913043478,0.9375,0.565217391304348,0.6875,0,"orthodox"
"266363",21,23,164,165,165,165,122,122,29,14,1,6,25,12,"win_A",-2,-1,0,0,0,0,0,0,0.966666666666667,0.7,0.833333333333333,0.6,0,"orthodox"
"266369",22,21,165,166,165,170,119,119,13,10,1,0,11,10,"win_B",1,-1,-5,0,0,0,0,0,0.928571428571429,1,0.785714285714286,1,1,"orthodox"
"266507",33,30,193,187,206,197,224,199,44,31,9,13,30,23,"win_A",3,6,9,25,0,0,1,0,0.830188679245283,0.704545454545455,0.566037735849057,0.522727272727273,0,"orthodox"
"266511",32,28,193,198,206,213,241,235,39,16,8,7,28,12,"win_A",4,-5,-7,6,0,0,0,0,0.829787234042553,0.695652173913043,0.595744680851064,0.521739130434783,0,"orthodox"
"266858",30,27,160,178,173,183,139,137,30,24,1,1,20,22,"win_B",3,-18,-10,2,0,0,0,0,0.967741935483871,0.96,0.645161290322581,0.88,1,"orthodox"
"267240",35,26,171,173,175,178,135,134,35,24,0,0,22,13,"win_A",9,-2,-3,1,1,0,0,0,1,1,0.628571428571429,0.541666666666667,0,"southpaw"
"267582",31,22,163,168,163,173,126,126,18,41,5,7,11,23,"win_A",9,-5,-10,0,0,0,0,0,0.782608695652174,0.854166666666667,0.478260869565217,0.479166666666667,0,"orthodox"
"267890",32,38,191,183,193,196,195,214,20,96,1,8,17,58,"win_A",-6,8,-3,-19,0,1,0,1,0.952380952380952,0.923076923076923,0.80952380952381,0.557692307692308,0,"orthodox"
"268053",25,31,165,170,170,175,115,114,21,23,1,4,14,12,"win_A",-6,-5,-5,1,0,0,0,0,0.954545454545455,0.851851851851852,0.636363636363636,0.444444444444444,0,"southpaw"
"268054",24,30,165,170,170,175,114,114,20,23,1,3,14,12,"win_A",-6,-5,-5,0,0,0,0,0,0.952380952380952,0.884615384615385,0.666666666666667,0.461538461538462,0,"southpaw"
"268056",27,28,170,168,175,173,115,115,19,25,3,4,11,16,"win_A",-1,2,2,0,0,0,0,0,0.863636363636364,0.862068965517241,0.5,0.551724137931034,0,"southpaw"
"268178",25,32,168,163,165,168,139,139,19,97,4,19,10,64,"win_A",-7,5,-3,0,0,0,0,0,0.826086956521739,0.836206896551724,0.434782608695652,0.551724137931034,0,"orthodox"
"268642",30,29,185,187,194,196,195,204,26,21,13,8,20,14,"win_A",1,-2,-2,-9,0,0,0,0,0.666666666666667,0.724137931034483,0.512820512820513,0.482758620689655,0,"orthodox"
"268645",20,28,178,185,183,194,191,179,14,24,1,9,11,20,"win_A",-8,-7,-11,12,0,0,0,0,0.933333333333333,0.727272727272727,0.733333333333333,0.606060606060606,0,"orthodox"
"268646",28,32,185,178,194,191,192,182,23,21,9,9,19,18,"win_A",-4,7,3,10,0,0,0,0,0.71875,0.7,0.59375,0.6,0,"orthodox"
"268650",26,30,185,178,194,191,182,173,20,21,5,8,17,18,"win_A",-4,7,3,9,0,0,0,0,0.8,0.724137931034483,0.68,0.620689655172414,0,"orthodox"
"268651",26,30,185,178,194,191,192,180,18,21,5,7,15,18,"win_A",-4,7,3,12,0,0,0,0,0.782608695652174,0.75,0.652173913043478,0.642857142857143,0,"orthodox"
"268652",25,29,185,178,194,191,194,176,17,21,5,6,14,18,"win_A",-4,7,3,18,0,0,1,0,0.772727272727273,0.777777777777778,0.636363636363636,0.666666666666667,0,"orthodox"
"268777",33,24,170,165,175,157,126,125,29,28,7,2,22,25,"win_A",9,5,18,1,0,0,0,0,0.805555555555556,0.933333333333333,0.611111111111111,0.833333333333333,0,"orthodox"
"268780",32,19,170,165,175,170,126,126,26,17,7,2,20,11,"win_A",13,5,5,0,0,0,0,0,0.787878787878788,0.894736842105263,0.606060606060606,0.578947368421053,0,"orthodox"
"268781",28,31,170,170,173,175,122,120,12,26,4,6,8,20,"win_A",-3,0,-2,2,0,0,0,0,0.75,0.8125,0.5,0.625,0,"southpaw"
"268796",23,25,170,162,175,168,114,115,11,6,4,8,8,2,"win_A",-2,8,7,-1,0,0,0,0,0.733333333333333,0.428571428571429,0.533333333333333,0.142857142857143,0,"orthodox"
"268801",20,17,170,165,175,170,112,107,6,4,2,2,5,3,"win_A",3,5,5,5,0,0,0,0,0.75,0.666666666666667,0.625,0.5,0,"orthodox"
"269076",24,25,191,185,196,203,213,216,19,22,0,1,16,17,"win_A",-1,6,-7,-3,0,0,0,0,1,0.956521739130435,0.842105263157895,0.739130434782609,0,"orthodox"
"269263",22,24,171,170,175,173,131,130,22,12,7,7,17,5,"win_A",-2,1,2,1,0,0,0,0,0.758620689655172,0.631578947368421,0.586206896551724,0.263157894736842,0,"Unknown"
"269266",24,21,159,171,163,175,130,129,16,22,5,4,6,17,"win_A",3,-12,-12,1,0,0,0,0,0.761904761904762,0.846153846153846,0.285714285714286,0.653846153846154,0,"Unknown"
"269267",27,21,171,171,178,175,133,131,32,22,12,3,18,17,"win_A",6,0,3,2,0,0,0,0,0.727272727272727,0.88,0.409090909090909,0.68,0,"orthodox"
"269819",20,34,187,179,222,183,211,190,34,37,12,20,11,15,"win_A",-14,8,39,21,0,0,1,0,0.739130434782609,0.649122807017544,0.239130434782609,0.263157894736842,0,"Unknown"
"269827",26,31,207,179,208,183,209,223,10,33,1,11,9,15,"win_A",-5,28,25,-14,0,0,0,0,0.909090909090909,0.75,0.818181818181818,0.340909090909091,0,"orthodox"
"269845",25,25,179,193,183,188,184,189,15,3,3,1,8,1,"win_A",0,-14,-5,-5,0,0,0,0,0.833333333333333,0.75,0.444444444444444,0.25,0,"orthodox"
"269846",25,25,179,193,183,188,185,190,14,3,3,0,8,1,"win_A",0,-14,-5,-5,0,0,0,0,0.823529411764706,1,0.470588235294118,0.333333333333333,0,"orthodox"
"269848",25,25,179,193,183,188,184,189,13,2,2,0,7,1,"win_B",0,-14,-5,-5,0,0,0,0,0.866666666666667,1,0.466666666666667,0.5,1,"orthodox"
"269854",24,38,179,180,183,185,183,186,8,48,1,17,2,31,"win_B",-14,-1,-2,-3,0,1,0,0,0.888888888888889,0.738461538461539,0.222222222222222,0.476923076923077,1,"orthodox"
"269857",23,38,179,180,183,185,183,186,6,47,0,17,2,31,"win_B",-15,-1,-2,-3,0,1,0,0,1,0.734375,0.333333333333333,0.484375,1,"orthodox"
"270019",54,25,191,193,193,193,230,220,40,4,7,3,28,4,"win_A",29,-2,0,10,1,0,0,0,0.851063829787234,0.571428571428571,0.595744680851064,0.571428571428571,0,"orthodox"
"270021",24,39,198,191,206,193,211,225,23,39,0,6,19,27,"win_A",-15,7,13,-14,0,1,0,0,1,0.866666666666667,0.826086956521739,0.6,0,"orthodox"
"270024",27,38,183,191,196,193,218,217,10,37,4,5,7,25,"win_A",-11,-8,3,1,0,1,0,0,0.714285714285714,0.880952380952381,0.5,0.595238095238095,0,"orthodox"
"270025",30,38,187,191,203,193,218,225,25,36,6,5,17,25,"win_B",-8,-4,10,-7,0,1,0,0,0.806451612903226,0.878048780487805,0.548387096774194,0.609756097560976,1,"orthodox"
"270040",31,29,191,191,193,193,216,263,16,30,0,3,14,21,"win_A",2,0,0,-47,0,0,0,1,1,0.909090909090909,0.875,0.636363636363636,0,"orthodox"
"270256",25,26,187,173,185,173,159,159,14,23,0,3,8,10,"win_A",-1,14,12,0,0,0,0,0,1,0.884615384615385,0.571428571428571,0.384615384615385,0,"orthodox"
"270278",24,34,171,160,173,152,115,115,22,30,1,15,10,20,"win_A",-10,11,21,0,0,0,0,0,0.956521739130435,0.666666666666667,0.434782608695652,0.444444444444444,0,"southpaw"
"270289",21,31,171,160,173,168,114,115,11,10,0,6,4,8,"win_A",-10,11,5,-1,0,0,0,0,1,0.625,0.363636363636364,0.5,0,"southpaw"
"270305",27,27,163,160,168,168,112,112,11,10,1,4,6,8,"win_A",0,3,0,0,0,0,0,0,0.916666666666667,0.714285714285714,0.5,0.571428571428571,0,"orthodox"
"270306",27,29,163,160,168,168,112,112,10,11,1,5,6,5,"win_A",-2,3,0,0,0,0,0,0,0.909090909090909,0.6875,0.545454545454545,0.3125,0,"orthodox"
"270308",26,28,163,160,168,168,111,109,8,10,1,3,6,4,"win_A",-2,3,0,2,0,0,0,0,0.888888888888889,0.769230769230769,0.666666666666667,0.307692307692308,0,"orthodox"
"270638",26,23,179,183,184,188,175,183,52,21,6,6,20,1,"win_A",3,-4,-4,-8,0,0,0,0,0.896551724137931,0.777777777777778,0.344827586206897,0.037037037037037,0,"orthodox"
"270652",22,21,179,187,184,188,173,178,38,11,5,1,15,8,"win_A",1,-8,-4,-5,0,0,0,0,0.883720930232558,0.916666666666667,0.348837209302326,0.666666666666667,0,"orthodox"
"270691",30,39,170,171,178,180,138,133,37,137,7,45,8,29,"win_B",-9,-1,-2,5,0,1,0,0,0.840909090909091,0.752747252747253,0.181818181818182,0.159340659340659,1,"Unknown"
"270697",24,38,171,171,178,180,139,147,78,135,15,41,51,29,"win_A",-14,0,-2,-8,0,1,0,0,0.838709677419355,0.767045454545455,0.548387096774194,0.164772727272727,0,"orthodox"
"270698",38,24,171,171,180,178,139,146,134,78,41,14,29,51,"win_A",14,0,2,-7,1,0,0,0,0.765714285714286,0.847826086956522,0.165714285714286,0.554347826086957,0,"orthodox"
"270714",36,26,171,169,180,176,141,151,121,67,38,40,24,24,"win_A",10,2,4,-10,1,0,0,0,0.761006289308176,0.626168224299065,0.150943396226415,0.224299065420561,0,"orthodox"
"270716",35,26,171,169,180,176,140,141,120,65,37,39,23,24,"win_B",9,2,4,-1,1,0,0,0,0.764331210191083,0.625,0.146496815286624,0.230769230769231,1,"orthodox"
"270768",28,20,171,168,180,168,138,134,81,14,20,6,8,5,"win_B",8,3,12,4,0,0,0,0,0.801980198019802,0.7,0.0792079207920792,0.25,1,"orthodox"
"270783",26,21,171,156,180,166,128,129,69,54,15,10,7,6,"win_A",5,15,14,-1,0,0,0,0,0.821428571428571,0.84375,0.0833333333333333,0.09375,0,"orthodox"
"270785",25,25,171,160,180,165,128,128,68,75,12,7,7,27,"win_A",0,11,15,0,0,0,0,0,0.85,0.914634146341463,0.0875,0.329268292682927,0,"orthodox"
"270812",21,26,171,165,180,157,126,131,44,74,5,30,4,11,"win_A",-5,6,23,-5,0,0,0,0,0.897959183673469,0.711538461538462,0.0816326530612245,0.105769230769231,0,"orthodox"
"270920",32,36,185,185,196,188,175,175,21,29,3,5,7,24,"win_A",-4,0,8,0,0,1,0,0,0.875,0.852941176470588,0.291666666666667,0.705882352941177,0,"southpaw"
"270926",28,25,170,185,178,196,175,175,34,14,1,0,23,4,"win_B",3,-15,-18,0,0,0,0,0,0.971428571428571,1,0.657142857142857,0.285714285714286,1,"orthodox"
"270931",29,24,180,185,190,196,169,168,5,9,0,0,4,3,"win_B",5,-5,-6,1,0,0,0,0,1,1,0.8,0.333333333333333,1,"Unknown"
"271010",26,31,175,170,185,173,148,149,70,19,24,8,31,8,"win_B",-5,5,12,-1,0,0,0,0,0.74468085106383,0.703703703703704,0.329787234042553,0.296296296296296,1,"orthodox"
"271032",23,23,178,175,180,185,147,146,23,50,0,16,19,20,"win_A",0,3,-5,1,0,0,0,0,1,0.757575757575758,0.826086956521739,0.303030303030303,0,"orthodox"
"272477",31,25,187,183,196,183,214,203,6,22,2,6,4,19,"win_B",6,4,13,11,0,0,0,0,0.75,0.785714285714286,0.5,0.678571428571429,1,"orthodox"
"272834",23,27,163,170,165,173,145,135,49,18,18,14,24,4,"win_A",-4,-7,-8,10,0,0,0,0,0.73134328358209,0.5625,0.358208955223881,0.125,0,"Unknown"
"273129",38,32,191,191,191,198,210,257,19,24,2,4,14,18,"win_A",6,0,-7,-47,1,0,0,1,0.904761904761905,0.857142857142857,0.666666666666667,0.642857142857143,0,"orthodox"
"273144",23,32,191,183,198,180,187,191,8,6,1,21,6,3,"win_A",-9,8,18,-4,0,0,0,0,0.888888888888889,0.222222222222222,0.666666666666667,0.111111111111111,0,"orthodox"
"273925",23,27,163,170,165,173,145,135,49,18,18,14,24,4,"win_A",-4,-7,-8,10,0,0,0,0,0.73134328358209,0.5625,0.358208955223881,0.125,0,"Unknown"
"274220",38,32,191,191,191,198,210,257,19,24,2,4,14,18,"win_A",6,0,-7,-47,1,0,0,1,0.904761904761905,0.857142857142857,0.666666666666667,0.642857142857143,0,"orthodox"
"274235",23,32,191,183,198,180,187,191,8,6,1,21,6,3,"win_A",-9,8,18,-4,0,0,0,0,0.888888888888889,0.222222222222222,0.666666666666667,0.111111111111111,0,"orthodox"
"274770",32,27,169,179,170,188,147,147,65,44,7,3,46,27,"win_B",5,-10,-18,0,0,0,0,0,0.902777777777778,0.936170212765957,0.638888888888889,0.574468085106383,1,"Unknown"
"274989",33,38,193,187,189,185,176,177,37,18,6,3,29,6,"win_A",-5,6,4,-1,0,1,0,0,0.86046511627907,0.857142857142857,0.674418604651163,0.285714285714286,0,"orthodox"
"275146",25,30,191,185,203,196,210,218,45,13,3,10,37,9,"win_A",-5,6,7,-8,0,0,0,0,0.9375,0.565217391304348,0.770833333333333,0.391304347826087,0,"orthodox"
"275213",26,30,191,180,196,185,193,220,57,46,8,21,47,23,"win_A",-4,11,11,-27,0,0,0,1,0.876923076923077,0.686567164179104,0.723076923076923,0.343283582089552,0,"orthodox"
"275680",28,31,173,173,180,175,135,134,22,41,0,3,9,9,"win_A",-3,0,5,1,0,0,0,0,1,0.931818181818182,0.409090909090909,0.204545454545455,0,"orthodox"
"275968",21,28,198,193,213,209,230,240,36,88,3,31,33,39,"win_A",-7,5,4,-10,0,0,0,0,0.923076923076923,0.739495798319328,0.846153846153846,0.327731092436975,0,"orthodox"
"275982",19,26,198,193,213,209,197,239,13,80,0,23,13,36,"win_B",-7,5,4,-42,0,0,0,1,1,0.776699029126214,1,0.349514563106796,1,"orthodox"
"276005",24,24,193,189,209,185,197,206,64,33,15,18,28,14,"win_A",0,4,24,-9,0,0,0,0,0.810126582278481,0.647058823529412,0.354430379746835,0.274509803921569,0,"orthodox"
"276025",25,22,189,193,191,209,194,180,37,50,11,6,22,24,"win_B",3,-4,-18,14,0,0,0,0,0.770833333333333,0.892857142857143,0.458333333333333,0.428571428571429,1,"orthodox"
"276040",21,19,193,197,209,218,190,200,37,4,4,3,17,1,"win_A",2,-4,-9,-10,0,0,0,0,0.902439024390244,0.571428571428571,0.414634146341463,0.142857142857143,0,"orthodox"
"276082",29,32,168,163,178,163,118,117,19,17,2,2,15,10,"win_A",-3,5,15,1,0,0,0,0,0.904761904761905,0.894736842105263,0.714285714285714,0.526315789473684,0,"orthodox"
"276083",28,34,168,163,178,160,118,118,18,39,1,11,15,13,"win_A",-6,5,18,0,0,0,0,0,0.947368421052632,0.78,0.789473684210526,0.26,0,"orthodox"
"276203",27,36,185,183,183,183,158,160,25,51,4,7,15,31,"win_A",-9,2,0,-2,0,1,0,0,0.862068965517241,0.879310344827586,0.517241379310345,0.53448275862069,0,"orthodox"
"276208",33,33,177,183,175,183,154,154,23,47,0,5,18,31,"win_A",0,-6,-8,0,0,0,0,0,1,0.903846153846154,0.782608695652174,0.596153846153846,0,"southpaw"
"276209",33,28,183,183,183,186,170,170,46,16,5,10,30,10,"win_A",5,0,-3,0,0,0,0,0,0.901960784313726,0.615384615384615,0.588235294117647,0.384615384615385,0,"southpaw"
"276221",27,24,183,175,183,183,153,154,34,22,2,2,24,18,"win_A",3,8,0,-1,0,0,0,0,0.944444444444444,0.916666666666667,0.666666666666667,0.75,0,"southpaw"
"276222",27,28,183,173,183,180,154,152,33,21,2,0,23,13,"win_A",-1,10,3,2,0,0,0,0,0.942857142857143,1,0.657142857142857,0.619047619047619,0,"southpaw"
"276223",26,33,183,168,183,165,155,155,32,20,2,18,23,3,"win_A",-7,15,18,0,0,0,0,0,0.941176470588235,0.526315789473684,0.676470588235294,0.0789473684210526,0,"southpaw"
"276224",26,29,183,171,183,184,156,156,31,47,2,8,23,29,"win_A",-3,12,-1,0,0,0,0,0,0.939393939393939,0.854545454545454,0.696969696969697,0.527272727272727,0,"southpaw"
"276225",25,29,183,173,183,178,160,155,30,13,2,6,22,2,"win_A",-4,10,5,5,0,0,0,0,0.9375,0.684210526315789,0.6875,0.105263157894737,0,"southpaw"
"276232",24,24,183,178,183,178,155,155,23,10,1,4,16,9,"win_A",0,5,5,0,0,0,0,0,0.958333333333333,0.714285714285714,0.666666666666667,0.642857142857143,0,"southpaw"
"276237",23,28,183,178,183,168,154,154,18,14,1,2,11,8,"win_A",-5,5,15,0,0,0,0,0,0.947368421052632,0.875,0.578947368421053,0.5,0,"southpaw"
"276239",23,22,183,170,183,185,151,151,16,14,1,2,9,5,"win_A",1,13,-2,0,0,0,0,0,0.941176470588235,0.875,0.529411764705882,0.3125,0,"southpaw"
"276240",22,23,183,174,183,182,148,148,15,18,1,1,8,13,"win_A",-1,9,1,0,0,0,0,0,0.9375,0.947368421052632,0.5,0.684210526315789,0,"southpaw"
"276242",22,26,183,175,183,180,148,145,13,21,1,4,6,12,"win_A",-4,8,3,3,0,0,0,0,0.928571428571429,0.84,0.428571428571429,0.48,0,"southpaw"
"276853",26,33,164,159,168,160,118,118,29,48,4,15,17,28,"win_A",-7,5,8,0,0,0,0,0,0.878787878787879,0.761904761904762,0.515151515151515,0.444444444444444,0,"orthodox"
"276860",21,30,168,159,165,160,123,123,19,48,1,7,18,28,"win_A",-9,9,5,0,0,0,0,0,0.95,0.872727272727273,0.9,0.509090909090909,0,"orthodox"
"276867",28,32,159,164,160,163,118,118,41,29,7,12,26,18,"win_A",-4,-5,-3,0,0,0,0,0,0.854166666666667,0.707317073170732,0.541666666666667,0.439024390243902,0,"orthodox"
"276869",27,24,159,168,160,165,122,123,39,23,7,1,26,14,"win_A",3,-9,-5,-1,0,0,0,0,0.847826086956522,0.958333333333333,0.565217391304348,0.583333333333333,0,"orthodox"
"276873",26,24,159,169,160,173,118,118,35,23,4,4,25,19,"win_B",2,-10,-13,0,0,0,0,0,0.897435897435897,0.851851851851852,0.641025641025641,0.703703703703704,1,"orthodox"
"276875",25,24,159,168,160,168,118,116,33,15,4,9,24,12,"win_A",1,-9,-8,2,0,0,0,0,0.891891891891892,0.625,0.648648648648649,0.5,0,"orthodox"
"276881",22,23,163,159,160,160,117,118,19,28,4,2,6,22,"win_A",-1,4,0,-1,0,0,0,0,0.826086956521739,0.933333333333333,0.260869565217391,0.733333333333333,0,"southpaw"
"277446",25,35,178,180,197,188,159,159,25,40,0,3,22,35,"win_A",-10,-2,9,0,0,1,0,0,1,0.930232558139535,0.88,0.813953488372093,0,"orthodox"
"277447",33,28,180,175,188,180,168,178,39,37,1,4,35,27,"win_A",5,5,8,-10,0,0,0,0,0.975,0.902439024390244,0.875,0.658536585365854,0,"orthodox"
"277454",30,32,180,183,188,185,159,159,31,33,0,1,28,21,"win_A",-2,-3,3,0,0,0,0,0,1,0.970588235294118,0.903225806451613,0.617647058823529,0,"orthodox"
"277486",35,30,173,170,178,183,142,142,35,26,10,5,26,11,"win_A",5,3,-5,0,1,0,0,0,0.777777777777778,0.838709677419355,0.577777777777778,0.354838709677419,0,"orthodox"
"277487",24,34,175,173,178,178,140,141,34,35,2,9,24,26,"win_A",-10,2,0,-1,0,0,0,0,0.944444444444444,0.795454545454545,0.666666666666667,0.590909090909091,0,"orthodox"
"277488",31,34,171,173,180,178,140,139,22,34,0,9,17,25,"win_B",-3,-2,2,1,0,0,0,0,1,0.790697674418605,0.772727272727273,0.581395348837209,1,"orthodox"
"277489",33,31,173,171,178,176,143,143,33,30,9,3,24,13,"win_A",2,2,2,0,0,0,0,0,0.785714285714286,0.909090909090909,0.571428571428571,0.393939393939394,0,"orthodox"
"277492",37,32,170,173,183,178,143,142,33,30,17,8,14,21,"win_B",5,-3,5,1,1,0,0,0,0.66,0.789473684210526,0.28,0.552631578947368,1,"orthodox"
"277493",31,25,173,180,178,170,140,140,29,16,7,0,20,15,"win_A",6,-7,8,0,0,0,0,0,0.805555555555556,1,0.555555555555556,0.9375,0,"orthodox"
"277504",22,25,178,173,188,178,140,139,17,21,0,4,12,14,"win_A",-3,5,10,1,0,0,0,0,1,0.84,0.705882352941177,0.56,0,"orthodox"
"277505",34,24,175,173,185,178,137,140,67,21,10,3,50,14,"win_A",10,2,7,-3,0,0,0,0,0.87012987012987,0.875,0.649350649350649,0.583333333333333,0,"orthodox"
"277531",30,40,188,178,192,191,220,239,18,25,0,17,11,21,"win_A",-10,10,1,-19,0,1,0,1,1,0.595238095238095,0.611111111111111,0.5,0,"orthodox"
"278319",34,38,166,165,170,166,127,126,43,26,6,15,19,19,"win_A",-4,1,4,1,0,1,0,0,0.877551020408163,0.634146341463415,0.387755102040816,0.463414634146341,0,"orthodox"
"278321",32,31,166,173,170,178,131,130,41,21,6,27,19,16,"win_A",1,-7,-8,1,0,0,0,0,0.872340425531915,0.4375,0.404255319148936,0.333333333333333,0,"orthodox"
"278322",26,31,166,170,170,160,122,122,40,18,3,5,19,8,"win_A",-5,-4,10,0,0,0,0,0,0.930232558139535,0.782608695652174,0.441860465116279,0.347826086956522,0,"orthodox"
"278324",25,23,166,164,170,165,122,122,38,39,3,1,18,31,"win_A",2,2,5,0,0,0,0,0,0.926829268292683,0.975,0.439024390243902,0.775,0,"orthodox"
"278330",23,33,166,166,170,173,132,137,32,9,3,11,17,2,"win_A",-10,0,-3,-5,0,0,0,0,0.914285714285714,0.45,0.485714285714286,0.1,0,"orthodox"
"278332",20,37,166,157,170,170,124,124,30,11,3,12,16,7,"win_A",-17,9,0,0,0,1,0,0,0.909090909090909,0.478260869565217,0.484848484848485,0.304347826086957,0,"orthodox"
"278334",20,30,166,170,170,173,127,127,28,18,3,7,16,11,"win_A",-10,-4,-3,0,0,0,0,0,0.903225806451613,0.72,0.516129032258065,0.44,0,"orthodox"
"278338",19,23,166,169,170,170,122,123,26,18,1,2,15,4,"win_B",-4,-3,0,-1,0,0,0,0,0.962962962962963,0.9,0.555555555555556,0.2,1,"orthodox"
"278582",25,33,165,164,173,163,122,121,36,29,3,15,31,18,"win_A",-8,1,10,1,0,0,0,0,0.923076923076923,0.659090909090909,0.794871794871795,0.409090909090909,0,"orthodox"
"278586",21,30,163,164,163,163,118,117,14,27,4,8,10,18,"win_A",-9,-1,0,1,0,0,0,0,0.777777777777778,0.771428571428571,0.555555555555556,0.514285714285714,0,"Unknown"
"278748",33,27,163,168,174,170,112,112,32,13,2,2,20,5,"win_A",6,-5,4,0,0,0,0,0,0.941176470588235,0.866666666666667,0.588235294117647,0.333333333333333,0,"orthodox"
"278824",21,32,178,171,178,180,133,135,73,37,1,7,65,26,"win_B",-11,7,-2,-2,0,0,0,0,0.986486486486487,0.840909090909091,0.878378378378378,0.590909090909091,1,"orthodox"
"279491",30,31,175,170,188,175,124,125,28,21,2,0,22,16,"win_A",-1,5,13,-1,0,0,0,0,0.933333333333333,1,0.733333333333333,0.761904761904762,0,"southpaw"
"279493",29,19,175,168,188,173,128,128,26,8,2,2,22,1,"win_A",10,7,15,0,0,0,0,0,0.928571428571429,0.8,0.785714285714286,0.1,0,"southpaw"
"279501",25,31,175,163,188,163,126,125,18,23,1,19,15,6,"win_A",-6,12,25,1,0,0,0,0,0.947368421052632,0.547619047619048,0.789473684210526,0.142857142857143,0,"southpaw"
"279517",21,23,175,173,188,178,126,126,3,6,0,0,3,5,"win_B",-2,2,10,0,0,0,0,0,1,1,1,0.833333333333333,1,"southpaw"
"279655",26,25,191,192,202,206,177,191,29,11,15,15,10,2,"win_A",1,-1,-4,-14,0,0,0,0,0.659090909090909,0.423076923076923,0.227272727272727,0.0769230769230769,0,"Unknown"
"279673",24,27,191,180,202,196,174,185,14,20,5,16,5,8,"win_A",-3,11,6,-11,0,0,0,0,0.736842105263158,0.555555555555556,0.263157894736842,0.222222222222222,0,"Unknown"
"279718",29,24,175,175,175,180,151,149,57,27,32,3,27,20,"win_B",5,0,-5,2,0,0,0,0,0.640449438202247,0.9,0.303370786516854,0.666666666666667,1,"orthodox"
"279729",22,33,175,163,180,163,145,146,18,67,0,32,14,20,"win_A",-11,12,17,-1,0,0,0,0,1,0.676767676767677,0.777777777777778,0.202020202020202,0,"orthodox"
"279942",25,22,179,170,173,173,140,147,22,35,13,1,11,30,"win_A",3,9,0,-7,0,0,0,0,0.628571428571429,0.972222222222222,0.314285714285714,0.833333333333333,0,"Unknown"
"279959",20,25,170,168,173,175,132,134,15,121,0,33,14,27,"win_A",-5,2,-2,-2,0,0,0,0,1,0.785714285714286,0.933333333333333,0.175324675324675,0,"southpaw"
"279960",20,25,170,170,173,165,132,135,14,28,0,22,13,8,"win_A",-5,0,8,-3,0,0,0,0,1,0.56,0.928571428571429,0.16,0,"southpaw"
"280417",35,27,184,178,183,183,166,167,48,46,4,3,39,39,"win_A",8,6,0,-1,1,0,0,0,0.923076923076923,0.938775510204082,0.75,0.795918367346939,0,"orthodox"
"280466",28,26,165,168,173,168,122,119,43,19,5,5,37,14,"win_A",2,-3,5,3,0,0,0,0,0.895833333333333,0.791666666666667,0.770833333333333,0.583333333333333,0,"orthodox"
"280474",25,23,165,159,173,157,118,118,34,17,3,13,29,9,"win_A",2,6,16,0,0,0,0,0,0.918918918918919,0.566666666666667,0.783783783783784,0.3,0,"orthodox"
"280477",23,24,165,165,173,178,120,122,31,12,2,6,28,0,"win_A",-1,0,-5,-2,0,0,0,0,0.939393939393939,0.666666666666667,0.848484848484849,0,0,"orthodox"
"280478",23,24,165,170,173,168,123,119,30,14,2,7,27,5,"win_A",-1,-5,5,4,0,0,0,0,0.9375,0.666666666666667,0.84375,0.238095238095238,0,"orthodox"
"280480",22,28,165,165,173,165,115,115,28,12,1,2,25,4,"win_A",-6,0,8,0,0,0,0,0,0.96551724137931,0.857142857142857,0.862068965517241,0.285714285714286,0,"orthodox"
"280490",20,26,165,160,173,157,114,114,19,24,0,9,17,8,"win_A",-6,5,16,0,0,0,0,0,1,0.727272727272727,0.894736842105263,0.242424242424242,0,"orthodox"
"280669",30,28,168,170,171,173,134,129,82,38,50,3,42,19,"win_B",2,-2,-2,5,0,0,0,0,0.621212121212121,0.926829268292683,0.318181818181818,0.463414634146341,1,"orthodox"
"280708",35,35,162,170,163,160,126,127,33,19,11,17,16,8,"win_A",0,-8,3,-1,1,1,0,0,0.75,0.527777777777778,0.363636363636364,0.222222222222222,0,"southpaw"
"280710",34,25,162,165,163,183,126,125,32,18,10,8,16,13,"win_A",9,-3,-20,1,0,0,0,0,0.761904761904762,0.692307692307692,0.380952380952381,0.5,0,"southpaw"
"280712",31,30,162,168,163,170,121,122,30,29,9,1,15,26,"win_A",1,-6,-7,-1,0,0,0,0,0.769230769230769,0.966666666666667,0.384615384615385,0.866666666666667,0,"southpaw"
"280713",30,23,162,168,163,177,126,128,29,21,9,2,15,9,"win_A",7,-6,-14,-2,0,0,0,0,0.763157894736842,0.91304347826087,0.394736842105263,0.391304347826087,0,"southpaw"
"280714",30,25,162,166,163,170,122,119,28,21,9,1,14,18,"win_A",5,-4,-7,3,0,0,0,0,0.756756756756757,0.954545454545455,0.378378378378378,0.818181818181818,0,"southpaw"
"280717",29,25,162,170,163,170,124,125,25,19,9,7,13,8,"win_A",4,-8,-7,-1,0,0,0,0,0.735294117647059,0.730769230769231,0.382352941176471,0.307692307692308,0,"southpaw"
"280721",28,24,162,170,163,180,126,127,20,38,8,7,11,30,"win_A",4,-8,-17,-1,0,0,0,0,0.714285714285714,0.844444444444444,0.392857142857143,0.666666666666667,0,"southpaw"
"280723",26,25,162,168,163,173,134,137,19,47,5,11,11,27,"win_A",1,-6,-10,-3,0,0,0,0,0.791666666666667,0.810344827586207,0.458333333333333,0.46551724137931,0,"southpaw"
"280724",26,30,162,164,163,165,124,124,18,24,5,11,10,16,"win_A",-4,-2,-2,0,0,0,0,0,0.782608695652174,0.685714285714286,0.434782608695652,0.457142857142857,0,"southpaw"
"280728",24,24,162,168,163,170,122,122,15,26,3,1,9,16,"win_B",0,-6,-7,0,0,0,0,0,0.833333333333333,0.962962962962963,0.5,0.592592592592593,1,"southpaw"
"281019",27,25,166,168,173,165,124,124,16,31,0,6,9,26,"win_A",2,-2,8,0,0,0,0,0,1,0.837837837837838,0.5625,0.702702702702703,0,"orthodox"
"281089",33,29,170,175,180,183,135,135,29,16,4,2,23,8,"win_B",4,-5,-3,0,0,0,0,0,0.878787878787879,0.888888888888889,0.696969696969697,0.444444444444444,1,"orthodox"
"281908",26,26,171,185,182,189,160,160,91,73,22,27,43,25,"win_B",0,-14,-7,0,0,0,0,0,0.805309734513274,0.73,0.380530973451327,0.25,1,"orthodox"
"282392",25,25,170,178,173,178,136,138,49,19,17,5,26,9,"win_A",0,-8,-5,-2,0,0,0,0,0.742424242424242,0.791666666666667,0.393939393939394,0.375,0,"orthodox"
"282408",18,22,164,170,165,173,126,119,40,33,5,12,6,20,"win_A",-4,-6,-8,7,0,0,0,0,0.888888888888889,0.733333333333333,0.133333333333333,0.444444444444444,0,"Unknown"
"282425",20,26,170,165,173,165,129,130,19,36,9,19,15,10,"win_B",-6,5,8,-1,0,0,0,0,0.678571428571429,0.654545454545455,0.535714285714286,0.181818181818182,1,"orthodox"
"282438",19,33,170,159,173,163,126,128,8,54,7,32,7,9,"win_A",-14,11,10,-2,0,0,0,0,0.533333333333333,0.627906976744186,0.466666666666667,0.104651162790698,0,"orthodox"
"282485",34,29,170,170,178,173,126,127,37,17,7,3,21,9,"win_A",5,0,5,-1,0,0,0,0,0.840909090909091,0.85,0.477272727272727,0.45,0,"orthodox"
"282489",31,22,170,168,178,168,125,125,34,10,5,2,21,5,"win_A",9,2,10,0,0,0,0,0,0.871794871794872,0.833333333333333,0.538461538461538,0.416666666666667,0,"orthodox"
"282490",31,22,170,168,178,168,126,128,33,9,5,1,21,5,"win_A",9,2,10,-2,0,0,0,0,0.868421052631579,0.9,0.552631578947368,0.5,0,"orthodox"
"282491",31,31,170,170,178,173,121,122,33,30,4,3,21,17,"win_B",0,0,5,-1,0,0,0,0,0.891891891891892,0.909090909090909,0.567567567567568,0.515151515151515,1,"orthodox"
"282496",28,23,170,169,178,170,122,123,28,19,1,2,20,5,"win_B",5,1,8,-1,0,0,0,0,0.96551724137931,0.904761904761905,0.689655172413793,0.238095238095238,1,"orthodox"
"282498",27,25,170,163,178,160,120,122,26,13,1,14,20,9,"win_A",2,7,18,-2,0,0,0,0,0.962962962962963,0.481481481481481,0.740740740740741,0.333333333333333,0,"orthodox"
"282699",22,32,182,173,178,183,154,155,19,28,0,6,13,16,"win_A",-10,9,-5,-1,0,0,0,0,1,0.823529411764706,0.684210526315789,0.470588235294118,0,"orthodox"
"282701",21,30,182,180,178,191,155,155,16,9,0,2,11,3,"win_A",-9,2,-13,0,0,0,0,0,1,0.818181818181818,0.6875,0.272727272727273,0,"orthodox"
"282702",21,34,182,175,178,188,155,155,15,11,0,9,11,4,"win_A",-13,7,-10,0,0,0,0,0,1,0.55,0.733333333333333,0.2,0,"orthodox"
"282703",21,29,182,175,178,183,155,157,13,13,0,14,9,9,"win_A",-8,7,-5,-2,0,0,0,0,1,0.481481481481481,0.692307692307692,0.333333333333333,0,"orthodox"
"282704",20,31,182,168,178,175,155,157,12,12,0,4,8,9,"win_A",-11,14,3,-2,0,0,0,0,1,0.75,0.666666666666667,0.5625,0,"orthodox"
"282754",36,27,152,168,165,160,105,105,40,25,5,3,30,11,"win_B",9,-16,5,0,1,0,0,0,0.888888888888889,0.892857142857143,0.666666666666667,0.392857142857143,1,"orthodox"
"282757",34,36,152,163,165,168,108,108,37,24,4,3,30,13,"win_A",-2,-11,-3,0,0,1,0,0,0.902439024390244,0.888888888888889,0.731707317073171,0.481481481481481,0,"orthodox"
"282760",33,26,152,163,165,168,108,108,34,18,3,11,29,8,"win_A",7,-11,-3,0,0,0,0,0,0.918918918918919,0.620689655172414,0.783783783783784,0.275862068965517,0,"orthodox"
"282762",31,24,152,168,165,168,105,105,33,22,1,2,28,19,"win_A",7,-16,-3,0,0,0,0,0,0.970588235294118,0.916666666666667,0.823529411764706,0.791666666666667,0,"orthodox"
"282772",27,25,152,155,165,157,105,105,24,6,0,0,19,4,"win_A",2,-3,8,0,0,0,0,0,1,1,0.791666666666667,0.666666666666667,0,"orthodox"
"283421",28,25,178,168,185,169,135,135,28,24,3,9,21,14,"win_A",3,10,16,0,0,0,0,0,0.903225806451613,0.727272727272727,0.67741935483871,0.424242424242424,0,"orthodox"
"283422",26,29,178,163,185,163,130,129,25,15,2,4,21,8,"win_A",-3,15,22,1,0,0,0,0,0.925925925925926,0.789473684210526,0.777777777777778,0.421052631578947,0,"orthodox"
"283423",26,26,178,165,185,173,135,135,24,21,2,1,20,7,"win_A",0,13,12,0,0,0,0,0,0.923076923076923,0.954545454545455,0.769230769230769,0.318181818181818,0,"orthodox"
"283426",24,28,178,163,185,170,126,126,21,23,1,4,18,14,"win_A",-4,15,15,0,0,0,0,0,0.954545454545455,0.851851851851852,0.818181818181818,0.518518518518518,0,"orthodox"
"283427",23,36,178,170,185,173,129,129,20,24,1,7,18,13,"win_A",-13,8,12,0,0,1,0,0,0.952380952380952,0.774193548387097,0.857142857142857,0.419354838709677,0,"orthodox"
"283432",22,29,178,168,185,173,128,128,16,20,0,11,14,13,"win_A",-7,10,12,0,0,0,0,0,1,0.645161290322581,0.875,0.419354838709677,0,"orthodox"
"283435",21,24,178,173,185,168,130,131,12,7,0,2,12,5,"win_A",-3,5,17,-1,0,0,0,0,1,0.777777777777778,1,0.555555555555556,0,"orthodox"
"283436",21,29,178,173,185,178,127,127,11,20,0,15,11,15,"win_A",-8,5,7,0,0,0,0,0,1,0.571428571428571,1,0.428571428571429,0,"orthodox"
"283439",20,33,178,166,185,175,132,132,8,16,0,19,8,8,"win_A",-13,12,10,0,0,0,0,0,1,0.457142857142857,1,0.228571428571429,0,"orthodox"
"283766",29,33,188,180,201,181,175,175,38,18,3,3,23,9,"win_A",-4,8,20,0,0,0,0,0,0.926829268292683,0.857142857142857,0.560975609756098,0.428571428571429,0,"orthodox"
"283767",28,34,188,170,201,178,175,175,37,47,2,5,23,30,"win_A",-6,18,23,0,0,0,0,0,0.948717948717949,0.903846153846154,0.58974358974359,0.576923076923077,0,"orthodox"
"283770",26,35,188,171,201,188,177,172,33,11,1,5,22,7,"win_A",-9,17,13,5,0,1,0,0,0.970588235294118,0.6875,0.647058823529412,0.4375,0,"orthodox"
"283773",25,27,188,178,201,178,175,175,29,10,1,4,19,5,"win_A",-2,10,23,0,0,0,0,0,0.966666666666667,0.714285714285714,0.633333333333333,0.357142857142857,0,"orthodox"
"283774",25,30,188,188,201,208,176,175,28,27,1,4,18,20,"win_A",-5,0,-7,1,0,0,0,0,0.96551724137931,0.870967741935484,0.620689655172414,0.645161290322581,0,"orthodox"
"283777",24,31,188,178,201,173,175,174,25,15,0,0,16,15,"win_A",-7,10,28,1,0,0,0,0,1,1,0.64,1,0,"orthodox"
"283784",23,41,188,185,201,185,174,171,18,14,0,10,9,7,"win_A",-18,3,16,3,0,1,0,0,1,0.583333333333333,0.5,0.291666666666667,0,"orthodox"
"283796",21,20,188,188,201,203,181,181,6,3,0,3,4,1,"win_A",1,0,-2,0,0,0,0,0,1,0.5,0.666666666666667,0.166666666666667,0,"orthodox"
"283805",33,44,193,185,203,196,237,257,42,34,4,5,36,25,"win_A",-11,8,7,-20,0,1,0,1,0.91304347826087,0.871794871794872,0.782608695652174,0.641025641025641,0,"orthodox"
"283806",44,39,185,183,196,201,233,226,33,27,5,7,25,21,"win_A",5,2,-5,7,1,1,0,0,0.868421052631579,0.794117647058823,0.657894736842105,0.617647058823529,0,"orthodox"
"283807",42,37,185,193,196,193,240,245,32,33,5,7,24,27,"win_A",5,-8,3,-5,1,1,0,0,0.864864864864865,0.825,0.648648648648649,0.675,0,"orthodox"
"283810",40,29,185,191,196,191,224,228,29,40,4,10,21,29,"win_A",11,-6,5,-4,1,0,0,0,0.878787878787879,0.8,0.636363636363636,0.58,0,"orthodox"
"283814",38,33,185,185,196,185,235,217,25,12,4,10,17,4,"win_A",5,0,11,18,1,0,1,0,0.862068965517241,0.545454545454545,0.586206896551724,0.181818181818182,0,"orthodox"
"283817",32,33,185,185,196,188,225,219,21,14,2,11,16,9,"win_A",-1,0,8,6,0,0,0,0,0.91304347826087,0.56,0.695652173913043,0.36,0,"orthodox"
"283819",31,35,185,188,196,196,238,234,20,18,1,9,15,13,"win_B",-4,-3,0,4,0,1,0,0,0.952380952380952,0.666666666666667,0.714285714285714,0.481481481481481,1,"orthodox"
"283820",31,29,185,185,196,188,234,209,19,78,1,9,14,58,"win_A",2,0,8,25,0,0,1,0,0.95,0.896551724137931,0.7,0.666666666666667,0,"orthodox"
"283824",29,24,185,181,196,199,220,217,15,22,0,5,11,19,"win_A",5,4,-3,3,0,0,0,0,1,0.814814814814815,0.733333333333333,0.703703703703704,0,"orthodox"
"283844",21,25,163,165,165,168,108,108,23,17,3,4,18,13,"win_B",-4,-2,-3,0,0,0,0,0,0.884615384615385,0.80952380952381,0.692307692307692,0.619047619047619,1,"orthodox"
"283849",22,23,165,165,160,168,108,108,14,12,3,0,11,9,"win_A",-1,0,-8,0,0,0,0,0,0.823529411764706,1,0.647058823529412,0.75,0,"orthodox"
"284051",24,28,160,160,163,160,108,108,26,15,4,6,16,6,"win_A",-4,0,3,0,0,0,0,0,0.866666666666667,0.714285714285714,0.533333333333333,0.285714285714286,0,"southpaw"
"284178",25,36,188,183,192,185,194,201,16,22,3,16,11,16,"win_A",-11,5,7,-7,0,1,0,0,0.842105263157895,0.578947368421053,0.578947368421053,0.421052631578947,0,"orthodox"
"284638",23,27,175,172,175,173,151,145,34,54,10,10,18,11,"win_A",-4,3,2,6,0,0,0,0,0.772727272727273,0.84375,0.409090909090909,0.171875,0,"orthodox"
"284861",31,36,188,192,191,198,220,222,33,20,3,8,32,14,"win_A",-5,-4,-7,-2,0,1,0,0,0.916666666666667,0.714285714285714,0.888888888888889,0.5,0,"orthodox"
"284863",34,30,192,188,198,191,229,234,19,32,5,2,13,31,"win_A",4,4,7,-5,0,0,0,0,0.791666666666667,0.941176470588235,0.541666666666667,0.911764705882353,0,"southpaw"
"284869",22,29,188,191,191,201,216,230,25,11,0,1,24,6,"win_A",-7,-3,-10,-14,0,0,0,0,1,0.916666666666667,0.96,0.5,0,"orthodox"
"284871",22,29,188,182,191,183,215,241,22,18,0,16,22,8,"win_A",-7,6,8,-26,0,0,0,1,1,0.529411764705882,1,0.235294117647059,0,"orthodox"
"284875",21,31,188,183,191,188,208,205,18,28,0,8,18,23,"win_A",-10,5,3,3,0,0,0,0,1,0.777777777777778,1,0.638888888888889,0,"orthodox"
"284876",21,21,188,185,191,193,207,220,17,18,0,4,17,6,"win_A",0,3,-2,-13,0,0,0,0,1,0.818181818181818,1,0.272727272727273,0,"orthodox"
"284990",32,33,175,180,180,183,152,152,20,33,4,6,14,20,"win_A",-1,-5,-3,0,0,0,0,0,0.833333333333333,0.846153846153846,0.583333333333333,0.512820512820513,0,"orthodox"
"284996",29,23,180,173,183,183,155,154,28,13,3,0,18,9,"win_A",6,7,0,1,0,0,0,0,0.903225806451613,1,0.580645161290323,0.692307692307692,0,"orthodox"
"284998",37,28,173,180,175,183,150,145,24,25,15,2,12,16,"win_B",9,-7,-8,5,1,0,0,0,0.615384615384615,0.925925925925926,0.307692307692308,0.592592592592593,1,"orthodox"
"285001",26,21,180,179,183,175,148,146,21,18,0,15,12,11,"win_A",5,1,8,2,0,0,0,0,1,0.545454545454545,0.571428571428571,0.333333333333333,0,"orthodox"
"285009",23,33,180,173,183,183,142,143,12,21,0,12,7,12,"win_A",-10,7,0,-1,0,0,0,0,1,0.636363636363636,0.583333333333333,0.363636363636364,0,"orthodox"
"285142",30,25,187,192,197,211,201,215,30,43,13,9,22,34,"win_A",5,-5,-14,-14,0,0,0,0,0.697674418604651,0.826923076923077,0.511627906976744,0.653846153846154,0,"Unknown"
"285144",28,25,187,191,197,201,196,188,26,22,10,5,18,19,"win_A",3,-4,-4,8,0,0,0,0,0.722222222222222,0.814814814814815,0.5,0.703703703703704,0,"Unknown"
"285694",28,28,166,170,168,173,122,122,34,26,1,0,17,16,"win_B",0,-4,-5,0,0,0,0,0,0.971428571428571,1,0.485714285714286,0.615384615384615,1,"orthodox"
"286207",37,25,183,183,191,188,176,180,12,19,2,3,4,5,"win_B",12,0,3,-4,1,0,0,0,0.857142857142857,0.863636363636364,0.285714285714286,0.227272727272727,1,"southpaw"
"286233",35,28,180,173,185,183,159,160,31,26,2,5,14,16,"win_A",7,7,2,-1,1,0,0,0,0.939393939393939,0.838709677419355,0.424242424242424,0.516129032258065,0,"orthodox"
"286256",26,26,180,178,185,191,160,160,9,3,0,4,5,0,"win_A",0,2,-6,0,0,0,0,0,1,0.428571428571429,0.555555555555556,0,0,"orthodox"
"286318",25,32,175,173,178,173,140,140,19,40,0,6,19,22,"win_A",-7,2,5,0,0,0,0,0,1,0.869565217391304,1,0.478260869565217,0,"orthodox"
"286320",31,32,173,165,173,175,145,144,38,40,6,23,20,26,"win_A",-1,8,-2,1,0,0,0,0,0.863636363636364,0.634920634920635,0.454545454545455,0.412698412698413,0,"orthodox"
"286322",30,28,173,170,173,178,140,140,36,16,6,2,19,13,"win_A",2,3,-5,0,0,0,0,0,0.857142857142857,0.888888888888889,0.452380952380952,0.722222222222222,0,"orthodox"
"286323",30,29,173,175,173,180,143,143,35,31,6,8,18,19,"win_A",1,-2,-7,0,0,0,0,0,0.853658536585366,0.794871794871795,0.439024390243902,0.487179487179487,0,"orthodox"
"286325",30,22,173,170,173,170,142,139,34,24,5,0,18,18,"win_A",8,3,3,3,0,0,0,0,0.871794871794872,1,0.461538461538462,0.75,0,"orthodox"
"286331",28,23,173,180,173,170,141,140,29,9,4,0,16,9,"win_B",5,-7,3,1,0,0,0,0,0.878787878787879,1,0.484848484848485,1,1,"orthodox"
"286351",19,20,173,164,173,168,125,125,9,9,0,0,4,5,"win_A",-1,9,5,0,0,0,0,0,1,1,0.444444444444444,0.555555555555556,0,"orthodox"
"287208",28,30,157,160,160,178,105,105,15,36,0,17,12,17,"win_A",-2,-3,-18,0,0,0,0,0,1,0.679245283018868,0.8,0.320754716981132,0,"orthodox"
"287362",29,37,201,188,208,198,217,237,16,39,0,7,15,22,"win_A",-8,13,10,-20,0,1,0,1,1,0.847826086956522,0.9375,0.478260869565217,0,"orthodox"
"287383",26,24,192,188,206,198,218,222,24,21,2,0,13,11,"win_B",2,4,8,-4,0,0,0,0,0.923076923076923,1,0.5,0.523809523809524,1,"orthodox"
"287578",34,28,178,183,178,201,234,220,48,8,3,5,41,8,"win_A",6,-5,-23,14,0,0,0,0,0.941176470588235,0.615384615384615,0.803921568627451,0.615384615384615,0,"orthodox"
"287580",34,36,178,183,178,189,241,241,46,21,3,6,40,7,"win_A",-2,-5,-11,0,0,1,0,0,0.938775510204082,0.777777777777778,0.816326530612245,0.259259259259259,0,"orthodox"
"287583",32,34,178,193,178,206,245,263,43,17,3,4,38,16,"win_A",-2,-15,-28,-18,0,0,0,1,0.934782608695652,0.80952380952381,0.826086956521739,0.761904761904762,0,"orthodox"
"287585",30,36,178,191,178,191,252,247,41,19,3,5,36,13,"win_A",-6,-13,-13,5,0,1,0,0,0.931818181818182,0.791666666666667,0.818181818181818,0.541666666666667,0,"orthodox"
"287588",28,33,178,193,178,203,247,223,37,39,2,3,32,30,"win_A",-5,-15,-25,24,0,0,1,0,0.948717948717949,0.928571428571429,0.82051282051282,0.714285714285714,0,"orthodox"
"287590",32,27,191,178,201,178,253,252,35,35,6,1,25,30,"win_B",5,13,23,1,0,0,0,0,0.853658536585366,0.972222222222222,0.609756097560976,0.833333333333333,1,"orthodox"
"287593",25,33,178,188,178,178,239,238,31,22,1,5,26,13,"win_A",-8,-10,0,1,0,0,0,0,0.96875,0.814814814814815,0.8125,0.481481481481481,0,"orthodox"
"287595",25,32,178,188,178,188,233,239,29,14,1,14,24,10,"win_A",-7,-10,-10,-6,0,0,0,0,0.966666666666667,0.5,0.8,0.357142857142857,0,"orthodox"
"287596",25,30,178,191,178,193,234,209,28,17,1,5,24,11,"win_A",-5,-13,-15,25,0,0,1,0,0.96551724137931,0.772727272727273,0.827586206896552,0.5,0,"orthodox"
"287598",24,24,188,178,193,178,226,235,16,27,0,0,12,23,"win_A",0,10,15,-9,0,0,0,0,1,1,0.75,0.851851851851852,0,"orthodox"
"287600",28,24,191,178,211,178,223,224,18,25,1,0,16,21,"win_B",4,13,33,-1,0,0,0,0,0.947368421052632,1,0.842105263157895,0.84,1,"orthodox"
"287601",23,30,178,183,178,201,226,212,24,17,0,0,20,11,"win_A",-7,-5,-23,14,0,0,0,0,1,1,0.833333333333333,0.647058823529412,0,"orthodox"
"287603",23,24,178,188,178,198,225,219,22,25,0,2,18,17,"win_A",-1,-10,-20,6,0,0,0,0,1,0.925925925925926,0.818181818181818,0.62962962962963,0,"orthodox"
"287611",21,29,178,188,178,191,211,217,14,9,0,3,12,7,"win_A",-8,-10,-13,-6,0,0,0,0,1,0.75,0.857142857142857,0.583333333333333,0,"orthodox"
"287613",21,31,178,198,178,201,213,271,12,16,0,8,11,10,"win_A",-10,-20,-23,-58,0,0,0,1,1,0.666666666666667,0.916666666666667,0.416666666666667,0,"orthodox"
"287614",21,30,178,193,178,193,220,245,11,7,0,4,10,5,"win_A",-9,-15,-15,-25,0,0,0,1,1,0.636363636363636,0.909090909090909,0.454545454545455,0,"orthodox"
"287627",27,35,175,187,178,183,158,158,27,22,0,6,24,7,"win_B",-8,-12,-5,0,0,1,0,0,1,0.785714285714286,0.888888888888889,0.25,1,"southpaw"
"287631",24,28,175,185,178,185,157,157,22,22,0,2,19,15,"win_A",-4,-10,-7,0,0,0,0,0,1,0.916666666666667,0.863636363636364,0.625,0,"southpaw"
"287635",22,22,175,175,178,173,155,155,17,14,0,3,15,2,"win_A",0,0,5,0,0,0,0,0,1,0.823529411764706,0.882352941176471,0.117647058823529,0,"southpaw"
"287636",22,26,175,180,178,180,155,155,16,13,0,6,14,7,"win_A",-4,-5,-2,0,0,0,0,0,1,0.684210526315789,0.875,0.368421052631579,0,"southpaw"
"287639",22,29,175,185,178,193,159,159,12,9,0,5,10,7,"win_A",-7,-10,-15,0,0,0,0,0,1,0.642857142857143,0.833333333333333,0.5,0,"southpaw"
"287641",19,21,175,188,178,198,148,147,10,6,0,1,8,5,"win_A",-2,-13,-20,1,0,0,0,0,1,0.857142857142857,0.8,0.714285714285714,0,"southpaw"
"288152",29,30,178,178,185,178,148,146,29,22,1,5,11,10,"win_A",-1,0,7,2,0,0,0,0,0.966666666666667,0.814814814814815,0.366666666666667,0.37037037037037,0,"orthodox"
"288156",26,30,178,171,185,173,140,140,25,32,0,4,10,9,"win_A",-4,7,12,0,0,0,0,0,1,0.888888888888889,0.4,0.25,0,"orthodox"
"288157",26,30,178,173,185,183,138,140,24,23,0,10,10,8,"win_A",-4,5,2,-2,0,0,0,0,1,0.696969696969697,0.416666666666667,0.242424242424242,0,"orthodox"
"288161",24,28,178,180,185,185,141,140,20,37,0,8,7,32,"win_A",-4,-2,0,1,0,0,0,0,1,0.822222222222222,0.35,0.711111111111111,0,"orthodox"
"288169",21,30,178,173,185,185,140,143,10,19,0,7,4,8,"win_A",-9,5,0,-3,0,0,0,0,1,0.730769230769231,0.4,0.307692307692308,0,"orthodox"
"288765",31,45,193,177,198,182,217,238,19,49,1,9,13,41,"win_A",-14,16,16,-21,0,1,0,1,0.95,0.844827586206897,0.65,0.706896551724138,0,"orthodox"
"288768",39,42,177,177,182,188,225,215,48,29,7,16,40,15,"win_A",-3,0,-6,10,1,1,0,0,0.872727272727273,0.644444444444444,0.727272727272727,0.333333333333333,0,"orthodox"
"288772",32,37,185,177,193,182,200,196,30,45,3,6,20,37,"win_A",-5,8,11,4,0,1,0,0,0.909090909090909,0.882352941176471,0.606060606060606,0.725490196078431,0,"orthodox"
"288782",31,26,177,185,182,198,193,193,37,21,3,0,30,15,"win_A",5,-8,-16,0,0,0,0,0,0.925,1,0.75,0.714285714285714,0,"orthodox"
"288785",30,28,177,177,182,179,193,191,34,38,3,1,28,24,"win_A",2,0,3,2,0,0,0,0,0.918918918918919,0.974358974358974,0.756756756756757,0.615384615384615,0,"orthodox"
"288793",24,28,180,177,193,182,190,191,7,26,3,3,7,23,"win_B",-4,3,11,-1,0,0,0,0,0.7,0.896551724137931,0.7,0.793103448275862,1,"orthodox"
"288799",26,32,177,178,182,188,196,192,21,4,2,0,19,3,"win_A",-6,-1,-6,4,0,0,0,0,0.91304347826087,1,0.826086956521739,0.75,0,"orthodox"
"289005",28,32,183,178,185,188,147,150,20,44,3,5,12,26,"win_A",-4,5,-3,-3,0,0,0,0,0.869565217391304,0.897959183673469,0.521739130434783,0.530612244897959,0,"orthodox"
"289011",28,22,178,170,188,170,141,139,39,25,4,1,23,19,"win_A",6,8,18,2,0,0,0,0,0.906976744186046,0.961538461538462,0.534883720930233,0.730769230769231,0,"orthodox"
"289012",28,28,180,178,185,188,139,140,29,39,5,3,13,23,"win_A",0,2,-3,-1,0,0,0,0,0.852941176470588,0.928571428571429,0.382352941176471,0.547619047619048,0,"orthodox"
"289013",28,30,178,175,188,183,148,150,37,15,3,23,22,12,"win_A",-2,3,5,-2,0,0,0,0,0.925,0.394736842105263,0.55,0.315789473684211,0,"orthodox"
"289015",27,27,178,171,188,176,140,139,34,20,3,1,20,6,"win_A",0,7,12,1,0,0,0,0,0.918918918918919,0.952380952380952,0.540540540540541,0.285714285714286,0,"orthodox"
"289018",25,26,180,178,185,188,140,141,22,32,5,2,10,19,"win_A",-1,2,-3,-1,0,0,0,0,0.814814814814815,0.941176470588235,0.37037037037037,0.558823529411765,0,"orthodox"
"289023",24,32,178,177,188,175,142,142,27,27,1,3,18,8,"win_A",-8,1,13,0,0,0,0,0,0.964285714285714,0.9,0.642857142857143,0.266666666666667,0,"orthodox"
"289510",36,28,183,183,188,186,190,185,32,16,3,11,22,10,"win_A",8,0,2,5,1,0,0,0,0.914285714285714,0.592592592592593,0.628571428571429,0.37037037037037,0,"southpaw"
"289547",35,27,197,183,199,208,196,195,38,13,5,1,33,6,"win_A",8,14,-9,1,1,0,0,0,0.883720930232558,0.928571428571429,0.767441860465116,0.428571428571429,0,"southpaw"
"290440",28,23,163,173,157,182,134,134,38,21,4,2,24,11,"win_B",5,-10,-25,0,0,0,0,0,0.904761904761905,0.91304347826087,0.571428571428571,0.478260869565217,1,"orthodox"
"290452",29,24,166,163,168,157,129,127,59,25,9,1,58,17,"win_B",5,3,11,2,0,0,0,0,0.867647058823529,0.961538461538462,0.852941176470588,0.653846153846154,1,"orthodox"
"290458",22,29,163,163,157,165,127,128,19,36,0,21,14,11,"win_A",-7,0,-8,-1,0,0,0,0,1,0.631578947368421,0.736842105263158,0.192982456140351,0,"orthodox"
"290589",30,33,170,175,180,178,135,135,46,32,10,3,33,25,"win_A",-3,-5,2,0,0,0,0,0,0.821428571428571,0.914285714285714,0.589285714285714,0.714285714285714,0,"orthodox"
"290590",32,31,175,174,178,188,135,134,31,22,3,6,25,8,"win_A",1,1,-10,1,0,0,0,0,0.911764705882353,0.785714285714286,0.735294117647059,0.285714285714286,0,"orthodox"
"290592",31,36,175,168,178,161,134,134,29,37,2,8,24,27,"win_A",-5,7,17,0,0,1,0,0,0.935483870967742,0.822222222222222,0.774193548387097,0.6,0,"orthodox"
"290593",30,33,175,168,178,170,130,134,28,25,2,4,23,19,"win_A",-3,7,8,-4,0,0,0,0,0.933333333333333,0.862068965517241,0.766666666666667,0.655172413793103,0,"orthodox"
"290602",29,23,173,175,173,178,135,135,16,18,12,0,9,14,"win_B",6,-2,-5,0,0,0,0,0,0.571428571428571,1,0.321428571428571,0.777777777777778,1,"orthodox"
"290977",31,25,170,164,173,168,122,122,16,27,5,3,10,16,"win_A",6,6,5,0,0,0,0,0,0.761904761904762,0.9,0.476190476190476,0.533333333333333,0,"southpaw"
"290980",29,25,170,173,173,178,122,122,14,12,4,5,9,8,"win_A",4,-3,-5,0,0,0,0,0,0.777777777777778,0.705882352941177,0.5,0.470588235294118,0,"southpaw"
"290984",25,28,170,160,173,165,125,124,9,36,3,0,6,22,"win_A",-3,10,8,1,0,0,0,0,0.75,1,0.5,0.611111111111111,0,"southpaw"
"291011",21,18,198,183,206,198,219,187,10,6,0,2,9,5,"win_A",3,15,8,32,0,0,1,0,1,0.75,0.9,0.625,0,"orthodox"
"291037",26,19,165,168,174,170,126,126,36,37,15,7,8,14,"win_B",7,-3,4,0,0,0,0,0,0.705882352941177,0.840909090909091,0.156862745098039,0.318181818181818,1,"orthodox"
"291043",26,21,165,173,174,180,124,123,34,32,9,1,8,7,"win_B",5,-8,-6,1,0,0,0,0,0.790697674418605,0.96969696969697,0.186046511627907,0.212121212121212,1,"orthodox"
"291048",25,20,165,163,174,168,127,127,29,18,9,11,7,10,"win_A",5,2,6,0,0,0,0,0,0.763157894736842,0.620689655172414,0.184210526315789,0.344827586206897,0,"orthodox"
"291049",20,25,168,165,171,174,125,125,24,28,10,9,10,7,"win_B",-5,3,-3,0,0,0,0,0,0.705882352941177,0.756756756756757,0.294117647058824,0.189189189189189,1,"orthodox"
"291052",25,25,165,163,174,163,125,130,26,41,5,4,7,14,"win_B",0,2,11,-5,0,0,0,0,0.838709677419355,0.911111111111111,0.225806451612903,0.311111111111111,1,"orthodox"
"291054",19,24,168,165,171,174,125,125,17,24,6,4,7,7,"win_B",-5,3,-3,0,0,0,0,0,0.739130434782609,0.857142857142857,0.304347826086957,0.25,1,"orthodox"
"292082",35,44,193,196,206,207,263,235,37,40,2,5,13,27,"win_A",-9,-3,-1,28,1,1,1,0,0.948717948717949,0.888888888888889,0.333333333333333,0.6,0,"orthodox"
"292087",38,33,196,187,207,198,248,250,33,29,2,4,21,20,"win_A",5,9,9,-2,1,0,0,0,0.942857142857143,0.878787878787879,0.6,0.606060606060606,0,"southpaw"
"292090",35,36,196,180,207,185,246,242,30,26,1,12,18,14,"win_A",-1,16,22,4,1,1,0,0,0.967741935483871,0.684210526315789,0.580645161290323,0.368421052631579,0,"southpaw"
"292091",36,35,192,196,193,207,248,226,30,29,2,1,14,17,"win_B",1,-4,-14,22,1,1,1,0,0.9375,0.966666666666667,0.4375,0.566666666666667,1,"orthodox"
"292092",35,32,196,192,207,196,240,225,28,21,1,1,17,13,"win_A",3,4,11,15,1,0,1,0,0.96551724137931,0.954545454545455,0.586206896551724,0.590909090909091,0,"southpaw"
"292099",32,28,196,193,207,208,250,225,21,8,1,0,13,6,"win_A",4,3,-1,25,0,0,1,0,0.954545454545455,1,0.590909090909091,0.75,0,"southpaw"
"292101",32,28,196,185,207,189,253,228,19,15,1,19,11,11,"win_A",4,11,18,25,0,0,1,0,0.95,0.441176470588235,0.55,0.323529411764706,0,"southpaw"
"292102",31,37,196,180,207,198,253,230,18,15,1,5,10,7,"win_A",-6,16,9,23,0,1,1,0,0.947368421052632,0.75,0.526315789473684,0.35,0,"southpaw"
"292109",29,27,196,187,207,188,240,212,11,6,1,1,5,4,"win_A",2,9,19,28,0,0,1,0,0.916666666666667,0.857142857142857,0.416666666666667,0.571428571428571,0,"southpaw"
"292111",29,27,196,196,207,208,242,235,9,9,1,0,4,6,"win_A",2,0,-1,7,0,0,0,0,0.9,1,0.4,0.666666666666667,0,"southpaw"
"292117",22,28,187,196,194,207,236,216,6,4,0,0,3,0,"win_A",-6,-9,-13,20,0,0,1,0,1,1,0.5,0,0,"southpaw"
"292256",24,25,160,163,163,155,120,121,57,4,8,1,21,1,"win_B",-1,-3,8,-1,0,0,0,0,0.876923076923077,0.8,0.323076923076923,0.2,1,"orthodox"
"292265",28,26,169,170,175,170,136,127,107,70,28,37,47,27,"win_A",2,-1,5,9,0,0,0,0,0.792592592592593,0.654205607476635,0.348148148148148,0.252336448598131,0,"orthodox"
"292284",25,23,170,175,170,171,138,141,60,38,24,9,24,10,"win_A",2,-5,-1,-3,0,0,0,0,0.714285714285714,0.808510638297872,0.285714285714286,0.212765957446809,0,"orthodox"
"292311",23,24,170,175,170,183,136,134,42,107,9,32,18,65,"win_A",-1,-5,-13,2,0,0,0,0,0.823529411764706,0.76978417266187,0.352941176470588,0.467625899280576,0,"orthodox"
"292322",23,23,170,175,170,183,134,132,30,98,8,29,11,58,"win_A",0,-5,-13,2,0,0,0,0,0.789473684210526,0.771653543307087,0.289473684210526,0.456692913385827,0,"orthodox"
"292455",25,27,165,168,173,177,125,126,11,33,1,5,2,13,"win_A",-2,-3,-4,-1,0,0,0,0,0.916666666666667,0.868421052631579,0.166666666666667,0.342105263157895,0,"orthodox"
"292462",20,23,168,168,173,177,127,126,16,23,4,3,3,10,"win_A",-3,0,-4,1,0,0,0,0,0.8,0.884615384615385,0.15,0.384615384615385,0,"orthodox"
"292464",23,23,168,173,177,178,126,126,21,14,3,6,9,9,"win_A",0,-5,-1,0,0,0,0,0,0.875,0.7,0.375,0.45,0,"orthodox"
"292468",21,28,168,168,177,168,124,123,16,20,1,17,7,13,"win_A",-7,0,9,1,0,0,0,0,0.941176470588235,0.540540540540541,0.411764705882353,0.351351351351351,0,"orthodox"
"292472",20,24,168,170,177,170,123,123,12,19,0,5,7,8,"win_A",-4,-2,7,0,0,0,0,0,1,0.791666666666667,0.583333333333333,0.333333333333333,0,"orthodox"
"292717",22,24,163,165,173,168,117,119,20,52,10,8,5,8,"win_A",-2,-2,5,-2,0,0,0,0,0.666666666666667,0.866666666666667,0.166666666666667,0.133333333333333,0,"orthodox"
"293537",30,24,171,173,165,180,128,127,79,55,9,9,47,10,"win_B",6,-2,-15,1,0,0,0,0,0.897727272727273,0.859375,0.534090909090909,0.15625,1,"southpaw"
"293597",34,27,175,173,175,173,144,144,42,17,0,3,17,9,"win_A",7,2,2,0,0,0,0,0,1,0.85,0.404761904761905,0.45,0,"southpaw"
"293602",28,32,175,173,175,180,145,145,37,18,0,0,14,10,"win_A",-4,2,-5,0,0,0,0,0,1,1,0.378378378378378,0.555555555555556,0,"southpaw"
"293606",25,29,175,171,175,169,135,135,32,31,0,4,14,19,"win_A",-4,4,6,0,0,0,0,0,1,0.885714285714286,0.4375,0.542857142857143,0,"southpaw"
"293608",25,30,175,161,175,163,141,137,30,23,0,0,14,11,"win_A",-5,14,12,4,0,0,0,0,1,1,0.466666666666667,0.478260869565217,0,"southpaw"
"293612",23,24,175,170,175,170,135,132,26,31,0,2,13,23,"win_A",-1,5,5,3,0,0,0,0,1,0.939393939393939,0.5,0.696969696969697,0,"southpaw"
"293616",23,26,175,170,175,173,138,135,22,17,0,5,12,9,"win_A",-3,5,2,3,0,0,0,0,1,0.772727272727273,0.545454545454545,0.409090909090909,0,"southpaw"
"293623",22,33,175,166,175,173,134,133,15,9,0,12,9,2,"win_A",-11,9,2,1,0,0,0,0,1,0.428571428571429,0.6,0.0952380952380952,0,"southpaw"
"293870",32,31,174,183,174,188,150,150,33,17,0,6,26,12,"win_A",1,-9,-14,0,0,0,0,0,1,0.739130434782609,0.787878787878788,0.521739130434783,0,"southpaw"
"293894",27,32,174,165,174,175,143,143,7,40,0,24,5,26,"win_A",-5,9,-1,0,0,0,0,0,1,0.625,0.714285714285714,0.40625,0,"southpaw"
"294592",26,30,165,173,178,173,126,130,23,6,1,15,14,2,"win_A",-4,-8,5,-4,0,0,0,0,0.958333333333333,0.285714285714286,0.583333333333333,0.0952380952380952,0,"orthodox"
"294620",28,23,178,175,180,175,159,159,26,27,2,2,18,19,"win_A",5,3,5,0,0,0,0,0,0.928571428571429,0.931034482758621,0.642857142857143,0.655172413793103,0,"orthodox"
"294623",25,36,178,171,180,173,160,159,20,91,2,11,16,73,"win_A",-11,7,7,1,0,1,0,0,0.909090909090909,0.892156862745098,0.727272727272727,0.715686274509804,0,"orthodox"
"294631",23,27,178,183,180,196,157,155,13,7,1,8,9,7,"win_A",-4,-5,-16,2,0,0,0,0,0.928571428571429,0.466666666666667,0.642857142857143,0.466666666666667,0,"orthodox"
"294634",21,27,178,183,180,193,158,158,10,27,1,9,7,6,"win_A",-6,-5,-13,0,0,0,0,0,0.909090909090909,0.75,0.636363636363636,0.166666666666667,0,"orthodox"
"295477",38,40,193,188,203,198,266,212,50,70,5,11,44,57,"win_A",-2,5,5,54,1,1,1,0,0.909090909090909,0.864197530864197,0.8,0.703703703703704,0,"orthodox"
"295478",38,27,193,193,203,188,258,228,49,19,5,8,43,9,"win_A",11,0,15,30,1,0,1,0,0.907407407407407,0.703703703703704,0.796296296296296,0.333333333333333,0,"orthodox"
"295480",35,32,193,188,203,193,273,221,48,20,4,0,42,17,"win_B",3,5,10,52,1,0,1,0,0.923076923076923,1,0.807692307692308,0.85,1,"orthodox"
"295481",34,23,193,188,203,188,273,266,46,23,4,2,40,18,"win_A",11,5,15,7,0,0,0,0,0.92,0.92,0.8,0.72,0,"orthodox"
"295482",34,38,193,188,203,193,269,232,45,55,4,8,39,44,"win_A",-4,5,10,37,0,1,1,0,0.918367346938776,0.873015873015873,0.795918367346939,0.698412698412698,0,"orthodox"
"295484",33,36,193,196,203,208,253,265,43,25,4,6,37,16,"win_A",-3,-3,-5,-12,0,1,0,0,0.914893617021277,0.806451612903226,0.787234042553192,0.516129032258065,0,"orthodox"
"295486",33,20,193,180,203,188,258,260,40,7,4,5,34,5,"win_A",13,13,15,-2,0,0,0,0,0.909090909090909,0.583333333333333,0.772727272727273,0.416666666666667,0,"orthodox"
"295491",31,30,198,193,208,203,268,264,27,36,2,3,16,30,"win_A",1,5,5,4,0,0,0,0,0.931034482758621,0.923076923076923,0.551724137931034,0.769230769230769,0,"orthodox"
"295494",29,34,193,191,203,191,230,275,33,14,3,3,27,12,"win_A",-5,2,12,-45,0,0,0,1,0.916666666666667,0.823529411764706,0.75,0.705882352941177,0,"orthodox"
"295495",28,35,193,188,203,178,238,233,32,22,3,6,26,13,"win_A",-7,5,25,5,0,1,0,0,0.914285714285714,0.785714285714286,0.742857142857143,0.464285714285714,0,"orthodox"
"295498",27,26,193,188,203,198,240,250,30,23,2,13,24,23,"win_A",1,5,5,-10,0,0,0,0,0.9375,0.638888888888889,0.75,0.638888888888889,0,"orthodox"
"295503",24,29,193,183,203,201,225,215,25,15,0,0,20,10,"win_B",-5,10,2,10,0,0,0,0,1,1,0.8,0.666666666666667,1,"orthodox"
"295504",24,33,193,198,203,201,224,275,24,18,0,12,19,12,"win_A",-9,-5,2,-51,0,0,0,1,1,0.6,0.791666666666667,0.4,0,"orthodox"
"295505",23,32,193,191,203,198,220,226,23,17,0,5,18,13,"win_A",-9,2,5,-6,0,0,0,0,1,0.772727272727273,0.782608695652174,0.590909090909091,0,"orthodox"
"295506",23,28,193,188,203,188,222,231,22,14,0,4,17,6,"win_A",-5,5,15,-9,0,0,0,0,1,0.777777777777778,0.772727272727273,0.333333333333333,0,"orthodox"
"295507",23,38,193,185,203,196,224,214,21,7,0,13,17,3,"win_A",-15,8,7,10,0,1,0,0,1,0.35,0.80952380952381,0.15,0,"orthodox"
"295510",22,30,193,185,203,183,219,235,18,13,0,28,15,8,"win_A",-8,8,20,-16,0,0,0,1,1,0.317073170731707,0.833333333333333,0.195121951219512,0,"orthodox"
"295511",22,31,193,183,203,180,222,204,17,6,0,12,14,3,"win_A",-9,10,23,18,0,0,1,0,1,0.333333333333333,0.823529411764706,0.166666666666667,0,"orthodox"
"295512",22,29,193,191,203,183,219,230,16,20,0,4,13,19,"win_A",-7,2,20,-11,0,0,0,0,1,0.833333333333333,0.8125,0.791666666666667,0,"orthodox"
"295674",29,29,165,164,170,168,118,118,24,35,1,5,15,20,"win_A",0,1,2,0,0,0,0,0,0.96,0.875,0.6,0.5,0,"southpaw"
"296097",26,31,180,185,193,224,207,198,10,58,2,30,3,53,"win_A",-5,-5,-31,9,0,0,0,0,0.833333333333333,0.659090909090909,0.25,0.602272727272727,0,"orthodox"
"296098",26,31,180,185,193,224,211,202,9,58,2,29,3,53,"win_A",-5,-5,-31,9,0,0,0,0,0.818181818181818,0.666666666666667,0.272727272727273,0.609195402298851,0,"orthodox"
"296124",21,27,187,185,222,224,189,189,40,37,12,22,13,33,"win_A",-6,2,-2,0,0,0,0,0,0.769230769230769,0.627118644067797,0.25,0.559322033898305,0,"Unknown"
"296213",40,39,171,178,173,180,160,160,99,46,16,16,78,32,"win_A",1,-7,-7,0,1,1,0,0,0.860869565217391,0.741935483870968,0.678260869565217,0.516129032258065,0,"orthodox"
"296215",39,32,171,178,173,178,161,161,95,43,15,12,76,23,"win_A",7,-7,-5,0,1,0,0,0,0.863636363636364,0.781818181818182,0.690909090909091,0.418181818181818,0,"orthodox"
"296216",39,34,171,178,173,180,162,161,94,22,15,5,75,19,"win_A",5,-7,-7,1,1,0,0,0,0.862385321100917,0.814814814814815,0.688073394495413,0.703703703703704,0,"orthodox"
"296221",36,27,171,185,173,188,156,156,90,8,10,11,72,4,"win_A",9,-14,-15,0,1,0,0,0,0.9,0.421052631578947,0.72,0.210526315789474,0,"orthodox"
"296223",22,35,175,171,173,173,154,153,15,88,4,10,3,72,"win_B",-13,4,0,1,0,1,0,0,0.789473684210526,0.897959183673469,0.157894736842105,0.73469387755102,1,"orthodox"
"296228",26,33,178,171,178,173,154,153,33,86,1,7,21,70,"win_A",-7,7,5,1,0,0,0,0,0.970588235294118,0.924731182795699,0.617647058823529,0.752688172043011,0,"orthodox"
"296233",32,33,171,175,173,178,154,158,82,13,6,1,69,9,"win_A",-1,-4,-5,-4,0,0,0,0,0.931818181818182,0.928571428571429,0.784090909090909,0.642857142857143,0,"orthodox"
"296237",30,36,171,178,173,178,158,165,78,19,4,4,66,15,"win_A",-6,-7,-5,-7,0,1,0,0,0.951219512195122,0.826086956521739,0.804878048780488,0.652173913043478,0,"orthodox"
"296239",29,28,171,177,173,183,180,177,76,74,4,10,65,39,"win_A",1,-6,-10,3,0,0,0,0,0.95,0.880952380952381,0.8125,0.464285714285714,0,"orthodox"
"296241",37,28,171,171,173,173,157,157,27,74,0,4,24,63,"win_B",9,0,0,0,1,0,0,0,1,0.948717948717949,0.888888888888889,0.807692307692308,1,"orthodox"
"296251",25,22,171,191,173,201,155,155,65,14,2,1,57,12,"win_A",3,-20,-28,0,0,0,0,0,0.970149253731343,0.933333333333333,0.850746268656716,0.8,0,"orthodox"
"296252",25,25,171,178,173,180,155,153,64,44,2,6,56,26,"win_A",0,-7,-7,2,0,0,0,0,0.96969696969697,0.88,0.848484848484849,0.52,0,"orthodox"
"296253",23,25,173,171,178,173,147,147,37,64,3,1,28,56,"win_A",-2,2,5,0,0,0,0,0,0.925,0.984615384615385,0.7,0.861538461538462,0,"orthodox"
"296259",23,28,171,173,173,173,151,149,58,26,1,7,51,11,"win_A",-5,-2,0,2,0,0,0,0,0.983050847457627,0.787878787878788,0.864406779661017,0.333333333333333,0,"orthodox"
"296289",18,21,171,175,173,173,145,145,27,22,0,11,25,14,"win_A",-3,-4,0,0,0,0,0,0,1,0.666666666666667,0.925925925925926,0.424242424242424,0,"orthodox"
"296632",19,22,166,168,168,165,136,134,31,50,4,12,19,14,"win_A",-3,-2,3,2,0,0,0,0,0.885714285714286,0.806451612903226,0.542857142857143,0.225806451612903,0,"orthodox"
"296821",28,28,177,178,180,189,160,160,27,22,1,1,16,14,"win_A",0,-1,-9,0,0,0,0,0,0.964285714285714,0.956521739130435,0.571428571428571,0.608695652173913,0,"southpaw"
"296822",28,37,177,164,180,173,160,160,26,22,1,9,15,15,"win_A",-9,13,7,0,0,1,0,0,0.962962962962963,0.709677419354839,0.555555555555556,0.483870967741935,0,"southpaw"
"296825",26,33,177,183,180,193,165,163,23,16,1,4,15,9,"win_A",-7,-6,-13,2,0,0,0,0,0.958333333333333,0.8,0.625,0.45,0,"southpaw"
"296836",23,31,177,175,180,185,164,163,12,19,0,5,9,10,"win_A",-8,2,-5,1,0,0,0,0,1,0.791666666666667,0.75,0.416666666666667,0,"southpaw"
"297011",31,37,188,193,196,201,224,248,31,38,2,5,27,31,"win_A",-6,-5,-5,-24,0,1,0,1,0.939393939393939,0.883720930232558,0.818181818181818,0.720930232558139,0,"orthodox"
"297012",31,34,188,196,196,206,227,236,30,29,2,1,27,23,"win_A",-3,-8,-10,-9,0,0,0,0,0.9375,0.966666666666667,0.84375,0.766666666666667,0,"orthodox"
"297014",29,26,188,196,196,203,231,237,27,23,2,2,24,17,"win_A",3,-8,-7,-6,0,0,0,0,0.931034482758621,0.92,0.827586206896552,0.68,0,"orthodox"
"297015",29,34,188,180,196,188,224,221,26,13,2,15,23,3,"win_A",-5,8,8,3,0,0,0,0,0.928571428571429,0.464285714285714,0.821428571428571,0.107142857142857,0,"orthodox"
"297018",27,27,191,188,203,196,223,235,15,24,1,1,8,21,"win_A",0,3,7,-12,0,0,0,0,0.9375,0.96,0.5,0.84,0,"orthodox"
"297022",26,31,188,188,196,196,220,247,21,24,0,7,19,17,"win_A",-5,0,0,-27,0,0,0,1,1,0.774193548387097,0.904761904761905,0.548387096774194,0,"orthodox"
"297023",25,28,188,183,196,198,222,208,20,21,0,2,18,16,"win_A",-3,5,-2,14,0,0,0,0,1,0.91304347826087,0.9,0.695652173913043,0,"orthodox"
"297024",25,26,188,188,196,198,225,254,19,23,0,11,17,23,"win_A",-1,0,-2,-29,0,0,0,1,1,0.676470588235294,0.894736842105263,0.676470588235294,0,"orthodox"
"297025",25,34,188,182,196,183,223,258,18,20,0,24,16,9,"win_A",-9,6,13,-35,0,0,0,1,1,0.454545454545455,0.888888888888889,0.204545454545455,0,"orthodox"
"297026",25,30,188,180,196,203,222,217,17,7,0,13,15,4,"win_A",-5,8,-7,5,0,0,0,0,1,0.35,0.882352941176471,0.2,0,"orthodox"
"297028",24,29,188,213,196,218,219,233,15,20,0,7,14,18,"win_A",-5,-25,-22,-14,0,0,0,0,1,0.740740740740741,0.933333333333333,0.666666666666667,0,"orthodox"
"297029",24,27,188,180,196,193,223,208,14,9,0,9,13,9,"win_A",-3,8,3,15,0,0,1,0,1,0.5,0.928571428571429,0.5,0,"orthodox"
"297030",24,40,188,190,196,193,221,248,13,10,0,7,12,10,"win_A",-16,-2,3,-27,0,1,0,1,1,0.588235294117647,0.923076923076923,0.588235294117647,0,"orthodox"
"297031",24,30,188,178,196,183,222,240,12,24,0,12,11,16,"win_A",-6,10,13,-18,0,0,0,1,1,0.666666666666667,0.916666666666667,0.444444444444444,0,"orthodox"
"297032",24,30,188,183,196,180,220,201,11,11,0,17,11,3,"win_A",-6,5,16,19,0,0,1,0,1,0.392857142857143,1,0.107142857142857,0,"orthodox"
"297034",24,31,188,188,196,188,228,228,9,14,0,12,9,10,"win_A",-7,0,8,0,0,0,0,0,1,0.538461538461538,1,0.384615384615385,0,"orthodox"
"297040",23,27,188,187,196,188,222,218,3,4,0,2,3,1,"win_A",-4,1,8,4,0,0,0,0,1,0.666666666666667,1,0.166666666666667,0,"orthodox"
"297231",32,27,175,173,178,170,147,147,44,17,5,4,29,3,"win_A",5,2,8,0,0,0,0,0,0.897959183673469,0.80952380952381,0.591836734693878,0.142857142857143,0,"orthodox"
"297233",32,32,170,175,178,178,152,152,22,42,6,5,16,29,"win_B",0,-5,0,0,0,0,0,0,0.785714285714286,0.893617021276596,0.571428571428571,0.617021276595745,1,"orthodox"
"297239",25,27,175,173,178,180,150,150,37,22,3,14,26,10,"win_A",-2,2,-2,0,0,0,0,0,0.925,0.611111111111111,0.65,0.277777777777778,0,"orthodox"
"297241",24,30,175,180,178,180,145,145,35,13,3,3,24,11,"win_A",-6,-5,-2,0,0,0,0,0,0.921052631578947,0.8125,0.631578947368421,0.6875,0,"orthodox"
"297242",24,27,175,170,178,183,140,140,33,33,2,1,24,16,"win_A",-3,5,-5,0,0,0,0,0,0.942857142857143,0.970588235294118,0.685714285714286,0.470588235294118,0,"orthodox"
"297243",23,29,175,175,178,178,140,139,32,29,2,3,23,11,"win_A",-6,0,0,1,0,0,0,0,0.941176470588235,0.90625,0.676470588235294,0.34375,0,"orthodox"
"297245",23,31,175,178,178,170,138,140,30,22,2,1,21,16,"win_A",-8,-3,8,-2,0,0,0,0,0.9375,0.956521739130435,0.65625,0.695652173913043,0,"orthodox"
"297246",23,24,175,170,178,173,140,140,29,21,2,13,21,10,"win_A",-1,5,5,0,0,0,0,0,0.935483870967742,0.617647058823529,0.67741935483871,0.294117647058824,0,"orthodox"
"297249",22,26,175,178,178,180,140,139,26,32,2,4,20,20,"win_A",-4,-3,-2,1,0,0,0,0,0.928571428571429,0.888888888888889,0.714285714285714,0.555555555555556,0,"orthodox"
"297251",22,29,175,173,178,178,139,138,23,18,2,1,18,12,"win_A",-7,2,0,1,0,0,0,0,0.92,0.947368421052632,0.72,0.631578947368421,0,"orthodox"
"297277",29,31,176,168,183,168,149,149,53,11,4,19,31,5,"win_A",-2,8,15,0,0,0,0,0,0.929824561403509,0.366666666666667,0.543859649122807,0.166666666666667,0,"orthodox"
"297283",26,31,176,173,183,183,149,147,45,18,2,3,28,15,"win_A",-5,3,0,2,0,0,0,0,0.957446808510638,0.857142857142857,0.595744680851064,0.714285714285714,0,"orthodox"
"297284",25,25,176,175,183,173,148,149,44,32,2,9,28,20,"win_A",0,1,10,-1,0,0,0,0,0.956521739130435,0.780487804878049,0.608695652173913,0.48780487804878,0,"orthodox"
"297286",25,28,176,165,183,175,147,147,42,31,2,10,26,19,"win_A",-3,11,8,0,0,0,0,0,0.954545454545455,0.75609756097561,0.590909090909091,0.463414634146341,0,"orthodox"
"297288",25,24,176,175,183,175,149,149,40,20,2,2,25,15,"win_A",1,1,8,0,0,0,0,0,0.952380952380952,0.909090909090909,0.595238095238095,0.681818181818182,0,"orthodox"
"297293",23,25,176,180,183,191,147,146,35,27,1,0,23,19,"win_A",-2,-4,-8,1,0,0,0,0,0.972222222222222,1,0.638888888888889,0.703703703703704,0,"orthodox"
"297298",22,28,176,175,183,183,148,148,30,7,0,18,18,2,"win_A",-6,1,0,0,0,0,0,0,1,0.28,0.6,0.08,0,"orthodox"
"297301",21,28,176,173,183,170,146,145,27,25,0,0,17,18,"win_A",-7,3,13,1,0,0,0,0,1,1,0.62962962962963,0.72,0,"orthodox"
"297312",18,32,176,175,183,178,140,136,14,0,0,1,10,0,"win_A",-14,1,5,4,0,0,0,0,1,0,0.714285714285714,0,0,"orthodox"
"297318",18,32,176,177,183,183,140,140,8,24,0,3,6,8,"win_A",-14,-1,0,0,0,0,0,0,1,0.888888888888889,0.75,0.296296296296296,0,"orthodox"
"298708",32,23,177,180,185,188,160,158,31,24,4,3,24,16,"win_A",9,-3,-3,2,0,0,0,0,0.885714285714286,0.888888888888889,0.685714285714286,0.592592592592593,0,"southpaw"
"298710",31,41,177,185,185,186,164,171,28,13,4,24,22,9,"win_A",-10,-8,-1,-7,0,1,0,0,0.875,0.351351351351351,0.6875,0.243243243243243,0,"southpaw"
"298712",31,26,177,175,185,183,165,165,26,26,4,5,21,20,"win_A",5,2,2,0,0,0,0,0,0.866666666666667,0.838709677419355,0.7,0.645161290322581,0,"southpaw"
"298720",27,30,177,177,185,185,160,157,18,27,2,4,14,19,"win_A",-3,0,0,3,0,0,0,0,0.9,0.870967741935484,0.7,0.612903225806452,0,"southpaw"
"298721",27,30,177,175,185,183,160,158,17,15,2,26,14,12,"win_A",-3,2,2,2,0,0,0,0,0.894736842105263,0.365853658536585,0.736842105263158,0.292682926829268,0,"southpaw"
"298722",27,22,177,173,185,178,160,160,17,20,1,3,14,13,"win_B",5,4,7,0,0,0,0,0,0.944444444444444,0.869565217391304,0.777777777777778,0.565217391304348,1,"southpaw"
"298724",26,32,177,174,185,181,157,160,15,11,1,6,12,4,"win_A",-6,3,4,-3,0,0,0,0,0.9375,0.647058823529412,0.75,0.235294117647059,0,"southpaw"
"298725",26,29,177,177,185,185,162,162,14,9,1,1,11,8,"win_A",-3,0,0,0,0,0,0,0,0.933333333333333,0.9,0.733333333333333,0.8,0,"southpaw"
"299215",28,31,157,157,152,168,110,110,28,23,10,19,15,13,"win_A",-3,0,-16,0,0,0,0,0,0.736842105263158,0.547619047619048,0.394736842105263,0.30952380952381,0,"orthodox"
"299216",28,21,157,165,152,163,108,108,27,24,10,1,15,12,"win_A",7,-8,-11,0,0,0,0,0,0.72972972972973,0.96,0.405405405405405,0.48,0,"orthodox"
"299221",24,23,157,159,152,157,117,116,24,17,7,11,13,9,"win_A",1,-2,-5,1,0,0,0,0,0.774193548387097,0.607142857142857,0.419354838709677,0.321428571428571,0,"orthodox"
"299222",25,24,160,157,163,152,108,107,25,24,4,6,23,13,"win_A",1,3,11,1,0,0,0,0,0.862068965517241,0.8,0.793103448275862,0.433333333333333,0,"orthodox"
"299223",27,24,160,157,152,152,107,107,20,23,3,6,14,13,"win_B",3,3,0,0,0,0,0,0,0.869565217391304,0.793103448275862,0.608695652173913,0.448275862068966,1,"orthodox"
"299231",21,28,157,165,152,170,108,108,14,15,6,2,9,14,"win_A",-7,-8,-18,0,0,0,0,0,0.7,0.882352941176471,0.45,0.823529411764706,0,"orthodox"
"299236",20,28,157,163,152,173,108,108,9,25,4,19,5,14,"win_A",-8,-6,-21,0,0,0,0,0,0.692307692307692,0.568181818181818,0.384615384615385,0.318181818181818,0,"orthodox"
"299262",22,28,180,175,180,185,181,185,52,29,9,11,32,10,"win_A",-6,5,-5,-4,0,0,0,0,0.852459016393443,0.725,0.524590163934426,0.25,0,"orthodox"
"299522",28,21,187,193,196,203,200,210,20,19,6,3,13,15,"win_A",7,-6,-7,-10,0,0,0,0,0.769230769230769,0.863636363636364,0.5,0.681818181818182,0,"orthodox"
"299624",22,29,175,168,183,178,131,133,91,74,26,32,55,24,"win_A",-7,7,5,-2,0,0,0,0,0.777777777777778,0.69811320754717,0.47008547008547,0.226415094339623,0,"Unknown"
"300056",26,31,188,181,188,182,175,172,9,22,1,0,6,14,"win_A",-5,7,6,3,0,0,0,0,0.9,1,0.6,0.636363636363636,0,"orthodox"
"300068",27,30,169,175,174,175,130,130,20,28,2,2,9,20,"win_A",-3,-6,-1,0,0,0,0,0,0.909090909090909,0.933333333333333,0.409090909090909,0.666666666666667,0,"southpaw"
"300451",20,24,169,178,178,180,134,133,30,65,1,17,9,12,"win_A",-4,-9,-2,1,0,0,0,0,0.967741935483871,0.792682926829268,0.290322580645161,0.146341463414634,0,"Unknown"
"300453",24,22,178,178,180,184,139,143,63,33,12,7,11,12,"win_A",2,0,-4,-4,0,0,0,0,0.84,0.825,0.146666666666667,0.3,0,"Unknown"
"300998",25,34,173,172,183,175,160,160,18,44,2,10,13,31,"win_A",-9,1,8,0,0,0,0,0,0.9,0.814814814814815,0.65,0.574074074074074,0,"orthodox"
"301003",32,27,172,185,175,188,154,154,41,16,8,3,28,9,"win_A",5,-13,-13,0,0,0,0,0,0.836734693877551,0.842105263157895,0.571428571428571,0.473684210526316,0,"southpaw"
"301005",32,26,172,178,175,188,152,149,39,36,8,2,27,23,"win_A",6,-6,-13,3,0,0,0,0,0.829787234042553,0.947368421052632,0.574468085106383,0.605263157894737,0,"southpaw"
"301006",27,31,183,172,191,175,153,153,27,38,7,7,10,26,"win_A",-4,11,16,0,0,0,0,0,0.794117647058823,0.844444444444444,0.294117647058824,0.577777777777778,0,"orthodox"
"301007",31,22,172,175,175,191,152,152,37,13,7,0,25,10,"win_A",9,-3,-16,0,0,0,0,0,0.840909090909091,1,0.568181818181818,0.769230769230769,0,"southpaw"
"301014",26,26,172,170,175,175,147,148,30,19,3,0,20,7,"win_A",0,2,0,-1,0,0,0,0,0.909090909090909,1,0.606060606060606,0.368421052631579,0,"southpaw"
"301176",27,26,170,165,175,164,126,126,34,29,1,2,15,19,"win_A",1,5,11,0,0,0,0,0,0.971428571428571,0.935483870967742,0.428571428571429,0.612903225806452,0,"southpaw"
"301181",24,25,170,179,175,170,127,127,29,19,0,3,14,12,"win_B",-1,-9,5,0,0,0,0,0,1,0.863636363636364,0.482758620689655,0.545454545454545,1,"southpaw"
"301183",24,30,170,175,175,183,126,126,27,21,0,6,13,12,"win_A",-6,-5,-8,0,0,0,0,0,1,0.777777777777778,0.481481481481481,0.444444444444444,0,"southpaw"
"301185",23,33,170,170,175,173,129,129,25,21,0,6,12,11,"win_A",-10,0,2,0,0,0,0,0,1,0.777777777777778,0.48,0.407407407407407,0,"southpaw"
"301187",23,32,170,170,175,173,127,127,23,17,0,2,11,12,"win_A",-9,0,2,0,0,0,0,0,1,0.894736842105263,0.478260869565217,0.631578947368421,0,"southpaw"
"301190",22,26,170,173,175,178,128,128,20,15,0,10,9,10,"win_A",-4,-3,-3,0,0,0,0,0,1,0.6,0.45,0.4,0,"southpaw"
"301194",22,32,170,171,175,175,128,127,16,13,0,6,8,5,"win_A",-10,-1,0,1,0,0,0,0,1,0.684210526315789,0.5,0.263157894736842,0,"southpaw"
"301484",34,26,171,165,175,168,124,128,15,24,13,5,7,13,"win_A",8,6,7,-4,0,0,0,0,0.535714285714286,0.827586206896552,0.25,0.448275862068966,0,"orthodox"
"301487",24,26,165,173,168,178,126,125,21,15,4,7,11,10,"win_A",-2,-8,-10,1,0,0,0,0,0.84,0.681818181818182,0.44,0.454545454545455,0,"southpaw"
"301489",23,34,165,170,168,180,125,125,19,32,4,7,10,20,"win_A",-11,-5,-12,0,0,0,0,0,0.826086956521739,0.82051282051282,0.434782608695652,0.512820512820513,0,"southpaw"
"301490",23,32,165,168,168,183,125,127,18,17,4,5,9,6,"win_A",-9,-3,-15,-2,0,0,0,0,0.818181818181818,0.772727272727273,0.409090909090909,0.272727272727273,0,"southpaw"
"301494",21,20,165,178,168,178,128,131,11,11,4,1,6,3,"win_A",1,-13,-10,-3,0,0,0,0,0.733333333333333,0.916666666666667,0.4,0.25,0,"southpaw"
"301503",19,22,165,170,168,175,128,128,3,5,2,0,1,2,"win_A",-3,-5,-7,0,0,0,0,0,0.6,1,0.2,0.4,0,"southpaw"
"301602",31,28,188,193,191,201,190,208,59,11,13,4,39,4,"win_A",3,-5,-10,-18,0,0,0,1,0.819444444444444,0.733333333333333,0.541666666666667,0.266666666666667,0,"orthodox"
"302249",26,29,168,165,175,175,111,110,15,27,1,11,8,14,"win_A",-3,3,0,1,0,0,0,0,0.9375,0.710526315789474,0.5,0.368421052631579,0,"orthodox"
"302272",25,32,175,175,185,173,139,140,10,49,0,19,8,34,"win_A",-7,0,12,-1,0,0,0,0,1,0.720588235294118,0.8,0.5,0,"orthodox"
"302273",25,31,175,175,185,183,142,144,9,19,0,8,8,15,"win_A",-6,0,2,-2,0,0,0,0,1,0.703703703703704,0.888888888888889,0.555555555555556,0,"orthodox"
"302277",25,25,175,173,185,185,140,141,4,5,0,0,4,1,"win_A",0,2,0,-1,0,0,0,0,1,1,1,0.2,0,"orthodox"
"302386",37,24,191,189,208,213,254,202,36,14,5,7,28,9,"win_A",13,2,-5,52,1,0,1,0,0.878048780487805,0.666666666666667,0.682926829268293,0.428571428571429,0,"orthodox"
"302387",35,36,191,195,208,203,254,243,35,38,5,16,27,27,"win_A",-1,-4,5,11,1,1,0,0,0.875,0.703703703703704,0.675,0.5,0,"orthodox"
"302390",35,29,191,185,208,191,242,234,32,17,5,8,24,12,"win_A",6,6,17,8,1,0,0,0,0.864864864864865,0.68,0.648648648648649,0.48,0,"orthodox"
"302391",31,35,178,191,183,208,250,228,31,31,13,5,18,23,"win_B",-4,-13,-25,22,0,1,1,0,0.704545454545455,0.861111111111111,0.409090909090909,0.638888888888889,1,"orthodox"
"302393",34,32,191,185,208,185,247,249,29,6,5,4,21,5,"win_A",2,6,23,-2,0,0,0,0,0.852941176470588,0.6,0.617647058823529,0.5,0,"orthodox"
"302401",26,24,191,191,198,208,226,225,19,19,7,1,14,12,"win_B",2,0,-10,1,0,0,0,0,0.730769230769231,0.95,0.538461538461538,0.6,1,"orthodox"
"302525",36,33,196,201,208,218,237,230,52,26,3,0,43,16,"win_B",3,-5,-10,7,1,0,0,0,0.945454545454545,1,0.781818181818182,0.615384615384615,1,"orthodox"
"302526",36,28,196,187,208,198,243,236,52,31,2,3,43,27,"win_B",8,9,10,7,1,0,0,0,0.962962962962963,0.911764705882353,0.796296296296296,0.794117647058823,1,"orthodox"
"302533",33,28,196,182,208,183,239,229,45,18,1,14,37,8,"win_A",5,14,25,10,0,0,0,0,0.978260869565217,0.5625,0.804347826086957,0.25,0,"orthodox"
"302635",40,38,193,198,201,203,242,228,41,25,6,4,33,16,"win_B",2,-5,-2,14,1,1,0,0,0.872340425531915,0.862068965517241,0.702127659574468,0.551724137931034,1,"orthodox"
"302637",39,34,193,198,201,203,241,288,39,34,6,5,32,29,"win_A",5,-5,-2,-47,1,0,0,1,0.866666666666667,0.871794871794872,0.711111111111111,0.743589743589744,0,"orthodox"
"302638",32,36,188,193,198,201,238,239,40,38,5,4,28,31,"win_A",-4,-5,-3,-1,0,1,0,0,0.888888888888889,0.904761904761905,0.622222222222222,0.738095238095238,0,"orthodox"
"302641",32,27,193,188,201,198,246,250,34,24,4,16,28,24,"win_A",5,5,3,-4,0,0,0,0,0.894736842105263,0.6,0.736842105263158,0.6,0,"orthodox"
"302642",31,31,193,188,201,196,247,238,33,24,3,6,27,17,"win_A",0,5,5,9,0,0,0,0,0.916666666666667,0.8,0.75,0.566666666666667,0,"orthodox"
"302643",41,31,188,193,196,201,238,239,26,32,17,3,16,27,"win_B",10,-5,-5,-1,1,0,0,0,0.604651162790698,0.914285714285714,0.372093023255814,0.771428571428571,1,"orthodox"
"302644",30,23,193,198,201,206,241,262,30,16,3,5,27,10,"win_A",7,-5,-5,-21,0,0,0,1,0.909090909090909,0.761904761904762,0.818181818181818,0.476190476190476,0,"orthodox"
"302646",30,31,193,188,201,201,240,293,28,19,3,3,25,14,"win_A",-1,5,0,-53,0,0,0,1,0.903225806451613,0.863636363636364,0.806451612903226,0.636363636363636,0,"orthodox"
"302647",28,28,193,193,203,201,238,216,24,27,1,0,18,24,"win_B",0,0,2,22,0,0,1,0,0.96,1,0.72,0.888888888888889,1,"orthodox"
"302651",27,22,193,188,201,193,236,287,23,15,0,1,20,15,"win_A",5,5,8,-51,0,0,0,1,1,0.9375,0.869565217391304,0.9375,0,"orthodox"
"302652",27,38,193,185,201,196,238,207,22,7,0,14,20,3,"win_A",-11,8,5,31,0,1,1,0,1,0.333333333333333,0.909090909090909,0.142857142857143,0,"orthodox"
"302658",26,31,193,185,201,185,233,202,15,21,0,6,13,10,"win_A",-5,8,16,31,0,0,1,0,1,0.777777777777778,0.866666666666667,0.37037037037037,0,"orthodox"
"302659",25,31,193,198,201,201,226,255,14,15,0,7,12,9,"win_A",-6,-5,0,-29,0,0,0,1,1,0.681818181818182,0.857142857142857,0.409090909090909,0,"orthodox"
"302661",25,36,193,185,201,196,229,205,12,6,0,6,11,3,"win_A",-11,8,5,24,0,1,1,0,1,0.5,0.916666666666667,0.25,0,"orthodox"
"302666",24,36,193,180,201,193,227,210,7,31,0,16,6,18,"win_A",-12,13,8,17,0,1,1,0,1,0.659574468085106,0.857142857142857,0.382978723404255,0,"orthodox"
"303379",26,34,175,175,175,180,148,148,17,30,3,7,8,17,"win_A",-8,0,-5,0,0,0,0,0,0.85,0.810810810810811,0.4,0.459459459459459,0,"orthodox"
"303381",24,27,175,168,175,183,149,146,13,12,3,2,4,11,"win_A",-3,7,-8,3,0,0,0,0,0.8125,0.857142857142857,0.25,0.785714285714286,0,"orthodox"
"303384",23,22,175,183,175,183,156,159,11,18,2,1,4,9,"win_A",1,-8,-8,-3,0,0,0,0,0.846153846153846,0.947368421052632,0.307692307692308,0.473684210526316,0,"orthodox"
"303387",23,30,175,175,175,188,147,148,8,6,2,1,3,4,"win_A",-7,0,-13,-1,0,0,0,0,0.8,0.857142857142857,0.3,0.571428571428571,0,"orthodox"
"303388",22,25,175,173,175,173,148,146,7,6,2,2,3,4,"win_A",-3,2,2,2,0,0,0,0,0.777777777777778,0.75,0.333333333333333,0.5,0,"orthodox"
"303962",20,28,169,169,165,175,129,131,56,51,5,64,30,10,"win_A",-8,0,-10,-2,0,0,0,0,0.918032786885246,0.443478260869565,0.491803278688525,0.0869565217391304,0,"orthodox"
"304287",36,34,185,180,196,181,153,154,35,23,3,6,22,17,"win_A",2,5,15,-1,1,0,0,0,0.921052631578947,0.793103448275862,0.578947368421053,0.586206896551724,0,"southpaw"
"304289",36,30,185,182,196,183,154,154,33,29,3,9,22,20,"win_A",6,3,13,0,1,0,0,0,0.916666666666667,0.763157894736842,0.611111111111111,0.526315789473684,0,"southpaw"
"304298",31,36,185,168,196,165,157,161,23,21,2,27,13,4,"win_A",-5,17,31,-4,0,1,0,0,0.92,0.4375,0.52,0.0833333333333333,0,"southpaw"
"304300",30,30,185,175,196,180,153,152,21,24,2,11,12,13,"win_A",0,10,16,1,0,0,0,0,0.91304347826087,0.685714285714286,0.521739130434783,0.371428571428571,0,"southpaw"
"304303",29,21,185,170,196,173,154,154,18,16,2,1,10,8,"win_A",8,15,23,0,0,0,0,0,0.9,0.941176470588235,0.5,0.470588235294118,0,"southpaw"
"304305",28,26,185,178,196,180,155,154,16,44,2,7,9,26,"win_A",2,7,16,1,0,0,0,0,0.888888888888889,0.862745098039216,0.5,0.509803921568627,0,"southpaw"
"304307",28,24,185,185,196,180,154,153,14,34,2,3,7,22,"win_A",4,0,16,1,0,0,0,0,0.875,0.918918918918919,0.4375,0.594594594594595,0,"southpaw"
"304554",27,23,179,175,188,185,159,163,57,18,14,4,30,10,"win_A",4,4,3,-4,0,0,0,0,0.802816901408451,0.818181818181818,0.422535211267606,0.454545454545455,0,"Unknown"
"304853",26,20,163,168,163,171,127,132,45,26,5,11,16,11,"win_A",6,-5,-8,-5,0,0,0,0,0.9,0.702702702702703,0.32,0.297297297297297,0,"orthodox"
"305148",24,30,198,192,213,193,246,225,52,12,4,6,46,9,"win_A",-6,6,20,21,0,0,1,0,0.928571428571429,0.666666666666667,0.821428571428571,0.5,0,"orthodox"
"305176",20,21,198,196,213,201,238,204,24,14,1,1,23,14,"win_A",-1,2,12,34,0,0,1,0,0.96,0.933333333333333,0.92,0.933333333333333,0,"orthodox"
"305856",20,24,160,168,173,175,111,115,18,11,0,6,11,2,"win_A",-4,-8,-2,-4,0,0,0,0,1,0.647058823529412,0.611111111111111,0.117647058823529,0,"orthodox"
"305857",20,22,160,164,173,165,112,111,17,18,0,7,10,11,"win_A",-2,-4,8,1,0,0,0,0,1,0.72,0.588235294117647,0.44,0,"orthodox"
"306132",24,25,173,175,182,178,135,135,24,21,3,2,12,12,"win_B",-1,-2,4,0,0,0,0,0,0.888888888888889,0.91304347826087,0.444444444444444,0.521739130434783,1,"Unknown"
"306219",32,29,175,170,178,176,140,140,34,14,5,4,31,10,"win_A",3,5,2,0,0,0,0,0,0.871794871794872,0.777777777777778,0.794871794871795,0.555555555555556,0,"orthodox"
"306229",29,27,182,175,185,178,139,140,34,25,2,1,22,25,"win_A",2,7,7,-1,0,0,0,0,0.944444444444444,0.961538461538462,0.611111111111111,0.961538461538462,0,"orthodox"
"306242",23,30,175,165,178,170,144,146,12,3,0,6,12,2,"win_A",-7,10,8,-2,0,0,0,0,1,0.333333333333333,1,0.222222222222222,0,"orthodox"
"306399",27,32,166,168,168,168,125,125,20,27,1,14,17,21,"win_A",-5,-2,0,0,0,0,0,0,0.952380952380952,0.658536585365854,0.80952380952381,0.51219512195122,0,"orthodox"
"306417",22,24,166,170,168,180,126,125,1,1,0,0,1,0,"win_A",-2,-4,-12,1,0,0,0,0,1,1,1,0,0,"orthodox"
"306539",31,27,173,175,178,183,159,156,47,12,4,9,36,8,"win_A",4,-2,-5,3,0,0,0,0,0.92156862745098,0.571428571428571,0.705882352941177,0.380952380952381,0,"orthodox"
"306543",27,25,180,173,185,178,147,147,22,43,3,3,18,33,"win_A",2,7,7,0,0,0,0,0,0.88,0.934782608695652,0.72,0.717391304347826,0,"orthodox"
"306546",24,30,173,178,178,188,153,161,39,43,3,5,30,26,"win_A",-6,-5,-10,-8,0,0,0,0,0.928571428571429,0.895833333333333,0.714285714285714,0.541666666666667,0,"orthodox"
"306557",19,19,173,175,178,173,137,132,28,21,1,3,20,15,"win_B",0,-2,5,5,0,0,0,0,0.96551724137931,0.875,0.689655172413793,0.625,1,"orthodox"
"306606",34,32,183,178,173,176,153,154,36,34,0,1,23,24,"win_A",2,5,-3,-1,0,0,0,0,1,0.971428571428571,0.638888888888889,0.685714285714286,0,"southpaw"
"306608",32,29,183,173,173,178,153,153,34,36,0,2,23,18,"win_A",3,10,-5,0,0,0,0,0,1,0.947368421052632,0.676470588235294,0.473684210526316,0,"southpaw"
"306633",33,24,175,183,183,173,155,152,22,7,57,0,16,4,"win_B",9,-8,10,3,0,0,0,0,0.278481012658228,1,0.20253164556962,0.571428571428571,1,"orthodox"
"306808",28,20,163,169,169,178,128,130,54,29,21,1,12,9,"win_B",8,-6,-9,-2,0,0,0,0,0.72,0.966666666666667,0.16,0.3,1,"Unknown"
"306867",29,27,188,185,198,191,168,168,25,23,1,1,19,14,"win_A",2,3,7,0,0,0,0,0,0.961538461538462,0.958333333333333,0.730769230769231,0.583333333333333,0,"orthodox"
"307122",22,37,175,173,180,180,137,139,23,55,1,14,18,26,"win_A",-15,2,0,-2,0,1,0,0,0.958333333333333,0.797101449275362,0.75,0.376811594202899,0,"orthodox"
"307123",26,36,170,173,183,180,140,140,29,55,1,13,14,26,"win_A",-10,-3,3,0,0,1,0,0,0.966666666666667,0.808823529411765,0.466666666666667,0.382352941176471,0,"orthodox"
"307757",39,38,191,183,201,189,249,234,34,23,6,11,26,7,"win_A",1,8,12,15,1,1,1,0,0.85,0.676470588235294,0.65,0.205882352941176,0,"orthodox"
"307762",34,35,196,191,208,201,240,226,21,28,0,5,12,23,"win_B",-1,5,7,14,0,1,0,0,1,0.848484848484849,0.571428571428571,0.696969696969697,1,"orthodox"
"307769",33,27,191,198,201,206,238,312,22,22,4,6,17,14,"win_B",6,-7,-5,-74,0,0,0,1,0.846153846153846,0.785714285714286,0.653846153846154,0.5,1,"orthodox"
"307770",32,37,191,185,201,193,238,225,21,21,4,19,16,3,"win_A",-5,6,8,13,0,1,0,0,0.84,0.525,0.64,0.075,0,"orthodox"
"307772",28,32,203,191,213,201,236,256,22,20,1,3,18,15,"win_A",-4,12,12,-20,0,0,0,1,0.956521739130435,0.869565217391304,0.782608695652174,0.652173913043478,0,"orthodox"
"307774",31,32,191,198,201,208,230,235,19,22,2,1,14,18,"win_A",-1,-7,-7,-5,0,0,0,0,0.904761904761905,0.956521739130435,0.666666666666667,0.782608695652174,0,"orthodox"
"307775",31,27,191,185,201,196,237,230,18,9,2,8,13,8,"win_A",4,6,5,7,0,0,0,0,0.9,0.529411764705882,0.65,0.470588235294118,0,"orthodox"
"307777",29,31,191,191,201,193,222,210,15,18,2,7,10,11,"win_A",-2,0,8,12,0,0,0,0,0.882352941176471,0.72,0.588235294117647,0.44,0,"orthodox"
"307778",42,29,185,191,196,201,233,216,11,14,29,2,4,10,"win_B",13,-6,-5,17,1,0,1,0,0.275,0.875,0.1,0.625,1,"orthodox"
"307779",29,26,191,188,201,196,234,223,13,21,2,1,9,17,"win_A",3,3,5,11,0,0,0,0,0.866666666666667,0.954545454545455,0.6,0.772727272727273,0,"orthodox"
"307781",28,33,191,171,201,173,239,218,11,23,2,6,7,17,"win_A",-5,20,28,21,0,0,1,0,0.846153846153846,0.793103448275862,0.538461538461538,0.586206896551724,0,"orthodox"
"307782",33,28,191,191,199,201,228,230,41,10,6,2,39,6,"win_B",5,0,-2,-2,0,0,0,0,0.872340425531915,0.833333333333333,0.829787234042553,0.5,1,"orthodox"
"307785",27,26,191,188,201,188,228,219,7,10,1,0,4,5,"win_A",1,3,13,9,0,0,0,0,0.875,1,0.5,0.5,0,"orthodox"
"307856",31,23,169,157,175,183,124,125,142,18,33,4,69,4,"win_A",8,12,-8,-1,0,0,0,0,0.811428571428571,0.818181818181818,0.394285714285714,0.181818181818182,0,"orthodox"
"308243",28,28,187,180,222,193,183,202,66,15,18,4,22,5,"win_A",0,7,29,-19,0,0,0,1,0.785714285714286,0.789473684210526,0.261904761904762,0.263157894736842,0,"Unknown"
"308255",26,25,187,183,222,198,185,180,55,43,17,18,18,23,"win_A",1,4,24,5,0,0,0,0,0.763888888888889,0.704918032786885,0.25,0.377049180327869,0,"Unknown"
"308272",19,24,187,183,222,193,183,178,33,75,12,26,11,21,"win_A",-5,4,29,5,0,0,0,0,0.733333333333333,0.742574257425743,0.244444444444444,0.207920792079208,0,"Unknown"
"308517",27,24,164,170,168,173,119,120,33,28,4,7,20,26,"win_A",3,-6,-5,-1,0,0,0,0,0.891891891891892,0.8,0.540540540540541,0.742857142857143,0,"orthodox"
"308518",27,23,164,168,168,170,118,118,32,12,4,5,20,8,"win_A",4,-4,-2,0,0,0,0,0,0.888888888888889,0.705882352941177,0.555555555555556,0.470588235294118,0,"orthodox"
"308521",25,23,164,160,168,163,118,118,28,22,4,13,16,9,"win_A",2,4,5,0,0,0,0,0,0.875,0.628571428571429,0.5,0.257142857142857,0,"orthodox"
"308522",25,27,164,168,168,168,118,118,27,19,4,4,16,14,"win_A",-2,-4,0,0,0,0,0,0,0.870967741935484,0.826086956521739,0.516129032258065,0.608695652173913,0,"orthodox"
"308709",26,21,159,160,170,163,115,115,30,17,7,7,15,7,"win_A",5,-1,7,0,0,0,0,0,0.810810810810811,0.708333333333333,0.405405405405405,0.291666666666667,0,"orthodox"
"308710",26,24,159,163,170,168,114,114,29,18,7,4,15,15,"win_A",2,-4,2,0,0,0,0,0,0.805555555555556,0.818181818181818,0.416666666666667,0.681818181818182,0,"orthodox"
"308712",25,22,159,165,170,175,112,111,28,17,5,2,15,14,"win_A",3,-6,-5,1,0,0,0,0,0.848484848484849,0.894736842105263,0.454545454545455,0.736842105263158,0,"orthodox"
"308716",23,25,159,157,170,173,111,111,24,18,3,14,13,8,"win_A",-2,2,-3,0,0,0,0,0,0.888888888888889,0.5625,0.481481481481481,0.25,0,"orthodox"
"309030",36,24,173,176,175,191,140,139,47,15,5,2,11,9,"win_A",12,-3,-16,1,1,0,0,0,0.903846153846154,0.882352941176471,0.211538461538462,0.529411764705882,0,"orthodox"
"309119",29,48,173,175,178,185,150,148,8,105,0,17,7,65,"win_A",-19,-2,-7,2,0,1,0,0,1,0.860655737704918,0.875,0.532786885245902,0,"orthodox"
"309120",27,48,174,175,165,185,149,152,14,105,2,16,11,65,"win_A",-21,-1,-20,-3,0,1,0,0,0.875,0.867768595041322,0.6875,0.537190082644628,0,"orthodox"
"309121",48,27,175,185,185,193,153,153,104,30,16,11,65,10,"win_A",21,-10,-8,0,1,0,0,0,0.866666666666667,0.731707317073171,0.541666666666667,0.24390243902439,0,"orthodox"
"309130",29,38,173,175,180,185,147,147,21,97,6,14,13,62,"win_A",-9,-2,-5,0,0,1,0,0,0.777777777777778,0.873873873873874,0.481481481481481,0.558558558558559,0,"orthodox"
"309138",38,29,175,175,185,180,145,145,89,29,14,5,58,12,"win_A",9,0,5,0,1,0,0,0,0.864077669902913,0.852941176470588,0.563106796116505,0.352941176470588,0,"orthodox"
"309140",28,38,175,175,180,185,147,147,28,88,5,13,12,58,"win_A",-10,0,-5,0,0,1,0,0,0.848484848484849,0.871287128712871,0.363636363636364,0.574257425742574,0,"orthodox"
"309160",34,25,175,173,185,180,141,141,69,13,10,2,51,8,"win_A",9,2,5,0,0,0,0,0,0.873417721518987,0.866666666666667,0.645569620253165,0.533333333333333,0,"orthodox"
"309400",33,29,193,179,196,183,225,217,34,22,1,4,24,16,"win_A",4,14,13,8,0,0,0,0,0.971428571428571,0.846153846153846,0.685714285714286,0.615384615384615,0,"southpaw"
"309407",29,34,193,183,196,188,227,207,26,29,1,13,17,24,"win_A",-5,10,8,20,0,0,1,0,0.962962962962963,0.69047619047619,0.62962962962963,0.571428571428571,0,"southpaw"
"309415",27,27,193,181,196,199,226,242,18,30,0,10,11,25,"win_A",0,12,-3,-16,0,0,0,1,1,0.75,0.611111111111111,0.625,0,"southpaw"
"309416",27,33,193,188,196,196,230,200,17,9,0,6,10,5,"win_A",-6,5,0,30,0,0,1,0,1,0.6,0.588235294117647,0.333333333333333,0,"southpaw"
"310822",35,33,180,180,187,192,173,173,35,18,10,1,19,13,"win_A",2,0,-5,0,1,0,0,0,0.777777777777778,0.947368421052632,0.422222222222222,0.684210526315789,0,"Unknown"
"311122",28,22,182,185,196,187,174,176,4,10,1,0,1,7,"win_B",6,-3,9,-2,0,0,0,0,0.8,1,0.2,0.7,1,"orthodox"
"311342",40,37,185,193,196,216,232,204,9,29,21,9,4,21,"win_B",3,-8,-20,28,1,1,1,0,0.3,0.763157894736842,0.133333333333333,0.552631578947368,1,"orthodox"
"311347",29,34,196,193,208,216,231,250,17,26,2,7,12,20,"win_A",-5,3,-8,-19,0,0,0,1,0.894736842105263,0.787878787878788,0.631578947368421,0.606060606060606,0,"southpaw"
"311348",24,33,188,193,193,216,225,228,34,26,1,5,30,20,"win_A",-9,-5,-23,-3,0,0,0,0,0.971428571428571,0.838709677419355,0.857142857142857,0.645161290322581,0,"orthodox"
"311872",30,29,173,180,183,185,146,147,19,25,0,3,18,19,"win_A",1,-7,-2,-1,0,0,0,0,1,0.892857142857143,0.947368421052632,0.678571428571429,0,"southpaw"
"311874",27,28,180,182,185,185,145,146,21,21,3,1,17,16,"win_A",-1,-2,0,-1,0,0,0,0,0.875,0.954545454545455,0.708333333333333,0.727272727272727,0,"orthodox"
"311876",27,27,180,178,185,178,147,147,19,14,3,6,15,10,"win_A",0,2,7,0,0,0,0,0,0.863636363636364,0.7,0.681818181818182,0.5,0,"orthodox"
"313348",35,33,180,180,187,192,173,173,35,18,10,1,19,13,"win_A",2,0,-5,0,1,0,0,0,0.777777777777778,0.947368421052632,0.422222222222222,0.684210526315789,0,"Unknown"
"313648",28,22,182,185,196,187,174,176,4,10,1,0,1,7,"win_B",6,-3,9,-2,0,0,0,0,0.8,1,0.2,0.7,1,"orthodox"
"313868",40,37,185,193,196,216,232,204,9,29,21,9,4,21,"win_B",3,-8,-20,28,1,1,1,0,0.3,0.763157894736842,0.133333333333333,0.552631578947368,1,"orthodox"
"313873",29,34,196,193,208,216,231,250,17,26,2,7,12,20,"win_A",-5,3,-8,-19,0,0,0,1,0.894736842105263,0.787878787878788,0.631578947368421,0.606060606060606,0,"southpaw"
"313874",24,33,188,193,193,216,225,228,34,26,1,5,30,20,"win_A",-9,-5,-23,-3,0,0,0,0,0.971428571428571,0.838709677419355,0.857142857142857,0.645161290322581,0,"orthodox"
"314398",30,29,173,180,183,185,146,147,19,25,0,3,18,19,"win_A",1,-7,-2,-1,0,0,0,0,1,0.892857142857143,0.947368421052632,0.678571428571429,0,"southpaw"
"314400",27,28,180,182,185,185,145,146,21,21,3,1,17,16,"win_A",-1,-2,0,-1,0,0,0,0,0.875,0.954545454545455,0.708333333333333,0.727272727272727,0,"orthodox"
"314402",27,27,180,178,185,178,147,147,19,14,3,6,15,10,"win_A",0,2,7,0,0,0,0,0,0.863636363636364,0.7,0.681818181818182,0.5,0,"orthodox"
"315446",26,29,183,173,189,170,180,187,34,27,7,6,21,19,"win_A",-3,10,19,-7,0,0,0,0,0.829268292682927,0.818181818181818,0.51219512195122,0.575757575757576,0,"orthodox"
"316152",23,32,173,173,180,183,147,147,13,55,2,6,10,46,"win_A",-9,0,-3,0,0,0,0,0,0.866666666666667,0.901639344262295,0.666666666666667,0.754098360655738,0,"orthodox"
"316155",28,31,168,173,175,183,145,146,6,52,0,5,5,44,"win_A",-3,-5,-8,-1,0,0,0,0,1,0.912280701754386,0.833333333333333,0.771929824561403,0,"orthodox"
"316158",23,29,168,173,173,183,147,141,8,50,7,4,6,43,"win_A",-6,-5,-10,6,0,0,0,0,0.533333333333333,0.925925925925926,0.4,0.796296296296296,0,"orthodox"
"316161",25,29,173,183,183,188,143,143,46,8,3,1,40,6,"win_A",-4,-10,-5,0,0,0,0,0,0.938775510204082,0.888888888888889,0.816326530612245,0.666666666666667,0,"orthodox"
"316162",24,27,173,170,183,178,143,143,45,14,2,2,40,12,"win_B",-3,3,5,0,0,0,0,0,0.957446808510638,0.875,0.851063829787234,0.75,1,"orthodox"
"316163",23,23,173,175,183,173,142,142,44,30,2,5,39,19,"win_A",0,-2,10,0,0,0,0,0,0.956521739130435,0.857142857142857,0.847826086956522,0.542857142857143,0,"orthodox"
"316165",23,25,173,173,183,173,145,147,42,11,2,5,37,9,"win_A",-2,0,10,-2,0,0,0,0,0.954545454545455,0.6875,0.840909090909091,0.5625,0,"orthodox"
"316189",18,32,173,173,183,183,135,135,20,18,0,10,19,10,"win_A",-14,0,0,0,0,0,0,0,1,0.642857142857143,0.95,0.357142857142857,0,"orthodox"
"316264",26,32,165,168,165,175,126,126,29,35,1,2,10,22,"win_A",-6,-3,-10,0,0,0,0,0,0.966666666666667,0.945945945945946,0.333333333333333,0.594594594594595,0,"orthodox"
"317764",34,33,187,188,188,188,171,176,33,19,9,6,26,11,"win_A",1,-1,0,-5,0,0,0,0,0.785714285714286,0.76,0.619047619047619,0.44,0,"orthodox"
"317766",33,33,178,187,183,188,168,166,35,33,5,7,25,26,"win_A",0,-9,-5,2,0,0,0,0,0.875,0.825,0.625,0.65,0,"orthodox"
"317767",32,34,187,168,188,165,169,163,32,20,7,20,26,3,"win_A",-2,19,23,6,0,0,0,0,0.82051282051282,0.5,0.666666666666667,0.075,0,"orthodox"
"317770",31,34,187,175,188,180,173,175,30,26,5,3,25,14,"win_A",-3,12,8,-2,0,0,0,0,0.857142857142857,0.896551724137931,0.714285714285714,0.482758620689655,0,"orthodox"
"317874",25,33,180,180,183,185,212,231,14,21,10,5,9,16,"win_A",-8,0,-2,-19,0,0,0,1,0.583333333333333,0.807692307692308,0.375,0.615384615384615,0,"orthodox"
"317875",32,27,180,191,185,183,194,229,20,16,4,1,15,15,"win_A",5,-11,2,-35,0,0,0,1,0.833333333333333,0.941176470588235,0.625,0.882352941176471,0,"Unknown"
"317886",22,27,182,180,183,185,170,175,14,10,3,0,8,8,"win_B",-5,2,-2,-5,0,0,0,0,0.823529411764706,1,0.470588235294118,0.8,1,"orthodox"
"317905",28,28,178,185,178,183,159,160,42,28,4,4,37,18,"win_A",0,-7,-5,-1,0,0,0,0,0.91304347826087,0.875,0.804347826086957,0.5625,0,"orthodox"
"317906",27,38,178,175,178,180,161,161,41,26,4,9,36,17,"win_A",-11,3,-2,0,0,1,0,0,0.911111111111111,0.742857142857143,0.8,0.485714285714286,0,"orthodox"
"317911",25,26,168,178,178,178,160,160,16,36,4,4,13,31,"win_B",-1,-10,0,0,0,0,0,0,0.8,0.9,0.65,0.775,1,"orthodox"
"317913",21,26,182,178,179,178,154,153,14,34,0,3,12,30,"win_A",-5,4,1,1,0,0,0,0,1,0.918918918918919,0.857142857142857,0.810810810810811,0,"orthodox"
"317921",24,29,178,173,178,173,154,152,26,24,1,5,23,19,"win_A",-5,5,5,2,0,0,0,0,0.962962962962963,0.827586206896552,0.851851851851852,0.655172413793103,0,"orthodox"
"317931",22,22,178,178,178,196,153,153,15,11,1,1,12,11,"win_A",0,0,-18,0,0,0,0,0,0.9375,0.916666666666667,0.75,0.916666666666667,0,"orthodox"
"317939",20,20,178,178,196,178,157,156,8,6,0,0,8,5,"win_A",0,0,18,1,0,0,0,0,1,1,1,0.833333333333333,0,"orthodox"
"318177",24,20,165,165,165,165,124,126,28,16,12,2,10,8,"win_A",4,0,0,-2,0,0,0,0,0.7,0.888888888888889,0.25,0.444444444444444,0,"Unknown"
"318178",20,21,165,159,165,163,124,125,15,15,2,7,8,6,"win_A",-1,6,2,-1,0,0,0,0,0.882352941176471,0.681818181818182,0.470588235294118,0.272727272727273,0,"Unknown"
"318233",26,37,185,193,191,206,221,268,32,23,1,11,18,21,"win_A",-11,-8,-15,-47,0,1,0,1,0.96969696969697,0.676470588235294,0.545454545454545,0.617647058823529,0,"orthodox"
"318235",26,24,185,191,191,196,217,250,30,31,1,4,16,24,"win_A",2,-6,-5,-33,0,0,0,1,0.967741935483871,0.885714285714286,0.516129032258065,0.685714285714286,0,"orthodox"
"318236",25,32,185,188,191,196,213,241,29,31,0,1,16,23,"win_A",-7,-3,-5,-28,0,0,0,1,1,0.96875,0.551724137931034,0.71875,0,"orthodox"
"318237",25,32,185,191,191,198,214,222,28,28,0,4,16,19,"win_A",-7,-6,-7,-8,0,0,0,0,1,0.875,0.571428571428571,0.59375,0,"orthodox"
"318239",23,35,185,183,191,189,210,244,23,20,0,3,13,7,"win_A",-12,2,2,-34,0,1,0,1,1,0.869565217391304,0.565217391304348,0.304347826086957,0,"orthodox"
"318240",23,38,185,191,191,203,217,253,22,30,0,18,13,27,"win_A",-15,-6,-12,-36,0,1,0,1,1,0.625,0.590909090909091,0.5625,0,"orthodox"
"318242",22,36,185,180,191,203,224,212,20,13,0,28,12,6,"win_A",-14,5,-12,12,0,1,0,0,1,0.317073170731707,0.6,0.146341463414634,0,"orthodox"
"318245",22,31,185,188,191,198,211,261,17,29,0,24,10,25,"win_A",-9,-3,-7,-50,0,0,0,1,1,0.547169811320755,0.588235294117647,0.471698113207547,0,"orthodox"
"318381",35,28,178,180,183,203,165,165,39,20,6,3,27,15,"win_A",7,-2,-20,0,1,0,0,0,0.866666666666667,0.869565217391304,0.6,0.652173913043478,0,"orthodox"
"318384",32,28,178,183,183,183,167,165,34,17,5,10,25,7,"win_A",4,-5,0,2,0,0,0,0,0.871794871794872,0.62962962962963,0.641025641025641,0.259259259259259,0,"orthodox"
"318385",32,25,178,180,183,180,167,167,33,20,5,0,24,12,"win_A",7,-2,3,0,0,0,0,0,0.868421052631579,1,0.631578947368421,0.6,0,"orthodox"
"318386",31,26,178,188,183,208,167,168,32,25,5,1,23,19,"win_A",5,-10,-25,-1,0,0,0,0,0.864864864864865,0.961538461538462,0.621621621621622,0.730769230769231,0,"orthodox"
"318389",26,30,185,178,191,183,174,173,23,30,4,3,17,21,"win_A",-4,7,8,1,0,0,0,0,0.851851851851852,0.909090909090909,0.62962962962963,0.636363636363636,0,"Unknown"
"318390",29,24,178,188,183,208,166,165,29,19,3,0,21,14,"win_A",5,-10,-25,1,0,0,0,0,0.90625,1,0.65625,0.736842105263158,0,"orthodox"
"318576",32,23,163,175,168,175,130,130,36,27,7,11,25,18,"win_A",9,-12,-7,0,0,0,0,0,0.837209302325581,0.710526315789474,0.581395348837209,0.473684210526316,0,"orthodox"
"318579",29,34,163,163,168,173,139,129,33,9,7,27,23,1,"win_A",-5,0,-5,10,0,0,0,0,0.825,0.25,0.575,0.0277777777777778,0,"orthodox"
"318583",28,29,163,163,168,175,123,121,29,16,6,2,20,8,"win_A",-1,0,-7,2,0,0,0,0,0.828571428571429,0.888888888888889,0.571428571428571,0.444444444444444,0,"orthodox"
"318584",28,30,163,163,168,168,121,118,28,28,6,8,19,25,"win_A",-2,0,0,3,0,0,0,0,0.823529411764706,0.777777777777778,0.558823529411765,0.694444444444444,0,"orthodox"
"318585",27,36,163,180,168,185,126,126,27,36,6,11,18,28,"win_A",-9,-17,-17,0,0,1,0,0,0.818181818181818,0.765957446808511,0.545454545454545,0.595744680851064,0,"orthodox"
"318586",27,26,163,165,168,173,126,126,26,13,6,3,18,2,"win_A",1,-2,-5,0,0,0,0,0,0.8125,0.8125,0.5625,0.125,0,"orthodox"
"318587",26,31,163,168,168,173,124,126,25,23,5,5,17,13,"win_A",-5,-5,-5,-2,0,0,0,0,0.833333333333333,0.821428571428571,0.566666666666667,0.464285714285714,0,"orthodox"
"318589",25,33,163,170,168,170,123,121,21,11,5,4,13,5,"win_A",-8,-7,-2,2,0,0,0,0,0.807692307692308,0.733333333333333,0.5,0.333333333333333,0,"orthodox"
"318590",24,22,163,170,168,173,120,122,20,26,5,3,12,24,"win_A",2,-7,-5,-2,0,0,0,0,0.8,0.896551724137931,0.48,0.827586206896552,0,"orthodox"
"318601",19,18,163,160,168,163,115,116,9,11,2,2,6,4,"win_A",1,3,5,-1,0,0,0,0,0.818181818181818,0.846153846153846,0.545454545454545,0.307692307692308,0,"orthodox"
"319789",24,32,189,174,188,185,217,207,32,55,16,14,17,39,"win_A",-8,15,3,10,0,0,0,0,0.666666666666667,0.797101449275362,0.354166666666667,0.565217391304348,0,"orthodox"
"319813",22,26,174,180,185,183,205,197,31,60,5,14,23,17,"win_A",-4,-6,2,8,0,0,0,0,0.861111111111111,0.810810810810811,0.638888888888889,0.22972972972973,0,"orthodox"
"319822",20,30,174,177,185,180,172,171,20,129,2,36,13,83,"win_A",-10,-3,5,1,0,0,0,0,0.909090909090909,0.781818181818182,0.590909090909091,0.503030303030303,0,"orthodox"
"319830",19,29,174,168,185,168,159,158,12,84,1,53,7,40,"win_A",-10,6,17,1,0,0,0,0,0.923076923076923,0.613138686131387,0.538461538461538,0.291970802919708,0,"orthodox"
"320515",22,36,188,180,193,185,186,202,7,108,2,54,7,36,"win_A",-14,8,8,-16,0,1,0,1,0.777777777777778,0.666666666666667,0.777777777777778,0.222222222222222,0,"Unknown"
"320519",26,36,180,180,193,185,186,203,13,107,2,51,5,36,"win_A",-10,0,8,-17,0,1,0,1,0.866666666666667,0.677215189873418,0.333333333333333,0.227848101265823,0,"orthodox"
"320521",25,36,187,180,188,185,185,187,31,106,9,50,23,36,"win_A",-11,7,3,-2,0,1,0,0,0.775,0.67948717948718,0.575,0.230769230769231,0,"orthodox"
"320530",30,34,183,180,191,185,188,195,33,100,7,47,26,35,"win_A",-4,3,6,-7,0,0,0,0,0.825,0.680272108843537,0.65,0.238095238095238,0,"Unknown"
"320567",18,31,178,180,185,185,182,175,33,75,8,30,10,26,"win_A",-13,-2,0,7,0,0,0,0,0.804878048780488,0.714285714285714,0.24390243902439,0.247619047619048,0,"Unknown"
"320590",28,23,180,183,185,193,175,177,47,64,14,17,17,20,"win_A",5,-3,-8,-2,0,0,0,0,0.770491803278688,0.790123456790123,0.278688524590164,0.246913580246914,0,"orthodox"
"320619",25,23,180,185,185,206,177,183,14,16,6,10,3,12,"win_A",2,-5,-21,-6,0,0,0,0,0.7,0.615384615384615,0.15,0.461538461538462,0,"orthodox"
"321240",25,31,170,180,175,191,142,141,23,45,3,7,14,29,"win_A",-6,-10,-16,1,0,0,0,0,0.884615384615385,0.865384615384615,0.538461538461538,0.557692307692308,0,"orthodox"
"321241",31,21,180,173,191,178,142,141,44,22,7,20,29,5,"win_A",10,7,13,1,0,0,0,0,0.862745098039216,0.523809523809524,0.568627450980392,0.119047619047619,0,"orthodox"
"321242",28,30,180,180,185,191,138,138,35,44,8,6,32,29,"win_A",-2,0,-6,0,0,0,0,0,0.813953488372093,0.88,0.744186046511628,0.58,0,"orthodox"
"321244",29,30,180,175,191,183,142,141,42,19,6,7,29,15,"win_A",-1,5,8,1,0,0,0,0,0.875,0.730769230769231,0.604166666666667,0.576923076923077,0,"orthodox"
"321249",25,27,180,165,191,173,137,137,37,29,3,22,25,21,"win_A",-2,15,18,0,0,0,0,0,0.925,0.568627450980392,0.625,0.411764705882353,0,"orthodox"
"321653",37,31,191,185,206,196,228,236,39,21,3,22,23,15,"win_A",6,6,10,-8,1,0,0,0,0.928571428571429,0.488372093023256,0.547619047619048,0.348837209302326,0,"orthodox"
"321654",35,29,191,188,206,196,240,228,38,17,2,5,23,8,"win_A",6,3,10,12,1,0,0,0,0.95,0.772727272727273,0.575,0.363636363636364,0,"orthodox"
"321656",33,36,191,185,206,201,248,217,37,42,1,9,22,38,"win_A",-3,6,5,31,0,1,1,0,0.973684210526316,0.823529411764706,0.578947368421053,0.745098039215686,0,"orthodox"
"321659",32,42,191,185,206,196,250,213,34,11,1,30,20,4,"win_A",-10,6,10,37,0,1,1,0,0.971428571428571,0.268292682926829,0.571428571428571,0.0975609756097561,0,"orthodox"
"321663",31,37,191,183,206,191,234,240,30,21,1,15,20,12,"win_A",-6,8,15,-6,0,1,0,0,0.967741935483871,0.583333333333333,0.645161290322581,0.333333333333333,0,"orthodox"
"321664",30,28,191,191,206,198,234,226,28,14,1,4,19,14,"win_A",2,0,8,8,0,0,0,0,0.96551724137931,0.777777777777778,0.655172413793103,0.777777777777778,0,"orthodox"
"321665",30,36,191,196,206,203,234,244,27,29,1,9,18,19,"win_A",-6,-5,3,-10,0,1,0,0,0.964285714285714,0.763157894736842,0.642857142857143,0.5,0,"orthodox"
"321667",30,34,191,195,206,203,232,243,25,38,1,13,16,27,"win_A",-4,-4,3,-11,0,0,0,0,0.961538461538462,0.745098039215686,0.615384615384615,0.529411764705882,0,"orthodox"
"321668",30,28,191,185,206,191,231,232,24,16,1,5,15,12,"win_A",2,6,15,-1,0,0,0,0,0.96,0.761904761904762,0.6,0.571428571428571,0,"orthodox"
"321669",30,24,191,191,206,185,232,222,23,23,1,0,15,11,"win_A",6,0,21,10,0,0,0,0,0.958333333333333,1,0.625,0.478260869565217,0,"orthodox"
"321670",30,31,191,188,206,188,249,236,22,14,1,10,15,10,"win_A",-1,3,18,13,0,0,0,0,0.956521739130435,0.583333333333333,0.652173913043478,0.416666666666667,0,"orthodox"
"321673",29,29,191,198,206,201,239,237,19,17,1,7,14,15,"win_A",0,-7,5,2,0,0,0,0,0.95,0.708333333333333,0.7,0.625,0,"orthodox"
"321674",29,26,191,179,206,183,235,217,18,19,1,1,13,13,"win_A",3,12,23,18,0,0,1,0,0.947368421052632,0.95,0.684210526315789,0.65,0,"orthodox"
"321675",29,29,191,188,206,188,228,230,17,15,1,6,13,7,"win_A",0,3,18,-2,0,0,0,0,0.944444444444444,0.714285714285714,0.722222222222222,0.333333333333333,0,"orthodox"
"321676",28,30,191,188,206,193,235,245,16,7,1,3,12,5,"win_A",-2,3,13,-10,0,0,0,0,0.941176470588235,0.7,0.705882352941177,0.5,0,"orthodox"
"321679",27,28,191,181,206,199,233,233,13,31,0,12,10,26,"win_A",-1,10,7,0,0,0,0,0,1,0.720930232558139,0.769230769230769,0.604651162790698,0,"orthodox"
"321680",27,21,191,185,206,191,227,210,12,15,0,0,10,12,"win_A",6,6,15,17,0,0,1,0,1,1,0.833333333333333,0.8,0,"orthodox"
"321688",26,26,191,188,206,188,226,223,4,5,0,0,3,1,"win_A",0,3,18,3,0,0,0,0,1,1,0.75,0.2,0,"orthodox"
"322097",23,28,168,165,168,175,132,132,15,34,0,15,8,23,"win_A",-5,3,-7,0,0,0,0,0,1,0.693877551020408,0.533333333333333,0.469387755102041,0,"orthodox"
"322098",24,28,183,165,182,175,134,132,21,34,3,14,13,23,"win_A",-4,18,7,2,0,0,0,0,0.875,0.708333333333333,0.541666666666667,0.479166666666667,0,"Unknown"
"322151",29,31,180,175,185,183,153,154,23,27,0,7,16,21,"win_A",-2,5,2,-1,0,0,0,0,1,0.794117647058823,0.695652173913043,0.617647058823529,0,"orthodox"
"322687",27,30,160,173,173,174,136,136,17,30,0,4,13,22,"win_A",-3,-13,-1,0,0,0,0,0,1,0.882352941176471,0.764705882352941,0.647058823529412,0,"orthodox"
"322899",28,38,191,198,193,208,271,255,26,39,0,9,23,23,"win_A",-10,-7,-15,16,0,1,1,0,1,0.8125,0.884615384615385,0.479166666666667,0,"orthodox"
"322901",36,37,188,198,198,208,268,233,42,38,7,8,29,23,"win_A",-1,-10,-10,35,1,1,1,0,0.857142857142857,0.826086956521739,0.591836734693878,0.5,0,"orthodox"
"322903",36,33,198,188,208,198,269,269,36,30,6,29,22,25,"win_A",3,10,10,0,1,0,0,0,0.857142857142857,0.508474576271186,0.523809523809524,0.423728813559322,0,"orthodox"
"322904",35,36,198,188,208,198,264,215,35,56,6,7,22,44,"win_A",-1,10,10,49,1,1,1,0,0.853658536585366,0.888888888888889,0.536585365853659,0.698412698412698,0,"orthodox"
"322905",35,34,198,191,208,201,269,235,34,15,6,9,22,8,"win_A",1,7,7,34,1,0,1,0,0.85,0.625,0.55,0.333333333333333,0,"orthodox"
"322906",35,42,198,177,208,188,275,226,33,29,6,17,21,15,"win_A",-7,21,20,49,1,1,1,0,0.846153846153846,0.630434782608696,0.538461538461538,0.326086956521739,0,"orthodox"
"322909",35,38,198,193,208,193,277,223,31,34,5,8,19,28,"win_A",-3,5,15,54,1,1,1,0,0.861111111111111,0.80952380952381,0.527777777777778,0.666666666666667,0,"orthodox"
"322910",30,34,188,198,196,208,265,218,24,31,0,4,20,19,"win_A",-4,-10,-12,47,0,0,1,0,1,0.885714285714286,0.833333333333333,0.542857142857143,0,"orthodox"
"322912",33,34,198,191,208,206,269,228,29,21,3,0,17,16,"win_A",-1,7,2,41,0,0,1,0,0.90625,1,0.53125,0.761904761904762,0,"orthodox"
"322913",32,30,198,191,208,203,277,246,28,19,3,3,16,9,"win_A",2,7,5,31,0,0,1,0,0.903225806451613,0.863636363636364,0.516129032258065,0.409090909090909,0,"orthodox"
"322915",30,30,198,196,208,211,256,224,23,19,2,2,14,13,"win_A",0,2,-3,32,0,0,1,0,0.92,0.904761904761905,0.56,0.619047619047619,0,"orthodox"
"322917",30,27,198,185,208,196,263,226,21,10,2,9,14,8,"win_A",3,13,12,37,0,0,1,0,0.91304347826087,0.526315789473684,0.608695652173913,0.421052631578947,0,"orthodox"
"322919",29,33,198,185,208,185,259,215,19,12,2,9,13,4,"win_A",-4,13,23,44,0,0,1,0,0.904761904761905,0.571428571428571,0.619047619047619,0.19047619047619,0,"orthodox"
"322924",28,37,198,185,208,193,258,215,14,12,2,15,11,8,"win_A",-9,13,15,43,0,1,1,0,0.875,0.444444444444444,0.6875,0.296296296296296,0,"orthodox"
"323586",30,34,188,193,193,201,217,246,15,19,0,9,13,0,"win_A",-4,-5,-8,-29,0,0,0,1,1,0.678571428571429,0.866666666666667,0,0,"southpaw"
"323589",29,29,188,185,193,189,220,233,11,15,0,24,9,11,"win_A",0,3,4,-13,0,0,0,0,1,0.384615384615385,0.818181818181818,0.282051282051282,0,"southpaw"
"323597",27,33,188,189,193,198,215,220,3,5,0,9,3,3,"win_A",-6,-1,-5,-5,0,0,0,0,1,0.357142857142857,1,0.214285714285714,0,"southpaw"
"323655",31,32,188,191,194,193,242,242,26,34,1,3,19,30,"win_B",-1,-3,1,0,0,0,0,0,0.962962962962963,0.918918918918919,0.703703703703704,0.810810810810811,1,"orthodox"
"323659",28,34,191,180,193,183,263,218,27,34,1,2,24,21,"win_A",-6,11,10,45,0,0,1,0,0.964285714285714,0.944444444444444,0.857142857142857,0.583333333333333,0,"orthodox"
"323660",27,29,191,194,193,208,254,231,25,28,0,1,22,22,"win_A",-2,-3,-15,23,0,0,1,0,1,0.96551724137931,0.88,0.758620689655172,0,"orthodox"
"323663",26,36,191,180,193,185,244,234,22,26,0,14,20,14,"win_A",-10,11,8,10,0,1,0,0,1,0.65,0.909090909090909,0.35,0,"orthodox"
"323664",26,26,191,180,193,183,245,221,21,26,0,1,19,18,"win_A",0,11,10,24,0,0,1,0,1,0.962962962962963,0.904761904761905,0.666666666666667,0,"orthodox"
"323667",25,26,191,191,193,193,229,256,17,21,0,0,15,15,"win_A",-1,0,0,-27,0,0,0,1,1,1,0.882352941176471,0.714285714285714,0,"orthodox"
"323669",25,33,191,185,193,196,247,236,15,21,0,27,13,15,"win_A",-8,6,-3,11,0,0,0,0,1,0.4375,0.866666666666667,0.3125,0,"orthodox"
"323672",24,28,191,185,193,191,245,275,10,8,0,1,9,5,"win_A",-4,6,2,-30,0,0,0,1,1,0.888888888888889,0.9,0.555555555555556,0,"orthodox"
"324177",28,37,183,183,175,185,162,164,24,17,1,7,9,10,"win_A",-9,0,-10,-2,0,1,0,0,0.96,0.708333333333333,0.36,0.416666666666667,0,"orthodox"
"324178",32,36,191,183,193,185,175,179,19,17,1,6,14,10,"win_A",-4,8,8,-4,0,1,0,0,0.95,0.739130434782609,0.7,0.434782608695652,0,"orthodox"
"324182",25,32,188,183,198,185,166,169,19,15,11,3,11,8,"win_A",-7,5,13,-3,0,0,0,0,0.633333333333333,0.833333333333333,0.366666666666667,0.444444444444444,0,"southpaw"
"324184",34,30,173,183,173,185,161,161,17,13,1,1,16,7,"win_A",4,-10,-12,0,0,0,0,0,0.944444444444444,0.928571428571429,0.888888888888889,0.5,0,"orthodox"
"324189",29,29,175,183,180,185,154,152,16,9,1,0,12,5,"win_A",0,-8,-5,2,0,0,0,0,0.941176470588235,1,0.705882352941177,0.555555555555556,0,"orthodox"
"324410",25,26,183,173,188,185,147,147,28,37,1,3,20,22,"win_A",-1,10,3,0,0,0,0,0,0.96551724137931,0.925,0.689655172413793,0.55,0,"southpaw"
"325279",38,32,201,188,218,196,246,227,38,47,1,5,24,36,"win_A",6,13,22,19,1,0,1,0,0.974358974358974,0.903846153846154,0.615384615384615,0.692307692307692,0,"orthodox"
"325280",38,29,201,187,218,203,248,224,37,16,1,6,23,14,"win_A",9,14,15,24,1,0,1,0,0.973684210526316,0.727272727272727,0.605263157894737,0.636363636363636,0,"orthodox"
"325281",37,33,201,191,218,191,242,278,36,12,1,1,22,11,"win_A",4,10,27,-36,1,0,0,1,0.972972972972973,0.923076923076923,0.594594594594595,0.846153846153846,0,"orthodox"
"325282",37,38,201,198,218,191,238,216,35,5,1,4,21,3,"win_A",-1,3,27,22,1,1,1,0,0.972222222222222,0.555555555555556,0.583333333333333,0.333333333333333,0,"orthodox"
"325286",34,32,201,196,218,208,238,235,30,24,0,2,18,16,"win_A",2,5,10,3,0,0,0,0,1,0.923076923076923,0.6,0.615384615384615,0,"orthodox"
"325292",29,31,185,201,188,218,238,217,23,23,1,0,13,13,"win_B",-2,-16,-30,21,0,0,1,0,0.958333333333333,1,0.541666666666667,0.565217391304348,1,"orthodox"
"325295",30,24,201,191,218,193,224,211,19,15,0,0,12,8,"win_A",6,10,25,13,0,0,0,0,1,1,0.631578947368421,0.533333333333333,0,"orthodox"
"325296",30,27,201,188,218,196,224,222,18,14,0,3,12,12,"win_A",3,13,22,2,0,0,0,0,1,0.823529411764706,0.666666666666667,0.705882352941177,0,"orthodox"
"325301",29,35,201,180,218,193,220,208,13,31,0,12,9,18,"win_A",-6,21,25,12,0,1,0,0,1,0.720930232558139,0.692307692307692,0.418604651162791,0,"orthodox"
"325948",29,31,153,164,158,169,108,108,20,25,7,6,12,19,"win_A",-2,-11,-11,0,0,0,0,0,0.740740740740741,0.806451612903226,0.444444444444444,0.612903225806452,0,"orthodox"
"326244",26,26,184,183,198,196,168,172,42,6,6,3,21,3,"win_A",0,1,2,-4,0,0,0,0,0.875,0.666666666666667,0.4375,0.333333333333333,0,"Unknown"
"326692",25,30,176,168,179,170,118,118,28,31,1,7,25,22,"win_A",-5,8,9,0,0,0,0,0,0.96551724137931,0.815789473684211,0.862068965517241,0.578947368421053,0,"orthodox"
"326693",24,29,176,168,179,170,118,118,27,31,1,6,25,22,"win_A",-5,8,9,0,0,0,0,0,0.964285714285714,0.837837837837838,0.892857142857143,0.594594594594595,0,"orthodox"
"326785",20,28,173,170,173,178,131,131,14,15,0,23,9,5,"win_A",-8,3,-5,0,0,0,0,0,1,0.394736842105263,0.642857142857143,0.131578947368421,0,"orthodox"
"327687",24,25,193,183,193,193,178,190,19,78,2,30,15,22,"win_A",-1,10,0,-12,0,0,0,0,0.904761904761905,0.722222222222222,0.714285714285714,0.203703703703704,0,"orthodox"
"327688",25,20,183,185,193,193,179,189,76,18,27,2,21,15,"win_A",5,-2,0,-10,0,0,0,0,0.737864077669903,0.9,0.203883495145631,0.75,0,"Unknown"
"327720",21,23,183,180,193,189,177,175,49,46,8,12,15,11,"win_A",-2,3,4,2,0,0,0,0,0.859649122807018,0.793103448275862,0.263157894736842,0.189655172413793,0,"Unknown"
"328338",21,27,165,165,157,163,127,126,22,19,1,5,19,15,"win_A",-6,0,-6,1,0,0,0,0,0.956521739130435,0.791666666666667,0.826086956521739,0.625,0,"orthodox"
"328364",32,35,185,191,198,203,169,168,37,24,9,2,26,20,"win_A",-3,-6,-5,1,0,1,0,0,0.804347826086957,0.923076923076923,0.565217391304348,0.769230769230769,0,"orthodox"
"328365",31,28,185,180,198,203,168,165,36,21,8,4,26,16,"win_A",3,5,-5,3,0,0,0,0,0.818181818181818,0.84,0.590909090909091,0.64,0,"orthodox"
"328366",31,29,185,180,198,185,167,165,36,24,7,4,26,23,"win_B",2,5,13,2,0,0,0,0,0.837209302325581,0.857142857142857,0.604651162790698,0.821428571428571,1,"orthodox"
"328374",27,26,185,185,198,206,168,168,27,13,5,1,19,5,"win_A",1,0,-8,0,0,0,0,0,0.84375,0.928571428571429,0.59375,0.357142857142857,0,"orthodox"
"328375",26,37,185,185,198,186,170,170,26,12,5,10,19,9,"win_A",-11,0,12,0,0,1,0,0,0.838709677419355,0.545454545454545,0.612903225806452,0.409090909090909,0,"orthodox"
"328379",26,25,178,185,189,198,167,166,18,23,0,4,11,17,"win_A",1,-7,-9,1,0,0,0,0,1,0.851851851851852,0.611111111111111,0.62962962962963,0,"orthodox"
"328401",20,22,185,170,198,173,157,159,5,3,0,2,3,1,"win_A",-2,15,25,-2,0,0,0,0,1,0.6,0.6,0.2,0,"orthodox"
"328612",23,25,177,170,173,175,137,138,27,2,2,19,19,1,"win_A",-2,7,-2,-1,0,0,0,0,0.931034482758621,0.0952380952380952,0.655172413793103,0.0476190476190476,0,"orthodox"
"328617",21,19,177,168,173,173,138,138,22,14,2,3,17,9,"win_A",2,9,0,0,0,0,0,0,0.916666666666667,0.823529411764706,0.708333333333333,0.529411764705882,0,"orthodox"
"328733",22,24,187,189,203,185,198,205,21,32,3,14,10,14,"win_A",-2,-2,18,-7,0,0,0,0,0.875,0.695652173913043,0.416666666666667,0.304347826086957,0,"Unknown"
"328772",24,19,171,171,178,165,136,136,24,11,6,1,10,4,"win_A",5,0,13,0,0,0,0,0,0.8,0.916666666666667,0.333333333333333,0.333333333333333,0,"orthodox"
"328801",34,32,180,173,175,178,147,147,29,50,3,8,22,27,"win_A",2,7,-3,0,0,0,0,0,0.90625,0.862068965517241,0.6875,0.46551724137931,0,"orthodox"
"328802",33,26,180,177,175,175,147,146,28,15,3,1,21,10,"win_A",7,3,0,1,0,0,0,0,0.903225806451613,0.9375,0.67741935483871,0.625,0,"orthodox"
"328803",33,22,180,180,175,178,148,149,28,14,2,1,21,9,"win_B",11,0,-3,-1,0,0,0,0,0.933333333333333,0.933333333333333,0.7,0.6,1,"orthodox"
"328804",31,24,180,175,175,173,144,146,27,32,1,7,21,20,"win_A",7,5,2,-2,0,0,0,0,0.964285714285714,0.82051282051282,0.75,0.512820512820513,0,"orthodox"
"328808",28,30,180,168,175,178,139,140,23,16,0,21,19,12,"win_A",-2,12,-3,-1,0,0,0,0,1,0.432432432432432,0.826086956521739,0.324324324324324,0,"orthodox"
"328813",27,22,180,178,175,180,140,140,18,39,0,2,14,24,"win_A",5,2,-5,0,0,0,0,0,1,0.951219512195122,0.777777777777778,0.585365853658537,0,"orthodox"
"329049",34,31,179,170,185,175,140,140,20,22,3,5,18,13,"win_B",3,9,10,0,0,0,0,0,0.869565217391304,0.814814814814815,0.782608695652174,0.481481481481481,1,"orthodox"
"329051",33,26,179,175,185,168,139,139,18,20,1,6,16,14,"win_B",7,4,17,0,0,0,0,0,0.947368421052632,0.769230769230769,0.842105263157895,0.538461538461538,1,"orthodox"
"329552",28,29,174,168,180,160,108,108,13,29,1,5,8,14,"win_A",-1,6,20,0,0,0,0,0,0.928571428571429,0.852941176470588,0.571428571428571,0.411764705882353,0,"southpaw"
"329568",22,31,168,157,160,168,108,108,11,23,2,20,5,13,"win_A",-9,11,-8,0,0,0,0,0,0.846153846153846,0.534883720930233,0.384615384615385,0.302325581395349,0,"orthodox"
"329577",19,19,170,168,175,160,111,113,4,1,1,1,1,0,"win_A",0,2,15,-2,0,0,0,0,0.8,0.5,0.2,0,0,"orthodox"
"329751",30,36,170,180,178,185,161,161,18,31,1,8,12,27,"win_A",-6,-10,-7,0,0,1,0,0,0.947368421052632,0.794871794871795,0.631578947368421,0.692307692307692,0,"orthodox"
"329752",32,33,193,180,201,185,160,159,22,31,1,5,12,27,"win_A",-1,13,16,1,0,0,0,0,0.956521739130435,0.861111111111111,0.521739130434783,0.75,0,"orthodox"
"329754",32,30,180,175,185,175,161,165,29,26,5,8,26,17,"win_A",2,5,10,-4,0,0,0,0,0.852941176470588,0.764705882352941,0.764705882352941,0.5,0,"orthodox"
"329758",30,29,180,191,185,193,163,163,25,16,4,0,24,12,"win_A",1,-11,-8,0,0,0,0,0,0.862068965517241,1,0.827586206896552,0.75,0,"orthodox"
"329762",26,27,180,185,185,188,160,159,20,16,2,1,20,9,"win_A",-1,-5,-3,1,0,0,0,0,0.909090909090909,0.941176470588235,0.909090909090909,0.529411764705882,0,"orthodox"
"329763",26,31,180,165,185,175,159,153,19,17,2,12,19,4,"win_A",-5,15,10,6,0,0,0,0,0.904761904761905,0.586206896551724,0.904761904761905,0.137931034482759,0,"orthodox"
"329764",26,24,180,173,185,178,160,159,18,23,2,3,18,16,"win_A",2,7,7,1,0,0,0,0,0.9,0.884615384615385,0.9,0.615384615384615,0,"orthodox"
"329816",30,29,171,165,176,175,138,140,29,34,2,12,12,22,"win_A",1,6,1,-2,0,0,0,0,0.935483870967742,0.739130434782609,0.387096774193548,0.478260869565217,0,"orthodox"
"329819",29,28,171,180,176,185,140,140,25,30,2,5,10,13,"win_A",1,-9,-9,0,0,0,0,0,0.925925925925926,0.857142857142857,0.37037037037037,0.371428571428571,0,"orthodox"
"329823",28,30,171,170,176,173,140,139,21,18,2,5,7,16,"win_A",-2,1,3,1,0,0,0,0,0.91304347826087,0.782608695652174,0.304347826086957,0.695652173913043,0,"orthodox"
"329829",26,28,171,170,176,178,141,140,15,15,0,1,6,10,"win_A",-2,1,-2,1,0,0,0,0,1,0.9375,0.4,0.625,0,"orthodox"
"329832",25,27,171,177,176,170,145,147,12,16,0,1,4,3,"win_A",-2,-6,6,-2,0,0,0,0,1,0.941176470588235,0.333333333333333,0.176470588235294,0,"orthodox"
"329838",24,23,171,175,176,191,140,140,6,10,0,0,2,9,"win_A",1,-4,-15,0,0,0,0,0,1,1,0.333333333333333,0.9,0,"orthodox"
"330063",35,33,191,188,196,193,252,230,59,50,1,4,42,41,"win_A",2,3,3,22,1,0,1,0,0.983333333333333,0.925925925925926,0.7,0.759259259259259,0,"orthodox"
"330072",34,23,191,183,196,193,252,207,50,16,1,1,34,10,"win_A",11,8,3,45,0,0,1,0,0.980392156862745,0.941176470588235,0.666666666666667,0.588235294117647,0,"orthodox"
"330074",34,32,191,188,196,193,244,229,49,47,0,4,33,38,"win_B",2,3,3,15,0,0,1,0,1,0.92156862745098,0.673469387755102,0.745098039215686,1,"orthodox"
"330087",32,26,191,185,196,188,254,219,35,17,0,10,20,15,"win_A",6,6,8,35,0,0,1,0,1,0.62962962962963,0.571428571428571,0.555555555555556,0,"orthodox"
"330090",31,24,191,188,196,198,258,250,30,15,0,2,18,15,"win_A",7,3,-2,8,0,0,0,0,1,0.882352941176471,0.6,0.882352941176471,0,"orthodox"
"330095",30,31,191,185,196,201,247,231,25,34,0,3,13,31,"win_A",-1,6,-5,16,0,0,1,0,1,0.918918918918919,0.52,0.837837837837838,0,"orthodox"
"330108",28,27,191,191,196,203,266,250,8,6,0,6,1,6,"win_A",1,0,-7,16,0,0,1,0,1,0.5,0.125,0.5,0,"orthodox"
"330770",29,37,185,183,188,185,199,224,21,22,1,17,11,16,"win_A",-8,2,3,-25,0,1,0,1,0.954545454545455,0.564102564102564,0.5,0.41025641025641,0,"orthodox"
"330772",36,24,183,177,185,179,196,192,22,19,14,0,16,13,"win_B",12,6,6,4,1,0,0,0,0.611111111111111,1,0.444444444444444,0.684210526315789,1,"orthodox"
"330773",35,35,183,188,185,201,209,225,22,9,13,3,16,5,"win_B",0,-5,-16,-16,1,1,0,1,0.628571428571429,0.75,0.457142857142857,0.416666666666667,1,"orthodox"
"330776",35,27,183,196,185,208,214,230,22,9,10,0,16,7,"win_B",8,-13,-23,-16,1,0,0,1,0.6875,1,0.5,0.777777777777778,1,"orthodox"
"330777",34,34,180,183,193,185,194,190,31,21,8,8,18,15,"win_B",0,-3,8,4,0,0,0,0,0.794871794871795,0.724137931034483,0.461538461538462,0.517241379310345,1,"Unknown"
"332463",29,40,169,161,175,170,130,130,14,43,0,14,7,21,"win_A",-11,8,5,0,0,1,0,0,1,0.754385964912281,0.5,0.368421052631579,0,"Unknown"
"332465",39,26,161,170,170,183,130,131,42,18,11,4,20,14,"win_A",13,-9,-13,-1,1,0,0,0,0.792452830188679,0.818181818181818,0.377358490566038,0.636363636363636,0,"southpaw"
"332469",23,37,171,161,170,170,130,130,29,39,0,9,23,20,"win_A",-14,10,0,0,0,1,0,0,1,0.8125,0.793103448275862,0.416666666666667,0,"orthodox"
"332473",28,36,163,161,157,170,130,130,15,35,2,9,8,17,"win_B",-8,2,-13,0,0,1,0,0,0.882352941176471,0.795454545454545,0.470588235294118,0.386363636363636,1,"orthodox"
"332475",35,24,161,168,170,173,127,127,33,45,8,10,15,26,"win_A",11,-7,-3,0,1,0,0,0,0.804878048780488,0.818181818181818,0.365853658536585,0.472727272727273,0,"southpaw"
"332490",31,27,161,170,170,173,133,135,18,7,5,2,8,3,"win_A",4,-9,-3,-2,0,0,0,0,0.782608695652174,0.777777777777778,0.347826086956522,0.333333333333333,0,"southpaw"
"332512",32,29,188,193,206,208,246,232,35,12,2,2,26,8,"win_A",3,-5,-2,14,0,0,0,0,0.945945945945946,0.857142857142857,0.702702702702703,0.571428571428571,0,"orthodox"
"332513",32,38,188,180,206,198,242,232,34,18,2,7,25,7,"win_A",-6,8,8,10,0,1,0,0,0.944444444444444,0.72,0.694444444444444,0.28,0,"orthodox"
"332514",30,37,188,195,206,203,243,247,33,43,1,4,24,35,"win_A",-7,-7,3,-4,0,1,0,0,0.970588235294118,0.914893617021277,0.705882352941177,0.74468085106383,0,"orthodox"
"332515",30,30,188,188,198,206,238,233,37,32,4,0,27,23,"win_A",0,0,-8,5,0,0,0,0,0.902439024390244,1,0.658536585365854,0.71875,0,"orthodox"
"332516",28,29,188,183,206,193,240,222,30,19,0,8,22,7,"win_A",-1,5,13,18,0,0,1,0,1,0.703703703703704,0.733333333333333,0.259259259259259,0,"orthodox"
"332519",26,38,188,183,206,191,226,234,25,21,0,18,19,12,"win_A",-12,5,15,-8,0,1,0,0,1,0.538461538461538,0.76,0.307692307692308,0,"orthodox"
"332520",25,32,188,188,206,178,228,236,24,22,0,4,18,13,"win_A",-7,0,28,-8,0,0,0,0,1,0.846153846153846,0.75,0.5,0,"orthodox"
"332521",25,33,188,191,206,208,226,236,23,19,0,10,17,18,"win_A",-8,-3,-2,-10,0,0,0,0,1,0.655172413793103,0.739130434782609,0.620689655172414,0,"orthodox"
"332522",25,29,188,180,206,203,228,226,22,7,0,8,16,4,"win_A",-4,8,3,2,0,0,0,0,1,0.466666666666667,0.727272727272727,0.266666666666667,0,"orthodox"
"332523",24,31,188,188,206,191,225,217,21,13,0,7,15,9,"win_A",-7,0,15,8,0,0,0,0,1,0.65,0.714285714285714,0.45,0,"orthodox"
"332524",24,30,188,185,206,196,224,202,20,13,0,0,14,8,"win_A",-6,3,10,22,0,0,1,0,1,1,0.7,0.615384615384615,0,"orthodox"
"332533",22,38,188,185,206,196,222,207,11,7,0,12,9,3,"win_A",-16,3,10,15,0,1,1,0,1,0.368421052631579,0.818181818181818,0.157894736842105,0,"orthodox"
"332534",22,30,188,201,206,211,223,291,10,7,0,3,8,4,"win_A",-8,-13,-5,-68,0,0,0,1,1,0.7,0.8,0.4,0,"orthodox"
"332537",21,27,188,191,206,203,226,244,7,8,0,7,6,6,"win_A",-6,-3,3,-18,0,0,0,1,1,0.533333333333333,0.857142857142857,0.4,0,"orthodox"
"332694",32,32,175,180,180,193,147,145,28,25,6,9,16,19,"win_A",0,-5,-13,2,0,0,0,0,0.823529411764706,0.735294117647059,0.470588235294118,0.558823529411765,0,"orthodox"
"332698",28,30,175,180,180,181,139,140,23,19,2,4,14,13,"win_A",-2,-5,-1,-1,0,0,0,0,0.92,0.826086956521739,0.56,0.565217391304348,0,"orthodox"
"332699",28,32,175,180,180,185,140,140,22,42,2,7,14,19,"win_A",-4,-5,-5,0,0,0,0,0,0.916666666666667,0.857142857142857,0.583333333333333,0.387755102040816,0,"orthodox"
"332700",27,32,175,178,180,170,142,141,21,23,2,2,13,16,"win_A",-5,-3,10,1,0,0,0,0,0.91304347826087,0.92,0.565217391304348,0.64,0,"orthodox"
"332701",26,25,175,171,180,170,137,136,19,32,1,1,11,24,"win_A",1,4,10,1,0,0,0,0,0.95,0.96969696969697,0.55,0.727272727272727,0,"orthodox"
"332702",26,25,175,173,180,178,137,139,18,18,1,3,11,13,"win_A",1,2,2,-2,0,0,0,0,0.947368421052632,0.857142857142857,0.578947368421053,0.619047619047619,0,"orthodox"
"332705",24,27,175,164,180,170,135,130,15,23,0,2,9,6,"win_A",-3,11,10,5,0,0,0,0,1,0.92,0.6,0.24,0,"orthodox"
"332706",24,24,175,173,180,175,137,136,14,9,0,1,9,7,"win_A",0,2,5,1,0,0,0,0,1,0.9,0.642857142857143,0.7,0,"orthodox"
"332733",26,21,178,171,178,165,146,144,23,16,7,5,11,5,"win_B",5,7,13,2,0,0,0,0,0.766666666666667,0.761904761904762,0.366666666666667,0.238095238095238,1,"Unknown"
"332743",19,23,171,178,165,180,136,136,4,25,0,13,2,3,"win_A",-4,-7,-15,0,0,0,0,0,1,0.657894736842105,0.5,0.0789473684210526,0,"Unknown"
"332950",27,22,179,175,185,183,150,152,2,4,0,0,2,2,"win_A",5,4,2,-2,0,0,0,0,1,1,1,0.5,0,"Unknown"
"333033",38,35,188,191,193,213,220,215,46,4,3,2,40,2,"win_A",3,-3,-20,5,1,1,0,0,0.938775510204082,0.666666666666667,0.816326530612245,0.333333333333333,0,"orthodox"
"333036",26,26,188,213,193,218,231,230,42,14,2,5,36,13,"win_A",0,-25,-25,1,0,0,0,0,0.954545454545455,0.736842105263158,0.818181818181818,0.684210526315789,0,"orthodox"
"333037",26,31,188,188,193,201,232,229,41,13,2,7,35,6,"win_A",-5,0,-8,3,0,0,0,0,0.953488372093023,0.65,0.813953488372093,0.3,0,"orthodox"
"333038",25,31,188,191,193,198,220,228,40,14,2,2,35,10,"win_A",-6,-3,-5,-8,0,0,0,0,0.952380952380952,0.875,0.833333333333333,0.625,0,"orthodox"
"333039",25,25,188,196,193,208,224,248,39,14,2,0,34,9,"win_A",0,-8,-15,-24,0,0,0,1,0.951219512195122,1,0.829268292682927,0.642857142857143,0,"orthodox"
"333045",23,29,188,185,193,185,222,223,32,24,1,2,28,16,"win_A",-6,3,8,-1,0,0,0,0,0.96969696969697,0.923076923076923,0.848484848484849,0.615384615384615,0,"orthodox"
"333046",23,40,188,198,193,201,221,221,31,20,1,3,27,15,"win_A",-17,-10,-8,0,0,1,0,0,0.96875,0.869565217391304,0.84375,0.652173913043478,0,"orthodox"
"333048",23,28,188,185,193,188,223,214,29,78,1,8,25,58,"win_A",-5,3,5,9,0,0,0,0,0.966666666666667,0.906976744186046,0.833333333333333,0.674418604651163,0,"orthodox"
"333050",22,34,188,178,193,191,223,209,27,22,0,13,23,17,"win_A",-12,10,2,14,0,0,0,0,1,0.628571428571429,0.851851851851852,0.485714285714286,0,"orthodox"
"333374",37,33,171,173,173,178,145,145,35,15,12,2,11,7,"win_B",4,-2,-5,0,1,0,0,0,0.74468085106383,0.882352941176471,0.234042553191489,0.411764705882353,1,"orthodox"
"333375",32,33,170,171,176,173,142,142,18,34,12,7,14,10,"win_A",-1,-1,3,0,0,0,0,0,0.6,0.829268292682927,0.466666666666667,0.24390243902439,0,"southpaw"
"333377",30,24,171,169,173,168,142,144,32,18,5,2,9,12,"win_A",6,2,5,-2,0,0,0,0,0.864864864864865,0.9,0.243243243243243,0.6,0,"orthodox"
"333378",29,35,171,178,173,185,149,149,32,21,3,11,9,12,"win_B",-6,-7,-12,0,0,1,0,0,0.914285714285714,0.65625,0.257142857142857,0.375,1,"orthodox"
"333379",28,31,171,168,173,168,149,150,30,16,3,1,9,9,"win_A",-3,3,5,-1,0,0,0,0,0.909090909090909,0.941176470588235,0.272727272727273,0.529411764705882,0,"orthodox"
"333380",28,31,171,171,173,175,149,150,29,15,3,5,9,6,"win_A",-3,0,-2,-1,0,0,0,0,0.90625,0.75,0.28125,0.3,0,"orthodox"
"333382",28,21,171,173,173,178,138,141,27,19,3,14,8,5,"win_A",7,-2,-5,-3,0,0,0,0,0.9,0.575757575757576,0.266666666666667,0.151515151515152,0,"orthodox"
"333384",27,25,171,168,173,165,142,141,25,22,3,3,7,21,"win_A",2,3,8,1,0,0,0,0,0.892857142857143,0.88,0.25,0.84,0,"orthodox"
"333386",27,35,171,170,173,175,146,142,23,19,2,14,6,10,"win_A",-8,1,-2,4,0,1,0,0,0.92,0.575757575757576,0.24,0.303030303030303,0,"orthodox"
"333390",24,33,171,163,173,157,130,130,19,23,1,8,5,11,"win_A",-9,8,16,0,0,0,0,0,0.95,0.741935483870968,0.25,0.354838709677419,0,"orthodox"
"333391",23,32,171,163,173,157,130,130,18,22,1,7,4,10,"win_A",-9,8,16,0,0,0,0,0,0.947368421052632,0.758620689655172,0.210526315789474,0.344827586206897,0,"orthodox"
"333394",23,23,171,180,173,185,133,133,15,25,1,3,4,22,"win_A",0,-9,-12,0,0,0,0,0,0.9375,0.892857142857143,0.25,0.785714285714286,0,"orthodox"
"333399",22,27,171,170,173,178,138,138,10,7,0,8,4,4,"win_A",-5,1,-5,0,0,0,0,0,1,0.466666666666667,0.4,0.266666666666667,0,"orthodox"
"334626",30,31,173,168,175,180,130,130,39,21,2,2,29,14,"win_A",-1,5,-5,0,0,0,0,0,0.951219512195122,0.91304347826087,0.707317073170732,0.608695652173913,0,"orthodox"
"334627",29,27,173,157,175,157,126,126,37,28,1,1,27,19,"win_A",2,16,18,0,0,0,0,0,0.973684210526316,0.96551724137931,0.710526315789474,0.655172413793103,0,"orthodox"
"334630",27,31,173,170,175,173,125,127,33,15,0,4,24,11,"win_A",-4,3,2,-2,0,0,0,0,1,0.789473684210526,0.727272727272727,0.578947368421053,0,"orthodox"
"334637",24,35,173,170,175,180,126,126,25,32,0,10,19,20,"win_A",-11,3,-5,0,0,1,0,0,1,0.761904761904762,0.76,0.476190476190476,0,"orthodox"
"334639",23,26,173,173,175,178,126,126,22,15,0,9,19,10,"win_A",-3,0,-3,0,0,0,0,0,1,0.625,0.863636363636364,0.416666666666667,0,"orthodox"
"334648",20,22,173,165,175,165,126,122,13,3,0,2,11,1,"win_A",-2,8,10,4,0,0,0,0,1,0.6,0.846153846153846,0.2,0,"orthodox"
"336006",34,27,177,174,183,173,149,149,23,22,27,15,12,18,"win_B",7,3,10,0,0,0,0,0,0.46,0.594594594594595,0.24,0.486486486486487,1,"Unknown"
"336010",32,26,177,178,183,191,160,174,22,16,20,1,12,13,"win_B",6,-1,-8,-14,0,0,0,0,0.523809523809524,0.941176470588235,0.285714285714286,0.764705882352941,1,"Unknown"
"337081",26,28,178,170,188,175,136,136,17,25,1,11,11,17,"win_A",-2,8,13,0,0,0,0,0,0.944444444444444,0.694444444444444,0.611111111111111,0.472222222222222,0,"orthodox"
"337084",25,29,178,168,188,180,130,129,13,9,1,9,11,7,"win_A",-4,10,8,1,0,0,0,0,0.928571428571429,0.5,0.785714285714286,0.388888888888889,0,"orthodox"
"337087",24,25,178,173,188,180,142,135,9,14,1,4,9,6,"win_A",-1,5,8,7,0,0,0,0,0.9,0.777777777777778,0.9,0.333333333333333,0,"orthodox"
"337196",39,28,168,170,165,173,139,132,70,24,9,6,38,20,"win_B",11,-2,-8,7,1,0,0,0,0.886075949367089,0.8,0.481012658227848,0.666666666666667,1,"orthodox"
"337507",28,37,189,182,193,196,175,175,11,20,0,6,4,9,"win_A",-9,7,-3,0,0,1,0,0,1,0.769230769230769,0.363636363636364,0.346153846153846,0,"southpaw"
"337509",26,35,189,182,193,196,175,175,9,17,0,5,3,7,"win_A",-9,7,-3,0,0,1,0,0,1,0.772727272727273,0.333333333333333,0.318181818181818,0,"southpaw"
"337531",25,26,175,165,175,155,129,128,16,17,1,3,14,11,"win_A",-1,10,20,1,0,0,0,0,0.941176470588235,0.85,0.823529411764706,0.55,0,"orthodox"
"337532",26,25,166,175,173,175,130,130,28,16,5,0,18,14,"win_A",1,-9,-2,0,0,0,0,0,0.848484848484849,1,0.545454545454545,0.875,0,"orthodox"
"337539",23,33,175,170,175,173,132,134,7,27,0,4,5,13,"win_A",-10,5,2,-2,0,0,0,0,1,0.870967741935484,0.714285714285714,0.419354838709677,0,"orthodox"
"337611",39,36,185,187,196,203,207,207,28,28,7,19,25,23,"win_A",3,-2,-7,0,1,1,0,0,0.8,0.595744680851064,0.714285714285714,0.48936170212766,0,"southpaw"
"337617",32,26,185,185,196,189,198,217,22,14,4,11,20,11,"win_A",6,0,7,-19,0,0,0,1,0.846153846153846,0.56,0.769230769230769,0.44,0,"southpaw"
"337618",30,32,188,185,198,196,188,188,14,22,3,3,11,20,"win_A",-2,3,2,0,0,0,0,0,0.823529411764706,0.88,0.647058823529412,0.8,0,"orthodox"
"337626",34,30,191,185,199,196,215,238,42,15,8,2,39,14,"win_A",4,6,3,-23,0,0,0,1,0.84,0.882352941176471,0.78,0.823529411764706,0,"orthodox"
"337627",41,29,185,185,196,196,215,214,11,14,25,2,4,14,"win_B",12,0,0,1,1,0,0,0,0.305555555555556,0.875,0.111111111111111,0.875,1,"orthodox"
"337628",28,29,185,189,196,201,202,194,13,22,2,5,13,15,"win_A",-1,-4,-5,8,0,0,0,0,0.866666666666667,0.814814814814815,0.866666666666667,0.555555555555556,0,"southpaw"
"337630",28,26,185,180,196,193,189,187,11,9,2,6,11,9,"win_A",2,5,3,2,0,0,0,0,0.846153846153846,0.6,0.846153846153846,0.6,0,"southpaw"
"337715",33,36,175,173,191,183,159,160,30,12,6,35,16,4,"win_A",-3,2,8,-1,0,1,0,0,0.833333333333333,0.25531914893617,0.444444444444444,0.0851063829787234,0,"orthodox"
"337719",29,27,175,175,191,183,152,153,24,12,4,7,12,8,"win_A",2,0,8,-1,0,0,0,0,0.857142857142857,0.631578947368421,0.428571428571429,0.421052631578947,0,"orthodox"
"337732",22,30,175,175,191,193,148,147,11,14,0,4,9,9,"win_A",-8,0,-2,1,0,0,0,0,1,0.777777777777778,0.818181818181818,0.5,0,"orthodox"
"338319",29,25,165,166,175,168,116,118,26,16,11,5,13,4,"win_A",4,-1,7,-2,0,0,0,0,0.702702702702703,0.761904761904762,0.351351351351351,0.19047619047619,0,"orthodox"
"338660",25,26,171,170,170,183,135,131,32,19,2,6,24,15,"win_A",-1,1,-13,4,0,0,0,0,0.941176470588235,0.76,0.705882352941177,0.6,0,"orthodox"
"338667",21,28,171,163,170,160,128,126,23,21,0,20,18,14,"win_A",-7,8,10,2,0,0,0,0,1,0.51219512195122,0.782608695652174,0.341463414634146,0,"orthodox"
"338669",20,29,171,164,170,168,127,128,21,26,0,7,16,11,"win_A",-9,7,2,-1,0,0,0,0,1,0.787878787878788,0.761904761904762,0.333333333333333,0,"orthodox"
"338671",20,23,171,170,170,173,129,127,19,1,0,8,15,1,"win_A",-3,1,-3,2,0,0,0,0,1,0.111111111111111,0.789473684210526,0.111111111111111,0,"orthodox"
"338678",19,25,171,168,170,175,128,129,11,3,0,12,9,0,"win_A",-6,3,-5,-1,0,0,0,0,1,0.2,0.818181818181818,0,0,"orthodox"
"339265",30,29,173,173,175,178,131,132,23,20,2,13,13,15,"win_A",1,0,-3,-1,0,0,0,0,0.92,0.606060606060606,0.52,0.454545454545455,0,"orthodox"
"339266",29,32,173,169,175,175,130,130,21,20,2,2,11,11,"win_A",-3,4,0,0,0,0,0,0,0.91304347826087,0.909090909090909,0.478260869565217,0.5,0,"orthodox"
"339275",25,25,173,178,175,183,130,131,11,15,0,2,7,10,"win_A",0,-5,-8,-1,0,0,0,0,1,0.882352941176471,0.636363636363636,0.588235294117647,0,"orthodox"
"339299",29,34,175,180,183,185,147,147,23,44,5,8,18,21,"win_A",-5,-5,-2,0,0,0,0,0,0.821428571428571,0.846153846153846,0.642857142857143,0.403846153846154,0,"orthodox"
"339301",33,29,180,175,185,175,146,142,42,32,8,6,19,27,"win_A",4,5,10,4,0,0,0,0,0.84,0.842105263157895,0.38,0.710526315789474,0,"orthodox"
"339544",23,25,188,185,185,185,168,167,14,12,1,0,8,10,"win_A",-2,3,0,1,0,0,0,0,0.933333333333333,1,0.533333333333333,0.833333333333333,0,"orthodox"
"339653",32,29,177,185,175,196,162,160,22,19,5,10,18,14,"win_A",3,-8,-21,2,0,0,0,0,0.814814814814815,0.655172413793103,0.666666666666667,0.482758620689655,0,"orthodox"
"339659",25,29,177,174,175,178,154,152,12,24,0,1,9,14,"win_A",-4,3,-3,2,0,0,0,0,1,0.96,0.75,0.56,0,"orthodox"
"339660",28,25,185,177,185,175,152,153,22,11,1,0,15,8,"win_B",3,8,10,-1,0,0,0,0,0.956521739130435,1,0.652173913043478,0.727272727272727,1,"orthodox"
"339662",25,21,177,183,175,188,156,156,9,9,0,0,6,4,"win_A",4,-6,-13,0,0,0,0,0,1,1,0.666666666666667,0.444444444444444,0,"orthodox"
"339667",23,31,177,173,175,175,157,158,3,3,0,13,1,2,"win_A",-8,4,0,-1,0,0,0,0,1,0.1875,0.333333333333333,0.125,0,"orthodox"
"339705",22,20,193,198,193,208,186,221,11,9,0,4,8,6,"win_A",2,-5,-15,-35,0,0,0,1,1,0.692307692307692,0.727272727272727,0.461538461538462,0,"orthodox"
"339711",22,19,193,198,193,208,189,221,5,5,0,2,5,5,"win_A",3,-5,-15,-32,0,0,0,1,1,0.714285714285714,1,0.714285714285714,0,"orthodox"
"340289",30,23,170,170,175,173,128,140,39,7,12,6,20,4,"win_B",7,0,2,-12,0,0,0,0,0.764705882352941,0.538461538461538,0.392156862745098,0.307692307692308,1,"Unknown"
"340290",30,24,170,159,175,163,126,125,39,13,11,3,20,6,"win_B",6,11,12,1,0,0,0,0,0.78,0.8125,0.4,0.375,1,"Unknown"
"340294",29,22,170,170,175,173,128,136,39,4,7,1,20,4,"win_B",7,0,2,-8,0,0,0,0,0.847826086956522,0.8,0.434782608695652,0.8,1,"Unknown"
"340298",20,27,177,170,175,175,130,135,32,36,5,5,16,17,"win_A",-7,7,0,-5,0,0,0,0,0.864864864864865,0.878048780487805,0.432432432432432,0.414634146341463,0,"Unknown"
"340299",26,26,170,165,175,173,127,131,35,12,5,6,16,7,"win_A",0,5,2,-4,0,0,0,0,0.875,0.666666666666667,0.4,0.388888888888889,0,"Unknown"
"341418",25,30,169,168,192,168,161,155,25,88,15,62,9,42,"win_A",-5,1,24,6,0,0,0,0,0.625,0.586666666666667,0.225,0.28,0,"Unknown"
"341841",23,26,171,179,178,183,141,148,43,32,6,5,20,26,"win_A",-3,-8,-5,-7,0,0,0,0,0.877551020408163,0.864864864864865,0.408163265306122,0.702702702702703,0,"orthodox"
"341960",31,32,163,165,160,166,118,116,35,21,9,3,11,16,"win_A",-1,-2,-6,2,0,0,0,0,0.795454545454545,0.875,0.25,0.666666666666667,0,"southpaw"
"341961",31,25,163,165,160,175,118,118,34,25,9,4,11,19,"win_A",6,-2,-15,0,0,0,0,0,0.790697674418605,0.862068965517241,0.255813953488372,0.655172413793103,0,"southpaw"
"341962",31,25,163,168,160,168,118,118,33,19,9,3,11,14,"win_A",6,-5,-8,0,0,0,0,0,0.785714285714286,0.863636363636364,0.261904761904762,0.636363636363636,0,"southpaw"
"341985",19,20,168,163,165,160,118,118,20,12,4,1,18,3,"win_A",-1,5,5,0,0,0,0,0,0.833333333333333,0.923076923076923,0.75,0.230769230769231,0,"orthodox"
"342093",28,24,189,191,201,211,212,200,18,8,2,0,15,7,"win_A",4,-2,-10,12,0,0,0,0,0.9,1,0.75,0.875,0,"orthodox"
"342941",26,36,160,165,165,157,114,115,20,35,1,7,14,29,"win_B",-10,-5,8,-1,0,1,0,0,0.952380952380952,0.833333333333333,0.666666666666667,0.69047619047619,1,"orthodox"
"342943",34,36,165,165,157,175,112,112,32,35,7,5,29,20,"win_A",-2,0,-18,0,0,1,0,0,0.82051282051282,0.875,0.743589743589744,0.5,0,"orthodox"
"342945",32,23,165,170,157,175,112,112,30,14,7,7,27,5,"win_A",9,-5,-18,0,0,0,0,0,0.810810810810811,0.666666666666667,0.72972972972973,0.238095238095238,0,"orthodox"
"342946",32,33,165,160,157,152,112,112,29,30,7,11,26,20,"win_A",-1,5,5,0,0,0,0,0,0.805555555555556,0.731707317073171,0.722222222222222,0.48780487804878,0,"orthodox"
"342947",32,33,165,160,157,168,112,112,28,12,7,7,25,9,"win_A",-1,5,-11,0,0,0,0,0,0.8,0.631578947368421,0.714285714285714,0.473684210526316,0,"orthodox"
"342953",23,27,160,165,168,157,112,112,19,21,1,4,5,20,"win_A",-4,-5,11,0,0,0,0,0,0.95,0.84,0.25,0.8,0,"orthodox"
"343258",36,34,163,159,168,163,108,108,24,31,4,6,13,21,"win_A",2,4,5,0,1,0,0,0,0.857142857142857,0.837837837837838,0.464285714285714,0.567567567567568,0,"orthodox"
"343259",33,31,163,159,168,163,108,108,21,31,1,4,12,21,"win_A",2,4,5,0,0,0,0,0,0.954545454545455,0.885714285714286,0.545454545454545,0.6,0,"orthodox"
"343267",22,22,159,157,163,160,104,104,21,12,0,0,16,8,"win_A",0,2,3,0,0,0,0,0,1,1,0.761904761904762,0.666666666666667,0,"orthodox"
"343273",21,19,159,168,163,168,105,105,15,9,0,11,12,4,"win_A",2,-9,-5,0,0,0,0,0,1,0.45,0.8,0.2,0,"orthodox"
"343305",25,34,188,185,208,188,167,168,23,30,1,5,18,16,"win_A",-9,3,20,-1,0,0,0,0,0.958333333333333,0.857142857142857,0.75,0.457142857142857,0,"Unknown"
"343326",24,26,185,185,193,188,163,168,10,11,7,1,2,6,"win_B",-2,0,5,-5,0,0,0,0,0.588235294117647,0.916666666666667,0.117647058823529,0.5,1,"orthodox"
"343331",25,33,185,180,188,193,166,163,6,69,1,25,4,50,"win_A",-8,5,-5,3,0,0,0,0,0.857142857142857,0.734042553191489,0.571428571428571,0.531914893617021,0,"southpaw"
"343337",23,22,185,172,188,178,155,155,1,2,0,1,0,1,"win_B",1,13,10,0,0,0,0,0,1,0.666666666666667,0,0.333333333333333,1,"southpaw"
"343359",33,38,180,188,193,201,198,196,29,45,8,12,17,21,"win_A",-5,-8,-8,2,0,1,0,0,0.783783783783784,0.789473684210526,0.459459459459459,0.368421052631579,0,"Unknown"
"343374",27,30,188,180,201,183,185,185,32,18,2,3,14,13,"win_A",-3,8,18,0,0,0,0,0,0.941176470588235,0.857142857142857,0.411764705882353,0.619047619047619,0,"southpaw"
"343658",26,37,185,188,193,198,167,163,17,42,2,15,8,24,"win_A",-11,-3,-5,4,0,1,0,0,0.894736842105263,0.736842105263158,0.421052631578947,0.421052631578947,0,"orthodox"
"343661",33,28,188,180,198,188,154,154,39,30,12,3,23,25,"win_A",5,8,10,0,0,0,0,0,0.764705882352941,0.909090909090909,0.450980392156863,0.757575757575758,0,"southpaw"
"343666",29,27,188,180,198,180,159,162,32,14,12,9,21,8,"win_A",2,8,18,-3,0,0,0,0,0.727272727272727,0.608695652173913,0.477272727272727,0.347826086956522,0,"southpaw"
"343667",29,35,188,183,198,185,162,168,31,29,12,8,21,16,"win_A",-6,5,13,-6,0,1,0,0,0.720930232558139,0.783783783783784,0.488372093023256,0.432432432432432,0,"southpaw"
"343670",28,28,188,175,198,183,160,159,26,12,12,5,16,5,"win_A",0,13,15,1,0,0,0,0,0.684210526315789,0.705882352941177,0.421052631578947,0.294117647058824,0,"southpaw"
"343672",27,28,188,180,198,178,159,160,24,31,12,4,15,17,"win_A",-1,8,20,-1,0,0,0,0,0.666666666666667,0.885714285714286,0.416666666666667,0.485714285714286,0,"southpaw"
"343675",25,30,188,180,198,203,160,160,20,22,11,6,12,17,"win_A",-5,8,-5,0,0,0,0,0,0.645161290322581,0.785714285714286,0.387096774193548,0.607142857142857,0,"southpaw"
"343676",26,24,185,188,191,198,179,184,19,19,0,10,11,11,"win_A",2,-3,-7,-5,0,0,0,0,1,0.655172413793103,0.578947368421053,0.379310344827586,0,"orthodox"
"343681",32,23,175,188,178,198,174,174,12,15,1,9,10,9,"win_A",9,-13,-20,0,0,0,0,0,0.923076923076923,0.625,0.769230769230769,0.375,0,"orthodox"
"343684",34,22,173,188,173,198,160,162,15,14,1,7,14,9,"win_A",12,-15,-25,-2,0,0,0,0,0.9375,0.666666666666667,0.875,0.428571428571429,0,"orthodox"
"343793",23,24,198,185,202,193,200,189,31,40,1,8,21,31,"win_A",-1,13,9,11,0,0,0,0,0.96875,0.833333333333333,0.65625,0.645833333333333,0,"orthodox"
"344020",20,40,179,179,189,188,167,162,7,27,0,9,5,16,"win_A",-20,0,1,5,0,1,0,0,1,0.75,0.714285714285714,0.444444444444444,0,"Unknown"
"344250",23,26,163,168,165,166,116,118,21,26,1,14,18,21,"win_A",-3,-5,-1,-2,0,0,0,0,0.954545454545455,0.65,0.818181818181818,0.525,0,"orthodox"
"344252",22,25,163,168,165,166,118,118,19,25,1,13,16,20,"win_A",-3,-5,-1,0,0,0,0,0,0.95,0.657894736842105,0.8,0.526315789473684,0,"orthodox"
"344608",28,38,178,170,188,178,135,135,26,46,3,3,15,40,"win_B",-10,8,10,0,0,1,0,0,0.896551724137931,0.938775510204082,0.517241379310345,0.816326530612245,1,"orthodox"
"344623",22,26,178,173,188,183,137,139,10,15,0,8,4,6,"win_A",-4,5,5,-2,0,0,0,0,1,0.652173913043478,0.4,0.260869565217391,0,"orthodox"
"344631",20,27,178,175,188,180,132,132,2,6,0,0,1,3,"win_A",-7,3,8,0,0,0,0,0,1,1,0.5,0.5,0,"orthodox"
"345060",37,35,177,173,175,183,160,162,25,12,1,34,19,4,"win_A",2,4,-8,-2,1,1,0,0,0.961538461538462,0.260869565217391,0.730769230769231,0.0869565217391304,0,"southpaw"
"345062",32,24,177,174,175,175,154,154,22,22,0,0,17,22,"win_A",8,3,0,0,0,0,0,0,1,1,0.772727272727273,1,0,"southpaw"
"345069",29,31,177,175,175,183,155,154,15,25,0,6,11,12,"win_A",-2,2,-8,1,0,0,0,0,1,0.806451612903226,0.733333333333333,0.387096774193548,0,"southpaw"
"345072",33,28,175,177,183,175,159,155,22,12,58,0,16,9,"win_B",5,-2,8,4,0,0,0,0,0.275,1,0.2,0.75,1,"orthodox"
"345453",27,36,167,165,173,168,139,138,23,24,0,9,16,15,"win_A",-9,2,5,1,0,1,0,0,1,0.727272727272727,0.695652173913043,0.454545454545455,0,"orthodox"
"345458",28,23,165,170,168,170,122,122,21,18,2,4,13,8,"win_B",5,-5,-2,0,0,0,0,0,0.91304347826087,0.818181818181818,0.565217391304348,0.363636363636364,1,"orthodox"
"345479",29,33,160,166,165,170,111,115,25,35,3,6,17,26,"win_A",-4,-6,-5,-4,0,0,0,0,0.892857142857143,0.853658536585366,0.607142857142857,0.634146341463415,0,"orthodox"
"345743",34,26,179,183,176,191,196,196,21,18,0,0,14,9,"win_A",8,-4,-15,0,0,0,0,0,1,1,0.666666666666667,0.5,0,"orthodox"
"345746",33,30,179,188,176,188,195,200,18,16,0,2,13,13,"win_A",3,-9,-12,-5,0,0,0,0,1,0.888888888888889,0.722222222222222,0.722222222222222,0,"orthodox"
"346046",24,22,180,185,180,188,142,142,26,11,0,0,19,10,"win_A",2,-5,-8,0,0,0,0,0,1,1,0.730769230769231,0.909090909090909,0,"orthodox"
"346048",34,24,173,180,175,180,142,142,20,24,11,0,12,17,"win_B",10,-7,-5,0,0,0,0,0,0.645161290322581,1,0.387096774193548,0.708333333333333,1,"orthodox"
"346220",28,39,178,178,177,178,168,168,12,51,1,9,6,36,"win_A",-11,0,-1,0,0,1,0,0,0.923076923076923,0.85,0.461538461538462,0.6,0,"orthodox"
"346228",34,29,178,183,178,185,154,154,43,1,6,7,29,1,"win_A",5,-5,-7,0,0,0,0,0,0.877551020408163,0.125,0.591836734693878,0.125,0,"orthodox"
"346230",34,28,178,179,178,183,154,154,42,23,5,6,28,13,"win_B",6,-1,-5,0,0,0,0,0,0.893617021276596,0.793103448275862,0.595744680851064,0.448275862068966,1,"orthodox"
"346240",30,34,178,178,178,180,167,168,31,32,3,10,21,8,"win_A",-4,0,-2,-1,0,0,0,0,0.911764705882353,0.761904761904762,0.617647058823529,0.19047619047619,0,"orthodox"
"346515",25,34,168,168,173,168,132,130,27,41,11,5,13,24,"win_A",-9,0,5,2,0,0,0,0,0.710526315789474,0.891304347826087,0.342105263157895,0.521739130434783,0,"southpaw"
"346516",32,34,168,173,168,178,136,135,38,25,3,5,23,22,"win_A",-2,-5,-10,1,0,0,0,0,0.926829268292683,0.833333333333333,0.560975609756098,0.733333333333333,0,"orthodox"
"346526",28,29,168,168,168,168,133,137,28,6,2,9,17,3,"win_A",-1,0,0,-4,0,0,0,0,0.933333333333333,0.4,0.566666666666667,0.2,0,"orthodox"
"346530",23,26,165,168,178,168,133,132,10,23,0,1,5,13,"win_B",-3,-3,10,1,0,0,0,0,1,0.958333333333333,0.5,0.541666666666667,1,"Unknown"
"346532",25,24,183,168,182,168,131,131,24,21,4,0,15,12,"win_A",1,15,14,0,0,0,0,0,0.857142857142857,1,0.535714285714286,0.571428571428571,0,"Unknown"
"346539",22,27,168,165,168,165,131,132,12,11,0,4,6,5,"win_A",-5,3,3,-1,0,0,0,0,1,0.733333333333333,0.5,0.333333333333333,0,"orthodox"
"346681",36,34,182,170,185,175,147,146,41,25,3,10,25,13,"win_A",2,12,10,1,1,0,0,0,0.931818181818182,0.714285714285714,0.568181818181818,0.371428571428571,0,"orthodox"
"346682",36,30,182,175,185,168,146,144,40,26,3,11,25,15,"win_A",6,7,17,2,1,0,0,0,0.930232558139535,0.702702702702703,0.581395348837209,0.405405405405405,0,"orthodox"
"346690",27,29,182,175,185,180,145,144,29,12,2,4,19,9,"win_A",-2,7,5,1,0,0,0,0,0.935483870967742,0.75,0.612903225806452,0.5625,0,"orthodox"
"346693",25,26,182,178,185,178,142,141,24,24,1,4,16,16,"win_A",-1,4,7,1,0,0,0,0,0.96,0.857142857142857,0.64,0.571428571428571,0,"orthodox"
"346696",22,25,170,182,173,185,141,137,11,21,8,1,3,14,"win_B",-3,-12,-12,4,0,0,0,0,0.578947368421053,0.954545454545455,0.157894736842105,0.636363636363636,1,"orthodox"
"347360",25,34,173,168,191,180,146,147,18,27,4,8,9,18,"win_A",-9,5,11,-1,0,0,0,0,0.818181818181818,0.771428571428571,0.409090909090909,0.514285714285714,0,"southpaw"
"347362",31,28,168,171,180,175,126,126,26,12,4,1,17,9,"win_A",3,-3,5,0,0,0,0,0,0.866666666666667,0.923076923076923,0.566666666666667,0.692307692307692,0,"southpaw"
"347836",29,40,180,177,178,178,159,158,14,22,0,6,11,11,"win_A",-11,3,0,1,0,1,0,0,1,0.785714285714286,0.785714285714286,0.392857142857143,0,"orthodox"
"348238",28,24,188,183,198,198,202,222,22,19,3,5,18,17,"win_B",4,5,0,-20,0,0,0,1,0.88,0.791666666666667,0.72,0.708333333333333,1,"orthodox"
"349379",23,19,180,193,183,198,209,186,45,12,8,0,17,8,"win_A",4,-13,-15,23,0,0,1,0,0.849056603773585,1,0.320754716981132,0.666666666666667,0,"orthodox"
"350155",28,28,168,169,173,173,134,135,34,28,1,1,19,20,"win_B",0,-1,0,-1,0,0,0,0,0.971428571428571,0.96551724137931,0.542857142857143,0.689655172413793,1,"Unknown"
"350160",26,25,168,175,173,178,135,134,29,23,0,0,16,10,"win_A",1,-7,-5,1,0,0,0,0,1,1,0.551724137931034,0.434782608695652,0,"Unknown"
"350208",28,32,191,185,201,188,226,225,9,14,1,10,5,9,"win_A",-4,6,13,1,0,0,0,0,0.9,0.583333333333333,0.5,0.375,0,"orthodox"
"350451",28,24,188,183,198,198,202,222,22,19,3,5,18,17,"win_B",4,5,0,-20,0,0,0,1,0.88,0.791666666666667,0.72,0.708333333333333,1,"orthodox"
"351592",23,19,180,193,183,198,209,186,45,12,8,0,17,8,"win_A",4,-13,-15,23,0,0,1,0,0.849056603773585,1,0.320754716981132,0.666666666666667,0,"orthodox"
"352368",28,28,168,169,173,173,134,135,34,28,1,1,19,20,"win_B",0,-1,0,-1,0,0,0,0,0.971428571428571,0.96551724137931,0.542857142857143,0.689655172413793,1,"Unknown"
"352373",26,25,168,175,173,178,135,134,29,23,0,0,16,10,"win_A",1,-7,-5,1,0,0,0,0,1,1,0.551724137931034,0.434782608695652,0,"Unknown"
"352421",28,32,191,185,201,188,226,225,9,14,1,10,5,9,"win_A",-4,6,13,1,0,0,0,0,0.9,0.583333333333333,0.5,0.375,0,"orthodox"
"352539",32,27,163,173,165,183,135,135,51,15,9,5,33,5,"win_A",5,-10,-18,0,0,0,0,0,0.85,0.75,0.55,0.25,0,"orthodox"
"352639",25,29,170,178,165,180,146,146,17,25,0,2,14,17,"win_A",-4,-8,-15,0,0,0,0,0,1,0.925925925925926,0.823529411764706,0.62962962962963,0,"orthodox"
"352819",31,35,170,170,173,180,136,136,26,53,1,15,15,36,"win_A",-4,0,-7,0,0,1,0,0,0.962962962962963,0.779411764705882,0.555555555555556,0.529411764705882,0,"orthodox"
"352820",29,34,180,170,198,180,140,139,19,51,0,14,11,35,"win_B",-5,10,18,1,0,0,0,0,1,0.784615384615385,0.578947368421053,0.538461538461538,1,"orthodox"
"352824",35,31,175,170,180,180,135,135,37,49,6,11,8,34,"win_A",4,5,0,0,1,0,0,0,0.86046511627907,0.816666666666667,0.186046511627907,0.566666666666667,0,"southpaw"
"352826",30,34,170,172,180,193,136,137,47,33,11,18,34,20,"win_A",-4,-2,-13,-1,0,0,0,0,0.810344827586207,0.647058823529412,0.586206896551724,0.392156862745098,0,"orthodox"
"352828",29,28,170,175,180,173,134,135,44,22,10,0,32,16,"win_A",1,-5,7,-1,0,0,0,0,0.814814814814815,1,0.592592592592593,0.727272727272727,0,"orthodox"
"352831",27,21,170,175,180,178,130,130,42,16,9,1,31,13,"win_A",6,-5,2,0,0,0,0,0,0.823529411764706,0.941176470588235,0.607843137254902,0.764705882352941,0,"orthodox"
"352833",28,25,165,170,173,180,130,130,22,40,2,8,15,30,"win_B",3,-5,-7,0,0,0,0,0,0.916666666666667,0.833333333333333,0.625,0.625,1,"southpaw"
"352835",24,24,170,170,180,170,131,131,38,11,8,0,30,10,"win_A",0,0,10,0,0,0,0,0,0.826086956521739,1,0.652173913043478,0.909090909090909,0,"orthodox"
"352836",24,26,170,168,180,173,128,129,37,48,7,14,29,28,"win_A",-2,2,7,-1,0,0,0,0,0.840909090909091,0.774193548387097,0.659090909090909,0.451612903225806,0,"orthodox"
"352837",23,21,170,173,180,173,126,126,37,10,6,1,29,5,"win_B",2,-3,7,0,0,0,0,0,0.86046511627907,0.909090909090909,0.674418604651163,0.454545454545455,1,"orthodox"
"353253",27,23,180,183,188,193,154,154,20,22,0,2,7,4,"win_A",4,-3,-5,0,0,0,0,0,1,0.916666666666667,0.35,0.166666666666667,0,"southpaw"
"353952",40,25,175,175,183,178,165,165,49,6,10,0,46,2,"win_B",15,0,5,0,1,0,0,0,0.830508474576271,1,0.779661016949153,0.333333333333333,1,"orthodox"
"353961",26,34,183,175,175,183,154,154,14,42,0,5,6,39,"win_A",-8,8,-8,0,0,0,0,0,1,0.893617021276596,0.428571428571429,0.829787234042553,0,"orthodox"
"354167",27,24,184,180,188,183,194,202,54,49,11,8,31,17,"win_A",3,4,5,-8,0,0,0,0,0.830769230769231,0.859649122807018,0.476923076923077,0.298245614035088,0,"orthodox"
"354231",24,36,155,168,160,173,114,114,18,5,3,12,11,2,"win_A",-12,-13,-13,0,0,1,0,0,0.857142857142857,0.294117647058824,0.523809523809524,0.117647058823529,0,"orthodox"
"354254",34,36,185,185,198,188,175,175,23,28,5,3,11,23,"win_A",-2,0,10,0,0,1,0,0,0.821428571428571,0.903225806451613,0.392857142857143,0.741935483870968,0,"southpaw"
"354257",33,32,185,178,188,173,177,177,25,17,3,2,21,16,"win_A",1,7,15,0,0,0,0,0,0.892857142857143,0.894736842105263,0.75,0.842105263157895,0,"orthodox"
"354262",30,37,185,183,188,193,177,175,20,22,2,8,17,11,"win_A",-7,2,-5,2,0,1,0,0,0.909090909090909,0.733333333333333,0.772727272727273,0.366666666666667,0,"orthodox"
"355318",26,27,178,170,183,170,135,135,24,21,3,3,15,11,"win_A",-1,8,13,0,0,0,0,0,0.888888888888889,0.875,0.555555555555556,0.458333333333333,0,"orthodox"
"355319",26,27,178,173,183,173,140,141,23,13,3,3,14,8,"win_A",-1,5,10,-1,0,0,0,0,0.884615384615385,0.8125,0.538461538461538,0.5,0,"orthodox"
"355320",26,33,178,170,183,178,139,142,22,7,3,18,13,1,"win_A",-7,8,5,-3,0,0,0,0,0.88,0.28,0.52,0.04,0,"orthodox"
"355322",25,27,178,175,183,185,135,136,20,19,2,11,13,10,"win_A",-2,3,-2,-1,0,0,0,0,0.909090909090909,0.633333333333333,0.590909090909091,0.333333333333333,0,"orthodox"
"355326",24,31,178,170,183,178,140,144,16,4,2,13,11,1,"win_A",-7,8,5,-4,0,0,0,0,0.888888888888889,0.235294117647059,0.611111111111111,0.0588235294117647,0,"orthodox"
"355680",37,27,168,168,170,170,114,115,15,28,0,4,6,19,"win_A",10,0,0,-1,1,0,0,0,1,0.875,0.4,0.59375,0,"orthodox"
"355797",18,27,178,170,183,173,133,133,11,24,2,5,3,20,"win_A",-9,8,10,0,0,0,0,0,0.846153846153846,0.827586206896552,0.230769230769231,0.689655172413793,0,"orthodox"
"355799",36,26,157,170,170,173,127,127,11,23,10,4,7,19,"win_B",10,-13,-3,0,1,0,0,0,0.523809523809524,0.851851851851852,0.333333333333333,0.703703703703704,1,"orthodox"
"355804",27,24,170,170,173,173,122,121,23,21,0,1,14,17,"win_A",3,0,0,1,0,0,0,0,1,0.954545454545455,0.608695652173913,0.772727272727273,0,"orthodox"
"355806",24,34,170,169,173,168,122,121,19,35,1,7,15,19,"win_A",-10,1,5,1,0,0,0,0,0.95,0.833333333333333,0.75,0.452380952380952,0,"Unknown"
"355829",28,27,191,179,193,183,200,222,22,21,3,2,10,15,"win_A",1,12,10,-22,0,0,0,1,0.88,0.91304347826087,0.4,0.652173913043478,0,"orthodox"
"355830",28,33,191,195,193,203,215,240,21,38,3,12,10,27,"win_A",-5,-4,-10,-25,0,0,0,1,0.875,0.76,0.416666666666667,0.54,0,"orthodox"
"355868",28,30,173,173,175,173,135,135,23,30,4,3,20,18,"win_A",-2,0,2,0,0,0,0,0,0.851851851851852,0.909090909090909,0.740740740740741,0.545454545454545,0,"orthodox"
"356394",24,20,173,173,173,178,140,141,3,2,0,1,2,0,"win_A",4,0,-5,-1,0,0,0,0,1,0.666666666666667,0.666666666666667,0,0,"southpaw"
"356463",22,22,165,168,168,170,120,119,35,31,7,6,8,3,"win_A",0,-3,-2,1,0,0,0,0,0.833333333333333,0.837837837837838,0.19047619047619,0.0810810810810811,0,"Unknown"
"356686",24,25,178,170,175,173,133,134,9,2,0,1,7,2,"win_A",-1,8,2,-1,0,0,0,0,1,0.666666666666667,0.777777777777778,0.666666666666667,0,"Unknown"
"356816",27,35,185,181,201,199,244,228,19,35,0,20,17,30,"win_A",-8,4,2,16,0,1,1,0,1,0.636363636363636,0.894736842105263,0.545454545454545,0,"orthodox"
"356817",26,33,188,181,203,199,229,218,15,35,0,19,9,30,"win_A",-7,7,4,11,0,0,0,0,1,0.648148148148148,0.6,0.555555555555556,0,"orthodox"
"356819",30,33,198,181,208,199,233,240,18,34,0,18,15,29,"win_A",-3,17,9,-7,0,0,0,0,1,0.653846153846154,0.833333333333333,0.557692307692308,0,"orthodox"
"356822",24,31,188,181,193,199,231,260,18,33,2,16,16,28,"win_A",-7,7,-6,-29,0,0,0,1,0.9,0.673469387755102,0.8,0.571428571428571,0,"orthodox"
"356833",25,28,181,185,199,185,221,243,25,21,7,1,22,15,"win_A",-3,-4,14,-22,0,0,0,1,0.78125,0.954545454545455,0.6875,0.681818181818182,0,"orthodox"
"356847",20,25,181,191,199,197,194,194,11,10,1,0,10,7,"win_A",-5,-10,2,0,0,0,0,0,0.916666666666667,1,0.833333333333333,0.7,0,"orthodox"
"356849",24,20,191,181,198,199,200,212,17,10,3,0,12,9,"win_A",4,10,-1,-12,0,0,0,0,0.85,1,0.6,0.9,0,"orthodox"
"356958",27,26,160,160,170,160,108,108,14,19,2,3,11,15,"win_A",1,0,10,0,0,0,0,0,0.875,0.863636363636364,0.6875,0.681818181818182,0,"southpaw"
"357504",32,29,185,185,198,187,176,176,20,10,6,6,18,6,"win_A",3,0,11,0,0,0,0,0,0.769230769230769,0.625,0.692307692307692,0.375,0,"orthodox"
"357518",22,27,185,178,198,178,178,178,6,4,0,9,5,1,"win_A",-5,7,20,0,0,0,0,0,1,0.307692307692308,0.833333333333333,0.0769230769230769,0,"orthodox"
"357973",30,27,178,174,175,173,148,152,23,20,7,13,15,16,"win_A",3,4,2,-4,0,0,0,0,0.766666666666667,0.606060606060606,0.5,0.484848484848485,0,"Unknown"
"357975",26,30,170,178,173,175,152,156,35,21,6,7,15,15,"win_B",-4,-8,-2,-4,0,0,0,0,0.853658536585366,0.75,0.365853658536585,0.535714285714286,1,"Unknown"
"357976",30,27,178,174,175,173,153,152,19,19,7,12,14,16,"win_A",3,4,2,1,0,0,0,0,0.730769230769231,0.612903225806452,0.538461538461538,0.516129032258065,0,"Unknown"
"357979",25,29,170,178,173,175,154,158,30,17,5,4,12,12,"win_A",-4,-8,-2,-4,0,0,0,0,0.857142857142857,0.80952380952381,0.342857142857143,0.571428571428571,0,"Unknown"
"358106",24,26,179,178,184,188,160,159,20,11,2,11,5,7,"win_A",-2,1,-4,1,0,0,0,0,0.909090909090909,0.5,0.227272727272727,0.318181818181818,0,"orthodox"
"358181",35,27,170,171,180,179,135,135,29,20,6,3,23,15,"win_B",8,-1,1,0,1,0,0,0,0.828571428571429,0.869565217391304,0.657142857142857,0.652173913043478,1,"orthodox"
"358184",26,31,171,170,175,180,133,135,26,25,0,3,19,19,"win_B",-5,1,-5,-2,0,0,0,0,1,0.892857142857143,0.730769230769231,0.678571428571429,1,"orthodox"
"358198",20,25,173,170,163,180,135,135,16,9,1,2,11,8,"win_A",-5,3,-17,0,0,0,0,0,0.941176470588235,0.818181818181818,0.647058823529412,0.727272727272727,0,"orthodox"
"358213",31,31,177,175,185,183,162,159,27,18,6,35,19,15,"win_A",0,2,2,3,0,0,0,0,0.818181818181818,0.339622641509434,0.575757575757576,0.283018867924528,0,"Unknown"
"358214",29,30,177,177,185,185,160,162,26,10,4,3,18,9,"win_A",-1,0,0,-2,0,0,0,0,0.866666666666667,0.769230769230769,0.6,0.692307692307692,0,"Unknown"
"358247",21,26,164,169,165,173,122,122,34,27,1,7,28,21,"win_A",-5,-5,-8,0,0,0,0,0,0.971428571428571,0.794117647058823,0.8,0.617647058823529,0,"orthodox"
"358733",27,19,164,171,174,168,133,136,86,17,20,3,18,9,"win_A",8,-7,6,-3,0,0,0,0,0.811320754716981,0.85,0.169811320754717,0.45,0,"orthodox"
"359225",21,24,163,165,163,173,125,124,12,15,0,1,8,5,"win_A",-3,-2,-10,1,0,0,0,0,1,0.9375,0.666666666666667,0.3125,0,"orthodox"
"359272",28,21,160,163,160,160,128,128,85,63,18,18,22,9,"win_A",7,-3,0,0,0,0,0,0,0.825242718446602,0.777777777777778,0.213592233009709,0.111111111111111,0,"orthodox"
"359286",27,20,160,163,160,160,128,128,76,48,14,13,22,7,"win_B",7,-3,0,0,0,0,0,0,0.844444444444444,0.786885245901639,0.244444444444444,0.114754098360656,1,"orthodox"
"360174",28,25,193,188,208,193,255,201,36,27,8,5,25,23,"win_B",3,5,15,54,0,0,1,0,0.818181818181818,0.84375,0.568181818181818,0.71875,1,"orthodox"
"360188",26,32,193,189,208,185,246,208,22,43,4,28,17,17,"win_A",-6,4,23,38,0,0,1,0,0.846153846153846,0.605633802816901,0.653846153846154,0.23943661971831,0,"orthodox"
"360330",32,36,183,175,191,183,154,155,34,26,10,87,12,18,"win_A",-4,8,8,-1,0,1,0,0,0.772727272727273,0.230088495575221,0.272727272727273,0.15929203539823,0,"orthodox"
"360336",27,28,183,182,191,183,151,153,28,16,7,4,11,6,"win_A",-1,1,8,-2,0,0,0,0,0.8,0.8,0.314285714285714,0.3,0,"orthodox"
"360337",27,25,183,178,191,188,154,153,26,15,7,1,9,6,"win_A",2,5,3,1,0,0,0,0,0.787878787878788,0.9375,0.272727272727273,0.375,0,"orthodox"
"360338",26,25,183,178,191,188,154,154,25,35,7,1,9,22,"win_A",1,5,3,0,0,0,0,0,0.78125,0.972222222222222,0.28125,0.611111111111111,0,"orthodox"
"360339",26,30,183,165,191,175,155,155,24,15,7,11,8,4,"win_A",-4,18,16,0,0,0,0,0,0.774193548387097,0.576923076923077,0.258064516129032,0.153846153846154,0,"orthodox"
"360341",26,29,183,178,191,188,155,158,22,42,6,5,7,26,"win_B",-3,5,3,-3,0,0,0,0,0.785714285714286,0.893617021276596,0.25,0.553191489361702,1,"orthodox"
"360346",25,28,183,171,191,184,155,153,18,43,5,6,4,28,"win_B",-3,12,7,2,0,0,0,0,0.782608695652174,0.877551020408163,0.173913043478261,0.571428571428571,1,"orthodox"
"360349",23,26,183,178,191,188,156,157,15,38,3,2,4,23,"win_A",-3,5,3,-1,0,0,0,0,0.833333333333333,0.95,0.222222222222222,0.575,0,"orthodox"
"361232",35,35,165,165,166,170,124,122,21,41,9,26,16,31,"win_A",0,0,-4,2,1,1,0,0,0.7,0.611940298507463,0.533333333333333,0.462686567164179,0,"orthodox"
"361239",20,28,165,165,180,170,123,123,19,40,1,20,15,31,"win_A",-8,0,10,0,0,0,0,0,0.95,0.666666666666667,0.75,0.516666666666667,0,"southpaw"
"361241",27,21,165,168,170,168,115,115,40,14,15,0,31,11,"win_B",6,-3,2,0,0,0,0,0,0.727272727272727,1,0.563636363636364,0.785714285714286,1,"orthodox"
"361244",26,28,165,161,170,173,113,110,37,15,12,9,29,8,"win_A",-2,4,-3,3,0,0,0,0,0.755102040816326,0.625,0.591836734693878,0.333333333333333,0,"orthodox"
"361247",30,25,170,165,178,170,112,111,12,35,3,10,7,28,"win_A",5,5,8,1,0,0,0,0,0.8,0.777777777777778,0.466666666666667,0.622222222222222,0,"orthodox"
"361252",23,24,157,165,173,170,112,112,13,30,8,8,5,24,"win_B",-1,-8,3,0,0,0,0,0,0.619047619047619,0.789473684210526,0.238095238095238,0.631578947368421,1,"orthodox"
"361257",22,21,165,157,170,173,112,112,24,13,5,1,21,5,"win_A",1,8,-3,0,0,0,0,0,0.827586206896552,0.928571428571429,0.724137931034483,0.357142857142857,0,"orthodox"
"361599",30,23,191,189,196,188,203,225,73,30,11,13,61,17,"win_B",7,2,8,-22,0,0,0,1,0.869047619047619,0.697674418604651,0.726190476190476,0.395348837209302,1,"orthodox"
"361607",21,29,189,196,188,211,206,212,22,26,11,6,14,17,"win_A",-8,-7,-23,-6,0,0,0,0,0.666666666666667,0.8125,0.424242424242424,0.53125,0,"orthodox"
"361919",19,39,170,163,175,157,138,139,15,23,0,14,11,11,"win_A",-20,7,18,-1,0,1,0,0,1,0.621621621621622,0.733333333333333,0.297297297297297,0,"orthodox"
"361924",29,22,163,165,157,170,134,133,17,11,4,1,9,9,"win_A",7,-2,-13,1,0,0,0,0,0.80952380952381,0.916666666666667,0.428571428571429,0.75,0,"orthodox"
"361932",20,24,170,163,180,157,132,133,10,10,0,0,7,3,"win_A",-4,7,23,-1,0,0,0,0,1,1,0.7,0.3,0,"orthodox"
"361939",21,24,163,170,157,173,135,136,3,3,0,0,1,3,"win_A",-3,-7,-16,-1,0,0,0,0,1,1,0.333333333333333,1,0,"orthodox"
"361949",22,32,179,177,185,180,174,175,35,139,11,45,28,90,"win_A",-10,2,5,-1,0,0,0,0,0.760869565217391,0.755434782608696,0.608695652173913,0.489130434782609,0,"orthodox"
"361954",21,32,179,177,185,180,174,174,31,137,10,43,25,89,"win_A",-11,2,5,0,0,0,0,0,0.75609756097561,0.761111111111111,0.609756097560976,0.494444444444444,0,"orthodox"
"362091",31,35,180,179,175,188,158,158,36,26,8,5,29,16,"win_B",-4,1,-13,0,0,1,0,0,0.818181818181818,0.838709677419355,0.659090909090909,0.516129032258065,1,"orthodox"
"362098",34,26,173,180,183,175,153,154,38,31,9,5,26,25,"win_A",8,-7,8,-1,0,0,0,0,0.808510638297872,0.861111111111111,0.553191489361702,0.694444444444444,0,"orthodox"
"362099",26,30,180,173,175,180,152,153,30,23,5,1,25,14,"win_A",-4,7,-5,-1,0,0,0,0,0.857142857142857,0.958333333333333,0.714285714285714,0.583333333333333,0,"orthodox"
"362100",26,33,180,173,175,173,157,154,29,14,5,0,24,13,"win_A",-7,7,2,3,0,0,0,0,0.852941176470588,1,0.705882352941177,0.928571428571429,0,"orthodox"
"362101",26,30,180,175,175,180,156,156,28,17,5,2,24,13,"win_A",-4,5,-5,0,0,0,0,0,0.848484848484849,0.894736842105263,0.727272727272727,0.684210526315789,0,"orthodox"
"362229",33,26,170,170,178,168,118,118,18,16,4,9,11,6,"win_A",7,0,10,0,0,0,0,0,0.818181818181818,0.64,0.5,0.24,0,"orthodox"
"362234",23,30,157,170,168,178,111,111,17,13,4,3,7,8,"win_B",-7,-13,-10,0,0,0,0,0,0.80952380952381,0.8125,0.333333333333333,0.5,1,"orthodox"
"362237",28,22,170,157,178,173,113,115,9,13,2,5,6,5,"win_A",6,13,5,-2,0,0,0,0,0.818181818181818,0.722222222222222,0.545454545454545,0.277777777777778,0,"orthodox"
"362385",32,35,178,185,191,193,200,200,19,35,5,5,16,22,"win_A",-3,-7,-2,0,0,1,0,0,0.791666666666667,0.875,0.666666666666667,0.55,0,"orthodox"
"362390",31,33,185,188,193,198,190,190,29,28,3,4,20,23,"win_A",-2,-3,-5,0,0,0,0,0,0.90625,0.875,0.625,0.71875,0,"orthodox"
"362391",31,29,185,180,193,185,189,189,28,10,3,1,19,6,"win_A",2,5,8,0,0,0,0,0,0.903225806451613,0.909090909090909,0.612903225806452,0.545454545454545,0,"orthodox"
"362403",26,27,185,185,193,198,191,194,16,11,0,0,12,7,"win_A",-1,0,-5,-3,0,0,0,0,1,1,0.75,0.636363636363636,0,"orthodox"
