"","age_A","age_B","height_A","height_B","reach_A","reach_B","weight_A","weight_B","won_A","won_B","lost_A","lost_B","kos_A","kos_B","AdvAgeA","AdvHeightA","AdvReachA","AdvWgtA","Over35AgeA","Over35AgeB","Over15lbA","Over15lbB","WinPA","WinPB","KoAPer","KoBPer","binaryresult","stance"
"5575",26,26,172,170,175,175,147,148,30,19,3,0,20,7,0,2,0,-1,0,0,0,0,0.909090909090909,1,0.606060606060606,0.368421052631579,"0","southpaw"
"5059",31,21,180,180,185,188,140,141,37,16,7,0,16,13,10,0,-3,-1,0,0,0,0,0.840909090909091,1,0.363636363636364,0.8125,"0","orthodox"
"3909",28,28,168,158,172,159,105,105,21,24,0,4,15,10,0,10,13,0,0,0,0,0,1,0.857142857142857,0.714285714285714,0.357142857142857,"0","southpaw"
"820",27,23,170,171,175,179,126,126,35,21,1,0,15,11,4,-1,-4,0,0,0,0,0,0.972222222222222,1,0.416666666666667,0.523809523809524,"0","southpaw"
"3405",30,22,167,175,173,173,134,135,78,41,19,3,29,27,8,-8,0,-1,0,0,0,0,0.804123711340206,0.931818181818182,0.298969072164948,0.613636363636364,"0","southpaw"
"501",27,31,157,165,160,168,112,112,28,19,3,1,21,9,-4,-8,-8,0,0,0,0,0,0.903225806451613,0.95,0.67741935483871,0.45,"0","orthodox"
"5071",26,27,168,175,170,183,135,135,18,26,0,1,9,19,-1,-7,-13,0,0,0,0,0,1,0.962962962962963,0.5,0.703703703703704,"0","orthodox"
"2298",29,35,179,183,184,183,183,182,35,15,5,12,22,7,-6,-4,1,1,0,1,0,0,0.875,0.555555555555556,0.55,0.259259259259259,"0","orthodox"
"2613",37,28,189,188,198,198,221,224,36,36,4,3,25,27,9,1,0,-3,1,0,0,0,0.9,0.923076923076923,0.625,0.692307692307692,"0","orthodox"
"5370",31,36,188,192,191,198,220,222,33,20,3,8,32,14,-5,-4,-7,-2,0,1,0,0,0.916666666666667,0.714285714285714,0.888888888888889,0.5,"0","orthodox"
"1143",29,28,165,163,178,165,128,126,37,16,2,1,31,7,1,2,13,2,0,0,0,0,0.948717948717949,0.941176470588235,0.794871794871795,0.411764705882353,"0","southpaw"
"1450",23,22,165,165,165,155,113,112,4,3,0,0,2,1,1,0,10,1,0,0,0,0,1,1,0.5,0.333333333333333,"0","orthodox"
"1304",26,28,170,180,178,188,175,175,26,34,0,0,18,29,-2,-10,-10,0,0,0,0,0,1,1,0.692307692307692,0.852941176470588,"0","orthodox"
"2260",24,29,169,165,174,168,132,132,4,5,0,5,3,0,-5,4,6,0,0,0,0,0,1,0.5,0.75,0,"0","orthodox"
"4390",30,30,177,188,178,188,220,230,43,13,4,7,24,10,0,-11,-10,-10,0,0,0,0,0.914893617021277,0.65,0.51063829787234,0.5,"0","orthodox"
"5007",24,26,175,189,183,185,223,204,48,36,15,20,32,16,-2,-14,-2,19,0,0,1,0,0.761904761904762,0.642857142857143,0.507936507936508,0.285714285714286,"0","orthodox"
"2708",43,27,170,173,168,173,167,166,92,25,10,4,65,10,16,-3,-5,1,1,0,0,0,0.901960784313726,0.862068965517241,0.637254901960784,0.344827586206897,"0","orthodox"
"3205",28,34,190,191,206,203,209,220,27,40,0,4,19,32,-6,-1,3,-11,0,0,0,0,1,0.909090909090909,0.703703703703704,0.727272727272727,"0","orthodox"
"3659",26,23,171,163,172,168,133,132,45,39,14,15,28,19,3,8,4,1,0,0,0,0,0.76271186440678,0.722222222222222,0.474576271186441,0.351851851851852,"0","Unknown"
"3521",21,30,171,174,187,180,130,130,14,47,0,4,8,16,-9,-3,7,0,0,0,0,0,1,0.92156862745098,0.571428571428571,0.313725490196078,"0","orthodox"
"2358",30,31,173,165,185,173,134,135,31,20,2,6,15,15,-1,8,12,-1,0,0,0,0,0.939393939393939,0.769230769230769,0.454545454545455,0.576923076923077,"0","orthodox"
"678",19,26,180,160,185,170,141,142,13,4,0,4,12,0,-7,20,15,-1,0,0,0,0,1,0.5,0.923076923076923,0,"0","orthodox"
"884",25,23,170,175,170,180,148,150,2,2,0,0,1,1,2,-5,-10,-2,0,0,0,0,1,1,0.5,0.5,"0","orthodox"
"4862",24,35,188,208,198,216,225,275,26,26,0,10,26,19,-11,-20,-18,-50,0,1,0,1,1,0.722222222222222,1,0.527777777777778,"0","southpaw"
"5619",30,30,185,175,196,180,153,152,21,24,2,11,12,13,0,10,16,1,0,0,0,0,0.91304347826087,0.685714285714286,0.521739130434783,0.371428571428571,"0","southpaw"
"4276",24,27,174,170,180,175,140,139,23,29,1,1,17,27,-3,4,5,1,0,0,0,0,0.958333333333333,0.966666666666667,0.708333333333333,0.9,"0","orthodox"
"4037",33,34,171,174,178,174,147,147,39,37,7,0,30,27,-1,-3,4,0,0,0,0,0,0.847826086956522,1,0.652173913043478,0.72972972972973,"0","orthodox"
"3267",24,28,180,179,178,185,180,183,95,21,20,15,17,19,-4,1,-7,-3,0,0,0,0,0.826086956521739,0.583333333333333,0.147826086956522,0.527777777777778,"0","orthodox"
"1169",28,33,177,178,180,180,139,138,16,41,0,2,13,17,-5,-1,0,1,0,0,0,0,1,0.953488372093023,0.8125,0.395348837209302,"0","southpaw"
"4700",23,28,178,175,180,185,154,154,10,40,0,1,7,19,-5,3,-5,0,0,0,0,0,1,0.975609756097561,0.7,0.463414634146341,"0","orthodox"
"5101",27,31,173,166,180,170,117,118,35,42,2,2,22,31,-4,7,10,-1,0,0,0,0,0.945945945945946,0.954545454545455,0.594594594594595,0.704545454545455,"0","orthodox"
"1533",21,22,170,168,165,183,133,133,24,23,1,3,17,15,-1,2,-18,0,0,0,0,0,0.96,0.884615384615385,0.68,0.576923076923077,"0","Unknown"
"1700",18,19,161,155,166,155,113,113,11,6,0,3,7,4,-1,6,11,0,0,0,0,0,1,0.666666666666667,0.636363636363636,0.444444444444444,"0","orthodox"
"761",22,34,169,175,173,178,137,137,17,19,0,10,11,12,-12,-6,-5,0,0,0,0,0,1,0.655172413793103,0.647058823529412,0.413793103448276,"0","orthodox"
"762",20,30,169,170,173,185,137,136,10,10,0,5,6,9,-10,-1,-12,1,0,0,0,0,1,0.666666666666667,0.6,0.6,"0","orthodox"
"4382",34,28,182,174,183,175,154,154,35,25,2,2,22,24,6,8,8,0,0,0,0,0,0.945945945945946,0.925925925925926,0.594594594594595,0.888888888888889,"0","orthodox"
"3378",25,21,182,183,185,193,178,180,81,54,14,9,12,19,4,-1,-8,-2,0,0,0,0,0.852631578947368,0.857142857142857,0.126315789473684,0.301587301587302,"0","orthodox"
"3217",29,35,168,170,178,180,126,126,56,54,3,5,39,36,-6,-2,-2,0,0,1,0,0,0.949152542372881,0.915254237288136,0.661016949152542,0.610169491525424,"0","orthodox"
"1802",20,27,173,178,180,180,141,140,2,1,1,2,1,1,-7,-5,0,1,0,0,0,0,0.666666666666667,0.333333333333333,0.333333333333333,0.333333333333333,"0","orthodox"
"933",32,37,202,203,208,208,247,256,26,49,0,4,14,44,-5,-1,0,-9,0,1,0,0,1,0.924528301886792,0.538461538461538,0.830188679245283,"0","orthodox"
"4713",35,27,188,185,208,196,248,228,36,10,7,10,27,8,8,3,12,20,1,0,1,0,0.837209302325581,0.5,0.627906976744186,0.4,"0","orthodox"
"3248",33,32,179,180,183,184,160,160,48,42,3,1,25,35,1,-1,-1,0,0,0,0,0,0.941176470588235,0.976744186046512,0.490196078431373,0.813953488372093,"0","southpaw"
"2468",29,31,178,183,183,188,153,153,21,19,5,13,10,12,-2,-5,-5,0,0,0,0,0,0.807692307692308,0.59375,0.384615384615385,0.375,"0","orthodox"
"414",29,27,165,168,164,167,118,118,14,46,0,29,8,25,2,-3,-3,0,0,0,0,0,1,0.613333333333333,0.571428571428571,0.333333333333333,"0","southpaw"
"3216",31,31,168,173,178,175,130,130,60,25,4,2,42,14,0,-5,3,0,0,0,0,0,0.9375,0.925925925925926,0.65625,0.518518518518518,"0","orthodox"
"3101",27,25,178,171,183,168,130,129,58,43,5,8,48,32,2,7,15,1,0,0,0,0,0.920634920634921,0.843137254901961,0.761904761904762,0.627450980392157,"0","orthodox"
"720",28,31,192,168,191,188,179,178,15,23,0,18,12,15,-3,24,3,1,0,0,0,0,1,0.560975609756098,0.8,0.365853658536585,"0","orthodox"
"5067",22,33,175,179,185,187,180,158,2,41,10,23,1,16,-11,-4,-2,22,0,0,1,0,0.166666666666667,0.640625,0.0833333333333333,0.25,"0","Unknown"
"5166",22,32,173,172,173,193,135,136,24,33,2,15,18,20,-10,1,-20,-1,0,0,0,0,0.923076923076923,0.6875,0.692307692307692,0.416666666666667,"0","orthodox"
"5867",26,38,188,183,206,191,226,234,25,21,0,18,19,12,-12,5,15,-8,0,1,0,0,1,0.538461538461538,0.76,0.307692307692308,"0","orthodox"
"994",33,33,166,170,166,173,118,117,28,34,4,8,22,25,0,-4,-7,1,0,0,0,0,0.875,0.80952380952381,0.6875,0.595238095238095,"0","orthodox"
"2836",28,22,183,180,193,188,188,192,74,20,1,7,46,13,6,3,5,-4,0,0,0,0,0.986666666666667,0.740740740740741,0.613333333333333,0.481481481481481,"0","orthodox"
"109",24,35,189,177,191,183,168,168,31,27,0,4,24,14,-11,12,8,0,0,1,0,0,1,0.870967741935484,0.774193548387097,0.451612903225806,"0","southpaw"
"521",25,27,173,175,178,175,140,140,9,15,0,1,3,7,-2,-2,3,0,0,0,0,0,1,0.9375,0.333333333333333,0.4375,"0","southpaw"
"5987",29,31,177,175,175,183,155,154,15,25,0,6,11,12,-2,2,-8,1,0,0,0,0,1,0.806451612903226,0.733333333333333,0.387096774193548,"0","southpaw"
"2576",23,29,180,179,191,184,159,160,39,85,4,19,30,51,-6,1,7,-1,0,0,0,0,0.906976744186046,0.817307692307692,0.697674418604651,0.490384615384615,"0","orthodox"
"350",20,16,170,168,175,170,119,118,5,4,0,1,3,1,4,2,5,1,0,0,0,0,1,0.8,0.6,0.2,"0","orthodox"
"920",27,36,175,185,183,208,160,161,12,10,0,26,9,7,-9,-10,-25,-1,0,1,0,0,1,0.277777777777778,0.75,0.194444444444444,"0","orthodox"
"1852",31,24,179,166,170,173,131,130,29,14,6,19,15,11,7,13,-3,1,0,0,0,0,0.828571428571429,0.424242424242424,0.428571428571429,0.333333333333333,"0","orthodox"
"1776",23,39,160,163,163,173,127,128,5,10,0,39,4,1,-16,-3,-10,-1,0,1,0,0,1,0.204081632653061,0.8,0.0204081632653061,"0","orthodox"
"5664",29,48,173,175,178,185,150,148,8,105,0,17,7,65,-19,-2,-7,2,0,1,0,0,1,0.860655737704918,0.875,0.532786885245902,"0","orthodox"
"2874",19,24,179,173,182,180,155,164,43,97,9,16,6,11,-5,6,2,-9,0,0,0,0,0.826923076923077,0.858407079646018,0.115384615384615,0.0973451327433628,"0","orthodox"
"539",29,34,178,191,171,196,216,236,3,2,0,1,2,1,-5,-13,-25,-20,0,0,0,1,1,0.666666666666667,0.666666666666667,0.333333333333333,"0","southpaw"
"5722",26,30,185,178,191,183,174,173,23,30,4,3,17,21,-4,7,8,1,0,0,0,0,0.851851851851852,0.909090909090909,0.62962962962963,0.636363636363636,"0","Unknown"
"2274",21,20,170,172,174,173,122,122,3,2,2,0,1,0,1,-2,1,0,0,0,0,0,0.6,1,0.2,0,"0","southpaw"
"1615",21,20,173,163,173,173,145,144,9,3,0,1,6,1,1,10,0,1,0,0,0,0,1,0.75,0.666666666666667,0.25,"0","orthodox"
"5395",30,36,178,191,178,191,252,247,41,19,3,5,36,13,-6,-13,-13,5,0,1,0,0,0.931818181818182,0.791666666666667,0.818181818181818,0.541666666666667,"0","orthodox"
"2068",20,30,178,177,185,180,153,153,6,6,0,0,0,4,-10,1,5,0,0,0,0,0,1,1,0,0.666666666666667,"0","orthodox"
"4328",31,21,183,185,185,191,182,166,3,5,0,0,2,4,10,-2,-6,16,0,0,1,0,1,1,0.666666666666667,0.8,"0","orthodox"
"524",24,22,175,183,175,196,147,147,6,6,0,7,3,6,2,-8,-21,0,0,0,0,0,1,0.461538461538462,0.5,0.461538461538462,"0","orthodox"
"2146",23,29,170,185,178,192,136,136,17,14,1,6,15,5,-6,-15,-14,0,0,0,0,0,0.944444444444444,0.7,0.833333333333333,0.25,"0","orthodox"
"3310",36,28,178,178,188,191,176,172,70,56,9,18,31,37,8,0,-3,4,1,0,0,0,0.886075949367089,0.756756756756757,0.392405063291139,0.5,"0","orthodox"
"5803",38,29,201,187,218,203,248,224,37,16,1,6,23,14,9,14,15,24,1,0,1,0,0.973684210526316,0.727272727272727,0.605263157894737,0.636363636363636,"0","orthodox"
"2731",35,30,185,180,198,196,184,186,52,19,4,2,42,18,5,5,2,-2,1,0,0,0,0.928571428571429,0.904761904761905,0.75,0.857142857142857,"0","orthodox"
"2854",27,33,166,156,170,163,130,134,67,187,11,38,39,70,-6,10,7,-4,0,0,0,0,0.858974358974359,0.831111111111111,0.5,0.311111111111111,"0","orthodox"
"1649",27,35,185,175,196,183,168,165,18,12,0,8,8,6,-8,10,13,3,0,1,0,0,1,0.6,0.444444444444444,0.3,"0","Unknown"
"2686",34,22,165,170,173,175,129,128,36,33,2,1,26,16,12,-5,-2,1,0,0,0,0,0.947368421052632,0.970588235294118,0.684210526315789,0.470588235294118,"0","orthodox"
"4674",24,27,165,168,175,178,126,126,20,25,0,0,14,15,-3,-3,-3,0,0,0,0,0,1,1,0.7,0.6,"0","orthodox"
"4913",37,29,192,188,211,196,235,228,35,19,5,5,22,14,8,4,15,7,1,0,0,0,0.875,0.791666666666667,0.55,0.583333333333333,"0","orthodox"
"5167",21,27,173,175,173,188,135,135,22,24,0,0,16,20,-6,-2,-15,0,0,0,0,0,1,1,0.727272727272727,0.833333333333333,"0","orthodox"
"431",26,32,160,152,165,154,105,105,26,24,1,5,9,14,-6,8,11,0,0,0,0,0,0.962962962962963,0.827586206896552,0.333333333333333,0.482758620689655,"0","orthodox"
"615",20,24,168,165,170,165,130,130,28,10,0,5,22,3,-4,3,5,0,0,0,0,0,1,0.666666666666667,0.785714285714286,0.2,"0","orthodox"
"480",29,30,177,170,183,173,156,156,29,24,2,3,16,14,-1,7,10,0,0,0,0,0,0.935483870967742,0.888888888888889,0.516129032258065,0.518518518518518,"0","southpaw"
"710",28,30,183,185,180,194,168,168,25,31,0,1,13,17,-2,-2,-14,0,0,0,0,0,1,0.96875,0.52,0.53125,"0","orthodox"
"829",28,29,175,165,175,170,122,121,21,26,0,13,15,13,-1,10,5,1,0,0,0,0,1,0.666666666666667,0.714285714285714,0.333333333333333,"0","orthodox"
"5909",24,35,173,170,175,180,126,126,25,32,0,10,19,20,-11,3,-5,0,0,1,0,0,1,0.761904761904762,0.76,0.476190476190476,"0","orthodox"
"6000",22,27,168,165,168,165,131,132,12,11,0,4,6,5,-5,3,3,-1,0,0,0,0,1,0.733333333333333,0.5,0.333333333333333,"0","orthodox"
"2645",32,33,188,180,193,178,213,185,82,33,7,20,51,12,-1,8,15,28,0,0,1,0,0.921348314606742,0.622641509433962,0.573033707865168,0.226415094339623,"0","orthodox"
"5943",25,21,177,183,175,188,156,156,9,9,0,0,6,4,4,-6,-13,0,0,0,0,0,1,1,0.666666666666667,0.444444444444444,"0","orthodox"
"3090",28,28,170,173,170,175,125,125,37,20,2,1,29,10,0,-3,-5,0,0,0,0,0,0.948717948717949,0.952380952380952,0.743589743589744,0.476190476190476,"0","orthodox"
"2534",27,31,182,180,185,183,150,158,16,32,1,13,12,29,-4,2,2,-8,0,0,0,0,0.941176470588235,0.711111111111111,0.705882352941177,0.644444444444444,"0","orthodox"
"1285",28,34,175,180,188,183,150,149,22,39,1,35,17,34,-6,-5,5,1,0,0,0,0,0.956521739130435,0.527027027027027,0.739130434782609,0.459459459459459,"0","orthodox"
"5209",26,30,185,178,194,191,182,173,20,21,5,8,17,18,-4,7,3,9,0,0,0,0,0.8,0.724137931034483,0.68,0.620689655172414,"0","orthodox"
"807",26,29,191,178,188,178,153,153,20,32,1,2,12,16,-3,13,10,0,0,0,0,0,0.952380952380952,0.941176470588235,0.571428571428571,0.470588235294118,"0","orthodox"
"1805",28,27,175,180,175,188,135,135,8,2,2,4,4,0,1,-5,-13,0,0,0,0,0,0.8,0.333333333333333,0.4,0,"0","Unknown"
"1957",20,27,163,161,165,168,108,108,12,18,1,6,10,13,-7,2,-3,0,0,0,0,0,0.923076923076923,0.75,0.769230769230769,0.541666666666667,"0","southpaw"
"5350",29,33,188,180,201,181,175,175,38,18,3,3,23,9,-4,8,20,0,0,0,0,0,0.926829268292683,0.857142857142857,0.560975609756098,0.428571428571429,"0","orthodox"
"3239",35,27,173,171,178,175,145,145,190,204,40,33,29,62,8,2,3,0,1,0,0,0,0.826086956521739,0.860759493670886,0.126086956521739,0.261603375527426,"0","orthodox"
"6056",30,27,178,174,175,173,153,152,19,19,7,12,14,16,3,4,2,1,0,0,0,0,0.730769230769231,0.612903225806452,0.538461538461538,0.516129032258065,"0","Unknown"
"4736",19,21,172,168,175,173,124,126,7,8,2,2,2,6,-2,4,2,-2,0,0,0,0,0.777777777777778,0.8,0.222222222222222,0.6,"0","orthodox"
"2332",26,34,185,188,187,201,186,189,12,41,4,6,10,25,-8,-3,-14,-3,0,0,0,0,0.75,0.872340425531915,0.625,0.531914893617021,"0","orthodox"
"2741",31,24,165,159,165,163,105,105,46,25,0,1,35,18,7,6,2,0,0,0,0,0,1,0.961538461538462,0.760869565217391,0.692307692307692,"0","orthodox"
"991",20,21,170,177,185,175,135,135,12,16,1,1,3,9,-1,-7,10,0,0,0,0,0,0.923076923076923,0.941176470588235,0.230769230769231,0.529411764705882,"0","orthodox"
"5838",32,33,193,180,201,185,160,159,22,31,1,5,12,27,-1,13,16,1,0,0,0,0,0.956521739130435,0.861111111111111,0.521739130434783,0.75,"0","orthodox"
"1414",21,32,175,168,177,170,123,125,16,24,0,8,13,9,-11,7,7,-2,0,0,0,0,1,0.75,0.8125,0.28125,"0","orthodox"
"6085",34,26,173,180,183,175,153,154,38,31,9,5,26,25,8,-7,8,-1,0,0,0,0,0.808510638297872,0.861111111111111,0.553191489361702,0.694444444444444,"0","orthodox"
"5657",25,23,164,160,168,163,118,118,28,22,4,13,16,9,2,4,5,0,0,0,0,0,0.875,0.628571428571429,0.5,0.257142857142857,"0","orthodox"
"4508",28,19,164,168,165,173,116,117,26,32,9,3,14,18,9,-4,-8,-1,0,0,0,0,0.742857142857143,0.914285714285714,0.4,0.514285714285714,"0","orthodox"
"3618",21,20,189,197,206,218,194,205,20,5,2,6,16,2,1,-8,-12,-11,0,0,0,0,0.909090909090909,0.454545454545455,0.727272727272727,0.181818181818182,"0","orthodox"
"2952",24,30,196,189,206,198,205,235,31,28,0,0,27,22,-6,7,8,-30,0,0,0,1,1,1,0.870967741935484,0.785714285714286,"0","orthodox"
"2914",27,40,180,185,189,191,160,159,24,46,0,3,17,32,-13,-5,-2,1,0,1,0,0,1,0.938775510204082,0.708333333333333,0.653061224489796,"0","orthodox"
"1248",30,28,166,166,164,170,112,112,25,31,0,1,20,23,2,0,-6,0,0,0,0,0,1,0.96875,0.8,0.71875,"0","southpaw"
"1774",22,18,179,170,178,167,150,150,7,5,0,2,4,4,4,9,11,0,0,0,0,0,1,0.714285714285714,0.571428571428571,0.571428571428571,"0","orthodox"
"593",26,32,170,163,180,160,126,126,25,17,1,4,10,10,-6,7,20,0,0,0,0,0,0.961538461538462,0.80952380952381,0.384615384615385,0.476190476190476,"0","orthodox"
"5484",27,26,193,188,203,198,240,250,30,23,2,13,24,23,1,5,5,-10,0,0,0,0,0.9375,0.638888888888889,0.75,0.638888888888889,"0","orthodox"
"3",23,31,175,175,179,188,155,155,43,19,1,1,31,12,-8,0,-9,0,0,0,0,0,0.977272727272727,0.95,0.704545454545455,0.6,"0","orthodox"
"96",29,34,183,189,184,193,175,175,19,21,0,4,17,8,-5,-6,-9,0,0,0,0,0,1,0.84,0.894736842105263,0.32,"0","orthodox"
"1356",31,22,160,157,168,157,112,112,29,13,3,0,25,11,9,3,11,0,0,0,0,0,0.90625,1,0.78125,0.846153846153846,"0","southpaw"
"5070",28,39,174,168,174,170,146,145,14,40,0,9,12,19,-11,6,4,1,0,1,0,0,1,0.816326530612245,0.857142857142857,0.387755102040816,"0","southpaw"
"5470",26,30,165,173,178,173,126,130,23,6,1,15,14,2,-4,-8,5,-4,0,0,0,0,0.958333333333333,0.285714285714286,0.583333333333333,0.0952380952380952,"0","orthodox"
"3936",23,34,188,180,188,183,190,197,10,33,0,10,10,17,-11,8,5,-7,0,0,0,0,1,0.767441860465116,1,0.395348837209302,"0","southpaw"
"4432",28,38,185,182,198,196,167,168,30,48,5,5,20,28,-10,3,2,-1,0,1,0,0,0.857142857142857,0.905660377358491,0.571428571428571,0.528301886792453,"0","orthodox"
"2521",23,42,175,180,189,183,154,154,10,69,0,70,8,56,-19,-5,6,0,0,1,0,0,1,0.496402877697842,0.8,0.402877697841727,"0","orthodox"
"2831",19,30,173,170,183,178,120,122,22,33,0,3,18,21,-11,3,5,-2,0,0,0,0,1,0.916666666666667,0.818181818181818,0.583333333333333,"0","orthodox"
"2871",28,34,190,191,206,203,209,220,27,40,0,4,19,32,-6,-1,3,-11,0,0,0,0,1,0.909090909090909,0.703703703703704,0.727272727272727,"0","orthodox"
"5529",24,31,188,188,196,188,228,228,9,14,0,12,9,10,-7,0,8,0,0,0,0,0,1,0.538461538461538,1,0.384615384615385,"0","orthodox"
"2583",38,33,185,175,191,184,160,159,42,34,2,2,31,25,5,10,7,1,1,0,0,0,0.954545454545455,0.944444444444444,0.704545454545455,0.694444444444444,"0","orthodox"
"1322",19,20,175,175,177,173,130,133,3,3,0,0,3,3,-1,0,4,-3,0,0,0,0,1,1,1,1,"0","orthodox"
"5760",30,31,191,188,206,188,249,236,22,14,1,10,15,10,-1,3,18,13,0,0,0,0,0.956521739130435,0.583333333333333,0.652173913043478,0.416666666666667,"0","orthodox"
"590",21,37,178,170,185,178,144,143,11,37,0,17,10,22,-16,8,7,1,0,1,0,0,1,0.685185185185185,0.909090909090909,0.407407407407407,"0","orthodox"
"2833",32,27,185,183,213,180,189,213,33,38,1,2,23,29,5,2,33,-24,0,0,0,1,0.970588235294118,0.95,0.676470588235294,0.725,"0","orthodox"
"3135",37,31,173,178,180,188,167,173,55,39,17,2,26,27,6,-5,-8,-6,1,0,0,0,0.763888888888889,0.951219512195122,0.361111111111111,0.658536585365854,"0","orthodox"
"1930",34,38,185,179,196,188,156,156,30,27,12,8,18,16,-4,6,8,0,0,1,0,0,0.714285714285714,0.771428571428571,0.428571428571429,0.457142857142857,"0","orthodox"
"3795",20,20,171,173,175,180,142,145,28,51,2,2,7,14,0,-2,-5,-3,0,0,0,0,0.933333333333333,0.962264150943396,0.233333333333333,0.264150943396226,"0","Unknown"
"2789",26,33,174,170,180,170,135,135,26,45,0,4,24,30,-7,4,10,0,0,0,0,0,1,0.918367346938776,0.923076923076923,0.612244897959184,"0","orthodox"
"5522",25,34,188,182,196,183,223,258,18,20,0,24,16,9,-9,6,13,-35,0,0,0,1,1,0.454545454545455,0.888888888888889,0.204545454545455,"0","orthodox"
"2569",32,35,180,173,191,193,175,184,98,183,17,53,71,110,-3,7,-2,-9,0,1,0,0,0.852173913043478,0.775423728813559,0.617391304347826,0.466101694915254,"0","orthodox"
"1697",25,27,171,173,182,180,135,135,20,17,4,14,18,7,-2,-2,2,0,0,0,0,0,0.833333333333333,0.548387096774194,0.75,0.225806451612903,"0","orthodox"
"4198",23,33,197,187,216,202,262,250,33,68,2,15,28,55,-10,10,14,12,0,0,0,0,0.942857142857143,0.819277108433735,0.8,0.662650602409639,"0","orthodox"
"4475",27,33,180,161,183,170,130,130,28,25,0,5,14,12,-6,19,13,0,0,0,0,0,1,0.833333333333333,0.5,0.4,"0","orthodox"
"2030",24,29,201,180,218,183,246,265,23,26,0,12,16,21,-5,21,35,-19,0,0,0,1,1,0.684210526315789,0.695652173913043,0.552631578947368,"0","orthodox"
"4756",21,37,173,165,185,165,134,131,37,99,7,33,19,19,-16,8,20,3,0,1,0,0,0.840909090909091,0.75,0.431818181818182,0.143939393939394,"0","orthodox"
"3937",24,28,175,178,185,189,161,162,59,33,3,6,30,20,-4,-3,-4,-1,0,0,0,0,0.951612903225806,0.846153846153846,0.483870967741935,0.512820512820513,"0","orthodox"
"2965",33,29,171,180,188,201,190,176,118,114,15,8,69,64,4,-9,-13,14,0,0,0,0,0.887218045112782,0.934426229508197,0.518796992481203,0.524590163934426,"0","orthodox"
"2461",42,37,193,188,203,188,240,248,53,16,6,12,47,13,5,5,15,-8,1,1,0,0,0.898305084745763,0.571428571428571,0.796610169491525,0.464285714285714,"0","orthodox"
"3896",29,29,171,166,180,173,135,135,22,12,0,0,16,3,0,5,7,0,0,0,0,0,1,1,0.727272727272727,0.25,"0","southpaw"
"743",23,36,183,175,193,188,163,164,9,15,0,13,6,5,-13,8,5,-1,0,1,0,0,1,0.535714285714286,0.666666666666667,0.178571428571429,"0","orthodox"
"2004",34,22,163,168,165,177,122,122,37,17,7,2,26,3,12,-5,-12,0,0,0,0,0,0.840909090909091,0.894736842105263,0.590909090909091,0.157894736842105,"0","southpaw"
"1687",24,24,168,165,175,170,130,130,25,19,0,2,25,10,0,3,5,0,0,0,0,0,1,0.904761904761905,1,0.476190476190476,"0","orthodox"
"3229",32,29,196,193,213,201,244,244,31,28,1,2,25,25,3,3,12,0,0,0,0,0,0.96875,0.933333333333333,0.78125,0.833333333333333,"0","orthodox"
"5140",23,22,170,168,170,170,122,120,37,23,0,2,35,11,1,2,0,2,0,0,0,0,1,0.92,0.945945945945946,0.44,"0","orthodox"
"4903",28,38,188,191,196,201,243,235,30,22,3,16,23,11,-10,-3,-5,8,0,1,0,0,0.909090909090909,0.578947368421053,0.696969696969697,0.289473684210526,"0","orthodox"
"2556",20,24,173,174,183,175,131,132,9,18,0,3,7,14,-4,-1,8,-1,0,0,0,0,1,0.857142857142857,0.777777777777778,0.666666666666667,"0","orthodox"
"5293",23,33,166,166,170,173,132,137,32,9,3,11,17,2,-10,0,-3,-5,0,0,0,0,0.914285714285714,0.45,0.485714285714286,0.1,"0","orthodox"
"4889",25,32,173,165,173,173,139,138,22,37,1,10,10,19,-7,8,0,1,0,0,0,0,0.956521739130435,0.787234042553192,0.434782608695652,0.404255319148936,"0","orthodox"
"2250",21,39,173,161,175,170,138,139,26,43,0,11,15,21,-18,12,5,-1,0,1,0,0,1,0.796296296296296,0.576923076923077,0.388888888888889,"0","southpaw"
"2862",29,45,188,190,208,206,236,231,25,61,5,4,18,40,-16,-2,2,5,0,1,0,0,0.833333333333333,0.938461538461538,0.6,0.615384615384615,"0","orthodox"
"4813",36,27,193,198,208,201,238,238,19,12,8,2,14,7,9,-5,7,0,1,0,0,0,0.703703703703704,0.857142857142857,0.518518518518518,0.5,"0","orthodox"
"4764",27,35,170,175,178,170,126,126,21,45,1,7,13,28,-8,-5,8,0,0,1,0,0,0.954545454545455,0.865384615384615,0.590909090909091,0.538461538461538,"0","orthodox"
"2817",28,26,168,183,175,188,140,139,29,28,1,1,14,26,2,-15,-13,1,0,0,0,0,0.966666666666667,0.96551724137931,0.466666666666667,0.896551724137931,"0","southpaw"
"840",24,25,175,175,175,185,155,156,15,7,3,4,8,4,-1,0,-10,-1,0,0,0,0,0.833333333333333,0.636363636363636,0.444444444444444,0.363636363636364,"0","orthodox"
"3250",26,28,180,185,184,191,147,147,34,36,0,1,29,27,-2,-5,-7,0,0,0,0,0,1,0.972972972972973,0.852941176470588,0.72972972972973,"0","orthodox"
"4910",23,31,188,191,196,203,248,237,18,20,0,5,17,9,-8,-3,-7,11,0,0,0,0,1,0.8,0.944444444444444,0.36,"0","orthodox"
"425",23,23,187,178,192,185,160,162,20,14,0,0,11,8,0,9,7,-2,0,0,0,0,1,1,0.55,0.571428571428571,"0","orthodox"
"2857",51,49,190,185,206,198,255,234,67,41,6,17,43,28,2,5,8,21,1,1,1,0,0.917808219178082,0.706896551724138,0.589041095890411,0.482758620689655,"0","orthodox"
"5074",30,27,199,187,211,196,224,204,9,13,2,3,7,9,3,12,15,20,0,0,1,0,0.818181818181818,0.8125,0.636363636363636,0.5625,"0","orthodox"
"5851",34,23,191,183,196,193,252,207,50,16,1,1,34,10,11,8,3,45,0,0,1,0,0.980392156862745,0.941176470588235,0.666666666666667,0.588235294117647,"0","orthodox"
"3550",27,27,192,187,199,203,229,223,42,18,1,3,39,11,0,5,-4,6,0,0,0,0,0.976744186046512,0.857142857142857,0.906976744186046,0.523809523809524,"0","orthodox"
"5419",31,26,177,185,182,198,193,193,37,21,3,0,30,15,5,-8,-16,0,0,0,0,0,0.925,1,0.75,0.714285714285714,"0","orthodox"
"6071",26,30,183,165,191,175,155,155,24,15,7,11,8,4,-4,18,16,0,0,0,0,0,0.774193548387097,0.576923076923077,0.258064516129032,0.153846153846154,"0","orthodox"
"4883",22,27,178,163,180,163,130,134,32,56,3,14,4,10,-5,15,17,-4,0,0,0,0,0.914285714285714,0.8,0.114285714285714,0.142857142857143,"0","Unknown"
"1090",18,28,171,175,165,183,141,141,2,4,0,9,2,1,-10,-4,-18,0,0,0,0,0,1,0.307692307692308,1,0.0769230769230769,"0","orthodox"
"2529",34,37,180,168,183,170,140,137,43,31,39,41,36,19,-3,12,13,3,0,1,0,0,0.524390243902439,0.430555555555556,0.439024390243902,0.263888888888889,"0","orthodox"
"1768",25,36,198,180,203,188,228,216,10,18,1,18,5,5,-11,18,15,12,0,1,0,0,0.909090909090909,0.5,0.454545454545455,0.138888888888889,"0","orthodox"
"2095",27,41,188,183,190,189,242,237,15,23,9,17,11,7,-14,5,1,5,0,1,0,0,0.625,0.575,0.458333333333333,0.175,"0","southpaw"
"620",25,32,188,168,194,188,171,172,24,23,1,19,20,15,-7,20,6,-1,0,0,0,0,0.96,0.547619047619048,0.8,0.357142857142857,"0","orthodox"
"4760",27,25,182,185,180,198,168,168,22,14,1,2,16,13,2,-3,-18,0,0,0,0,0,0.956521739130435,0.875,0.695652173913043,0.8125,"0","orthodox"
"4812",38,31,193,185,208,188,237,227,31,11,9,9,25,9,7,8,20,10,1,0,0,0,0.775,0.55,0.625,0.45,"0","orthodox"
"4317",22,28,168,167,170,173,135,134,28,27,0,0,14,19,-6,1,-3,1,0,0,0,0,1,1,0.5,0.703703703703704,"0","orthodox"
"2948",34,37,196,189,213,198,217,242,34,36,1,3,27,25,-3,7,15,-25,0,1,0,1,0.971428571428571,0.923076923076923,0.771428571428571,0.641025641025641,"0","orthodox"
"5536",23,31,175,178,178,170,138,140,30,22,2,1,21,16,-8,-3,8,-2,0,0,0,0,0.9375,0.956521739130435,0.65625,0.695652173913043,"0","orthodox"
"1698",25,32,170,185,175,208,149,148,11,9,3,4,4,6,-7,-15,-33,1,0,0,0,0,0.785714285714286,0.692307692307692,0.285714285714286,0.461538461538462,"0","southpaw"
"3927",31,31,188,193,188,206,227,211,33,16,3,5,29,12,0,-5,-18,16,0,0,1,0,0.916666666666667,0.761904761904762,0.805555555555556,0.571428571428571,"0","southpaw"
"3005",24,24,173,184,180,193,150,174,101,45,9,6,21,18,0,-11,-13,-24,0,0,0,1,0.918181818181818,0.882352941176471,0.190909090909091,0.352941176470588,"0","orthodox"
"1895",32,30,178,180,183,183,203,198,60,34,4,9,38,30,2,-2,0,5,0,0,0,0,0.9375,0.790697674418605,0.59375,0.697674418604651,"0","orthodox"
"4671",25,35,165,180,175,185,127,128,23,36,1,9,16,28,-10,-15,-10,-1,0,1,0,0,0.958333333333333,0.8,0.666666666666667,0.622222222222222,"0","orthodox"
"2867",34,23,190,184,206,193,219,200,44,10,0,0,31,6,11,6,13,19,0,0,1,0,1,1,0.704545454545455,0.6,"0","orthodox"
"1790",35,25,180,198,188,203,227,222,17,8,18,0,5,4,10,-18,-15,5,1,0,0,0,0.485714285714286,1,0.142857142857143,0.5,"0","orthodox"
"3360",32,29,185,180,196,191,179,176,45,9,3,4,29,6,3,5,5,3,0,0,0,0,0.9375,0.692307692307692,0.604166666666667,0.461538461538462,"0","southpaw"
"2286",42,31,183,165,183,178,165,164,55,29,10,29,33,25,11,18,5,1,1,0,0,0,0.846153846153846,0.5,0.507692307692308,0.431034482758621,"0","southpaw"
"1516",28,26,178,175,188,175,149,149,33,24,3,8,22,16,2,3,13,0,0,0,0,0,0.916666666666667,0.75,0.611111111111111,0.5,"0","orthodox"
"641",26,29,188,178,184,188,168,166,3,5,0,6,2,4,-3,10,-4,2,0,0,0,0,1,0.454545454545455,0.666666666666667,0.363636363636364,"0","orthodox"
"2196",30,26,188,185,191,189,221,217,20,14,2,12,10,11,4,3,2,4,0,0,0,0,0.909090909090909,0.538461538461538,0.454545454545455,0.423076923076923,"0","southpaw"
"4060",30,25,165,171,170,169,135,135,31,23,3,0,14,13,5,-6,1,0,0,0,0,0,0.911764705882353,1,0.411764705882353,0.565217391304348,"0","orthodox"
"2409",31,27,163,160,163,165,118,117,28,14,1,12,20,1,4,3,-2,1,0,0,0,0,0.96551724137931,0.538461538461538,0.689655172413793,0.0384615384615385,"0","orthodox"
"4531",36,31,192,191,198,198,237,231,38,16,4,3,24,12,5,1,0,6,1,0,0,0,0.904761904761905,0.842105263157895,0.571428571428571,0.631578947368421,"0","orthodox"
"1376",23,38,168,175,188,180,163,160,8,6,2,22,5,3,-15,-7,8,3,0,1,0,0,0.8,0.214285714285714,0.5,0.107142857142857,"0","orthodox"
"4505",41,20,173,171,178,184,144,144,38,18,20,0,16,14,21,2,-6,0,1,0,0,0,0.655172413793103,1,0.275862068965517,0.777777777777778,"0","orthodox"
"3831",30,28,183,177,185,175,150,151,32,18,0,4,25,11,2,6,10,-1,0,0,0,0,1,0.818181818181818,0.78125,0.5,"0","orthodox"
"701",30,34,171,174,168,177,129,129,20,19,0,2,14,9,-4,-3,-9,0,0,0,0,0,1,0.904761904761905,0.7,0.428571428571429,"0","southpaw"
"66",22,28,178,178,185,183,146,147,16,33,0,1,12,27,-6,0,2,-1,0,0,0,0,1,0.970588235294118,0.75,0.794117647058823,"1","orthodox"
"201",34,24,173,179,173,170,123,123,43,17,7,2,35,11,10,-6,3,0,0,0,0,0,0.86,0.894736842105263,0.7,0.578947368421053,"1","orthodox"
"114",35,28,167,170,173,170,139,140,33,17,3,7,24,4,7,-3,3,-1,1,0,0,0,0.916666666666667,0.708333333333333,0.666666666666667,0.166666666666667,"1","orthodox"
"347",29,20,173,182,180,185,168,166,211,39,11,9,36,8,9,-9,-5,2,0,0,0,0,0.95045045045045,0.8125,0.162162162162162,0.166666666666667,"1","orthodox"
"44",28,30,173,170,174,173,126,126,22,25,1,1,16,18,-2,3,1,0,0,0,0,0,0.956521739130435,0.961538461538462,0.695652173913043,0.692307692307692,"1","southpaw"
"548",27,18,189,180,191,192,172,184,41,22,18,2,24,14,9,9,-1,-12,0,0,0,0,0.694915254237288,0.916666666666667,0.406779661016949,0.583333333333333,"1","orthodox"
"943",32,27,191,178,201,178,253,252,35,35,6,1,25,30,5,13,23,1,0,0,0,0,0.853658536585366,0.972222222222222,0.609756097560976,0.833333333333333,"1","orthodox"
"369",29,28,185,185,198,188,160,160,45,24,2,4,38,15,1,0,10,0,0,0,0,0,0.957446808510638,0.857142857142857,0.808510638297872,0.535714285714286,"1","orthodox"
"198",34,28,183,173,178,184,184,185,30,9,10,5,21,4,6,10,-6,-1,0,0,0,0,0.75,0.642857142857143,0.525,0.285714285714286,"1","orthodox"
"993",33,26,179,175,185,168,139,139,18,20,1,6,16,14,7,4,17,0,0,0,0,0,0.947368421052632,0.769230769230769,0.842105263157895,0.538461538461538,"1","orthodox"
"880",21,27,175,178,185,183,190,176,2,18,5,8,1,8,-6,-3,2,14,0,0,0,0,0.285714285714286,0.692307692307692,0.142857142857143,0.307692307692308,"1","Unknown"
"871",22,27,159,165,157,173,112,112,15,36,6,3,8,22,-5,-6,-16,0,0,0,0,0,0.714285714285714,0.923076923076923,0.380952380952381,0.564102564102564,"1","orthodox"
"964",27,24,160,157,152,152,107,107,20,23,3,6,14,13,3,3,0,0,0,0,0,0,0.869565217391304,0.793103448275862,0.608695652173913,0.448275862068966,"1","orthodox"
"32",26,27,163,161,168,170,108,108,19,26,1,5,12,14,-1,2,-2,0,0,0,0,0,0.95,0.838709677419355,0.6,0.451612903225806,"1","orthodox"
"253",18,23,178,183,179,186,157,157,1,6,3,2,0,3,-5,-5,-7,0,0,0,0,0,0.25,0.75,0,0.375,"1","orthodox"
"478",35,26,168,180,175,184,147,147,40,33,2,0,17,29,9,-12,-9,0,1,0,0,0,0.952380952380952,1,0.404761904761905,0.878787878787879,"1","southpaw"
"692",23,25,173,170,180,175,118,118,32,17,0,4,22,13,-2,3,5,0,0,0,0,0,1,0.80952380952381,0.6875,0.619047619047619,"1","orthodox"
"101",29,30,166,168,166,175,118,118,27,19,1,0,22,14,-1,-2,-9,0,0,0,0,0,0.964285714285714,1,0.785714285714286,0.736842105263158,"1","orthodox"
"1003",34,27,177,174,183,173,149,149,23,22,27,15,12,18,7,3,10,0,0,0,0,0,0.46,0.594594594594595,0.24,0.486486486486487,"1","Unknown"
"418",27,32,171,171,168,169,140,140,32,90,3,1,18,75,-5,0,-1,0,0,0,0,0,0.914285714285714,0.989010989010989,0.514285714285714,0.824175824175824,"1","orthodox"
"21",31,24,166,166,164,173,112,112,28,17,0,1,22,10,7,0,-9,0,0,0,0,0,1,0.944444444444444,0.785714285714286,0.555555555555556,"1","southpaw"
"674",32,26,179,170,187,173,151,157,41,47,22,14,16,20,6,9,14,-6,0,0,0,0,0.650793650793651,0.770491803278688,0.253968253968254,0.327868852459016,"1","Unknown"
"427",42,29,190,189,206,198,210,233,54,27,3,0,37,22,13,1,8,-23,1,0,0,1,0.947368421052632,1,0.649122807017544,0.814814814814815,"1","orthodox"
"342",25,27,191,189,199,198,212,213,24,22,0,0,24,18,-2,2,1,-1,0,0,0,0,1,1,1,0.818181818181818,"1","orthodox"
"158",23,24,178,175,182,182,145,145,5,6,6,0,2,3,-1,3,0,0,0,0,0,0,0.454545454545455,1,0.181818181818182,0.5,"1","orthodox"
"22",28,35,168,173,170,173,135,134,32,31,1,7,24,19,-7,-5,-3,1,0,1,0,0,0.96969696969697,0.815789473684211,0.727272727272727,0.5,"1","orthodox"
"760",25,26,178,173,183,175,152,153,29,42,1,1,17,32,-1,5,8,-1,0,0,0,0,0.966666666666667,0.976744186046512,0.566666666666667,0.744186046511628,"1","orthodox"
"445",45,34,170,169,168,175,157,160,96,58,11,3,68,28,11,1,-7,-3,1,0,0,0,0.897196261682243,0.950819672131147,0.635514018691589,0.459016393442623,"1","orthodox"
"214",29,25,163,175,160,174,122,122,16,21,1,0,9,12,4,-12,-14,0,0,0,0,0,0.941176470588235,1,0.529411764705882,0.571428571428571,"1","orthodox"
"91",29,23,177,178,194,183,158,158,22,12,2,3,21,4,6,-1,11,0,0,0,0,0,0.916666666666667,0.8,0.875,0.266666666666667,"1","orthodox"
"106",43,22,165,180,168,178,148,150,26,15,15,0,17,14,21,-15,-10,-2,1,0,0,0,0.634146341463415,1,0.414634146341463,0.933333333333333,"1","orthodox"
"13",31,23,155,178,157,183,117,118,19,12,7,2,1,5,8,-23,-26,-1,0,0,0,0,0.730769230769231,0.857142857142857,0.0384615384615385,0.357142857142857,"1","orthodox"
"377",18,21,165,164,175,160,133,130,44,67,15,18,16,8,-3,1,15,3,0,0,0,0,0.745762711864407,0.788235294117647,0.271186440677966,0.0941176470588235,"1","orthodox"
"557",20,23,164,160,166,170,132,118,33,49,1,5,18,23,-3,4,-4,14,0,0,0,0,0.970588235294118,0.907407407407407,0.529411764705882,0.425925925925926,"1","Unknown"
"783",34,27,193,189,196,208,245,225,36,32,1,2,26,26,7,4,-12,20,0,0,1,0,0.972972972972973,0.941176470588235,0.702702702702703,0.764705882352941,"1","southpaw"
"252",32,34,170,168,175,183,134,138,23,36,7,13,8,25,-2,2,-8,-4,0,0,0,0,0.766666666666667,0.73469387755102,0.266666666666667,0.510204081632653,"1","orthodox"
"332",31,32,171,173,169,173,140,140,89,48,0,2,75,39,-1,-2,-4,0,0,0,0,0,1,0.96,0.842696629213483,0.78,"1","orthodox"
"23",25,28,174,174,170,173,135,135,23,29,2,6,9,15,-3,0,-3,0,0,0,0,0,0.92,0.828571428571429,0.36,0.428571428571429,"1","orthodox"
"256",22,30,183,177,186,180,153,154,1,4,0,0,1,3,-8,6,6,-1,0,0,0,0,1,1,1,0.75,"1","orthodox"
"469",24,23,170,171,170,173,144,146,74,70,13,16,31,19,1,-1,-3,-2,0,0,0,0,0.850574712643678,0.813953488372093,0.35632183908046,0.22093023255814,"1","orthodox"
"322",37,41,188,185,191,191,174,174,24,46,3,4,18,32,-4,3,0,0,1,1,0,0,0.888888888888889,0.92,0.666666666666667,0.64,"1","southpaw"
"1038",23,24,157,165,173,170,112,112,13,30,8,8,5,24,-1,-8,3,0,0,0,0,0,0.619047619047619,0.789473684210526,0.238095238095238,0.631578947368421,"1","orthodox"
"178",23,23,185,170,193,175,146,145,18,10,0,2,8,3,0,15,18,1,0,0,0,0,1,0.833333333333333,0.444444444444444,0.25,"1","orthodox"
"196",30,28,183,180,175,185,168,167,31,16,2,4,11,10,2,3,-10,1,0,0,0,0,0.939393939393939,0.8,0.333333333333333,0.5,"1","orthodox"
"550",24,23,183,179,191,183,154,154,17,26,4,1,4,19,1,4,8,0,0,0,0,0,0.80952380952381,0.962962962962963,0.19047619047619,0.703703703703704,"1","orthodox"
"250",24,20,170,168,175,170,125,126,1,1,0,0,0,0,4,2,5,-1,0,0,0,0,1,1,0,0,"1","orthodox"
"269",20,18,180,182,180,185,160,160,0,5,5,1,0,3,2,-2,-5,0,0,0,0,0,0,0.833333333333333,0,0.5,"1","orthodox"
"936",31,35,185,188,196,196,238,234,20,18,1,9,15,13,-4,-3,0,4,0,1,0,0,0.952380952380952,0.666666666666667,0.714285714285714,0.481481481481481,"1","orthodox"
"497",26,29,185,183,193,193,188,205,44,35,4,9,30,12,-3,2,0,-17,0,0,0,1,0.916666666666667,0.795454545454545,0.625,0.272727272727273,"1","orthodox"
"564",25,25,178,178,178,180,152,156,46,13,3,1,28,10,0,0,-2,-4,0,0,0,0,0.938775510204082,0.928571428571429,0.571428571428571,0.714285714285714,"1","orthodox"
"42",22,19,175,173,188,178,136,136,8,10,1,0,5,8,3,2,10,0,0,0,0,0,0.888888888888889,1,0.555555555555556,0.8,"1","orthodox"
"1",29,26,171,160,179,161,115,115,26,18,2,3,12,17,3,11,18,0,0,0,0,0,0.928571428571429,0.857142857142857,0.428571428571429,0.80952380952381,"1","orthodox"
"927",29,24,175,175,175,180,151,149,57,27,32,3,27,20,5,0,-5,2,0,0,0,0,0.640449438202247,0.9,0.303370786516854,0.666666666666667,"1","orthodox"
"925",21,32,178,171,178,180,133,135,73,37,1,7,65,26,-11,7,-2,-2,0,0,0,0,0.986486486486487,0.840909090909091,0.878378378378378,0.590909090909091,"1","orthodox"
"644",21,24,170,157,178,159,134,133,50,65,8,12,21,15,-3,13,19,1,0,0,0,0,0.862068965517241,0.844155844155844,0.362068965517241,0.194805194805195,"1","orthodox"
"9331",31,31,170,170,178,173,121,122,33,30,4,3,21,17,0,0,5,-1,0,0,0,0,0.891891891891892,0.909090909090909,0.567567567567568,0.515151515151515,"1","orthodox"
"971",41,31,188,193,196,201,238,239,26,32,17,3,16,27,10,-5,-5,-1,1,0,0,0,0.604651162790698,0.914285714285714,0.372093023255814,0.771428571428571,"1","orthodox"
"302",19,23,181,186,183,186,175,175,0,2,1,2,0,0,-4,-5,-3,0,0,0,0,0,0,0.5,0,0,"1","orthodox"
"413",30,32,177,185,185,191,160,160,27,32,5,2,19,25,-2,-8,-6,0,0,0,0,0,0.84375,0.941176470588235,0.59375,0.735294117647059,"1","Unknown"
"536",22,21,164,164,174,160,128,136,23,66,7,17,13,8,1,0,14,-8,0,0,0,0,0.766666666666667,0.795180722891566,0.433333333333333,0.0963855421686747,"1","Unknown"
"390",24,20,175,183,191,185,160,151,52,23,6,2,32,11,4,-8,6,9,0,0,0,0,0.896551724137931,0.92,0.551724137931034,0.44,"1","orthodox"
"220",30,29,170,178,178,178,147,147,22,29,4,9,16,21,1,-8,0,0,0,0,0,0,0.846153846153846,0.763157894736842,0.615384615384615,0.552631578947368,"1","orthodox"
"379",42,25,178,184,183,192,142,141,77,17,7,3,62,11,17,-6,-9,1,1,0,0,0,0.916666666666667,0.85,0.738095238095238,0.55,"1","orthodox"
"498",37,21,180,189,178,185,189,191,194,18,51,1,29,11,16,-9,-7,-2,1,0,0,0,0.791836734693877,0.947368421052632,0.118367346938776,0.578947368421053,"1","orthodox"
"408",43,36,185,180,191,185,173,173,48,44,4,0,32,32,7,5,6,0,1,1,0,0,0.923076923076923,1,0.615384615384615,0.727272727272727,"1","orthodox"
"135",21,25,178,183,173,185,147,146,9,13,0,1,4,11,-4,-5,-12,1,0,0,0,0,1,0.928571428571429,0.444444444444444,0.785714285714286,"1","orthodox"
"213",38,30,166,163,173,160,126,126,41,16,8,2,37,9,8,3,13,0,1,0,0,0,0.836734693877551,0.888888888888889,0.755102040816326,0.5,"1","orthodox"
"240",30,21,189,176,190,176,175,175,4,7,0,1,3,7,9,13,14,0,0,0,0,0,1,0.875,0.75,0.875,"1","orthodox"
"921",26,24,159,169,160,173,118,118,35,23,4,4,25,19,2,-10,-13,0,0,0,0,0,0.897435897435897,0.851851851851852,0.641025641025641,0.703703703703704,"1","orthodox"
"931",26,26,171,185,182,189,160,160,91,73,22,27,43,25,0,-14,-7,0,0,0,0,0,0.805309734513274,0.73,0.380530973451327,0.25,"1","orthodox"
"138",18,21,188,183,190,184,167,170,2,4,1,0,1,2,-3,5,6,-3,0,0,0,0,0.666666666666667,1,0.333333333333333,0.5,"1","orthodox"
"941",28,23,173,180,173,170,141,140,29,9,4,0,16,9,5,-7,3,1,0,0,0,0,0.878787878787879,1,0.484848484848485,1,"1","orthodox"
"579",23,24,157,165,160,168,119,119,66,81,15,16,8,10,-1,-8,-8,0,0,0,0,0,0.814814814814815,0.835051546391753,0.0987654320987654,0.103092783505155,"1","Unknown"
"10",21,22,156,160,165,166,108,108,6,9,2,0,4,6,-1,-4,-1,0,0,0,0,0,0.75,1,0.5,0.666666666666667,"1","orthodox"
"249",26,26,178,180,180,183,152,154,0,5,2,0,0,4,0,-2,-3,-2,0,0,0,0,0,1,0,0.8,"1","orthodox"
"395",25,21,166,164,170,174,129,130,32,65,5,9,15,14,4,2,-4,-1,0,0,0,0,0.864864864864865,0.878378378378378,0.405405405405405,0.189189189189189,"1","orthodox"
"786",42,23,188,189,198,208,233,238,45,17,8,0,32,15,19,-1,-10,-5,1,0,0,0,0.849056603773585,1,0.60377358490566,0.882352941176471,"1","orthodox"
"237",29,34,174,170,178,180,135,135,26,52,8,14,18,36,-5,4,-2,0,0,0,0,0,0.764705882352941,0.787878787878788,0.529411764705882,0.545454545454545,"1","southpaw"
"428",30,28,192,189,211,198,208,246,30,24,4,0,20,20,2,3,13,-38,0,0,0,1,0.882352941176471,1,0.588235294117647,0.833333333333333,"1","orthodox"
"166",17,19,175,172,178,173,130,130,1,3,1,1,1,1,-2,3,5,0,0,0,0,0,0.5,0.75,0.5,0.25,"1","orthodox"
"221",25,29,173,178,180,178,147,147,18,28,2,9,11,20,-4,-5,2,0,0,0,0,0,0.9,0.756756756756757,0.55,0.540540540540541,"1","orthodox"
"725",38,28,191,180,198,203,280,221,53,5,4,6,34,3,10,11,-5,59,1,0,1,0,0.929824561403509,0.454545454545455,0.596491228070175,0.272727272727273,"1","orthodox"
"944",28,24,191,178,211,178,223,224,18,25,1,0,16,21,4,13,33,-1,0,0,0,0,0.947368421052632,1,0.842105263157895,0.84,"1","orthodox"
"34",27,30,166,168,175,170,126,125,30,35,0,11,27,23,-3,-2,5,1,0,0,0,0,1,0.760869565217391,0.9,0.5,"1","southpaw"
"5241",31,27,182,197,185,216,186,270,112,77,23,6,12,62,4,-15,-31,-84,0,0,0,1,0.82962962962963,0.927710843373494,0.0888888888888889,0.746987951807229,"1","orthodox"
"112",18,23,173,163,176,168,109,109,12,6,2,0,7,4,-5,10,8,0,0,0,0,0,0.857142857142857,1,0.5,0.666666666666667,"1","southpaw"
"533",23,19,164,168,160,178,130,130,115,30,24,4,11,2,4,-4,-18,0,0,0,0,0,0.827338129496403,0.882352941176471,0.079136690647482,0.0588235294117647,"1","orthodox"
"410",40,26,185,180,191,189,160,160,46,23,2,0,32,17,14,5,2,0,1,0,0,0,0.958333333333333,1,0.666666666666667,0.739130434782609,"1","orthodox"
"355",25,37,170,165,175,173,130,130,41,37,2,3,23,26,-12,5,2,0,0,1,0,0,0.953488372093023,0.925,0.534883720930233,0.65,"1","orthodox"
"363",35,22,171,178,183,187,157,159,77,42,14,2,21,37,13,-7,-4,-2,1,0,0,0,0.846153846153846,0.954545454545455,0.230769230769231,0.840909090909091,"1","orthodox"
"336",30,34,178,189,180,198,218,218,45,33,2,3,39,24,-4,-11,-18,0,0,0,0,0,0.957446808510638,0.916666666666667,0.829787234042553,0.666666666666667,"1","orthodox"
"143",32,22,171,168,170,170,135,141,9,8,8,0,6,6,10,3,0,-6,0,0,0,0,0.529411764705882,1,0.352941176470588,0.75,"1","southpaw"
"855",32,32,180,182,185,188,153,153,30,31,0,3,19,22,0,-2,-3,0,0,0,0,0,1,0.911764705882353,0.633333333333333,0.647058823529412,"1","orthodox"
"136",21,25,178,183,173,185,147,146,9,13,0,1,4,11,-4,-5,-12,1,0,0,0,0,1,0.928571428571429,0.444444444444444,0.785714285714286,"1","orthodox"
"176",22,28,171,170,182,180,135,135,14,17,2,3,13,15,-6,1,2,0,0,0,0,0,0.875,0.85,0.8125,0.75,"1","orthodox"
"131",39,29,183,180,191,188,175,174,18,38,3,1,7,32,10,3,3,1,1,0,0,0,0.857142857142857,0.974358974358974,0.333333333333333,0.82051282051282,"1","southpaw"
"754",25,28,170,170,170,178,133,131,1,1,1,0,1,1,-3,0,-8,2,0,0,0,0,0.5,1,0.5,1,"1","orthodox"
"434",29,20,173,182,180,185,168,166,211,39,11,9,36,8,9,-9,-5,2,0,0,0,0,0.95045045045045,0.8125,0.162162162162162,0.166666666666667,"1","orthodox"
"604",27,39,192,178,211,188,200,215,48,117,20,24,38,69,-12,14,23,-15,0,1,0,1,0.705882352941177,0.829787234042553,0.558823529411765,0.48936170212766,"1","Unknown"
"748",30,26,171,182,168,183,151,151,34,13,4,3,19,6,4,-11,-15,0,0,0,0,0,0.894736842105263,0.8125,0.5,0.375,"1","orthodox"
"104",32,26,193,191,208,213,223,227,11,9,7,0,5,4,6,2,-5,-4,0,0,0,0,0.611111111111111,1,0.277777777777778,0.444444444444444,"1","orthodox"
"830",23,28,171,163,178,166,144,144,43,110,12,42,20,11,-5,8,12,0,0,0,0,0,0.781818181818182,0.723684210526316,0.363636363636364,0.0723684210526316,"1","orthodox"
"305",37,39,178,168,185,178,159,159,17,16,9,23,4,14,-2,10,7,0,1,1,0,0,0.653846153846154,0.41025641025641,0.153846153846154,0.358974358974359,"1","orthodox"
"31",29,28,165,171,157,175,125,125,23,32,0,1,14,18,1,-6,-18,0,0,0,0,0,1,0.96969696969697,0.608695652173913,0.545454545454545,"1","orthodox"
"297",33,26,178,183,191,188,156,157,9,9,11,1,1,7,7,-5,3,-1,0,0,0,0,0.45,0.9,0.05,0.7,"1","orthodox"
"928",30,28,168,170,171,173,134,129,82,38,50,3,42,19,2,-2,-2,5,0,0,0,0,0.621212121212121,0.926829268292683,0.318181818181818,0.463414634146341,"1","orthodox"
"282",30,25,185,185,191,198,195,196,10,20,2,0,6,15,5,0,-7,-1,0,0,0,0,0.833333333333333,1,0.5,0.75,"1","southpaw"
"396",36,29,190,189,206,193,223,205,48,28,1,0,34,19,7,1,13,18,1,0,1,0,0.979591836734694,1,0.693877551020408,0.678571428571429,"1","orthodox"
"455",27,32,184,185,196,198,174,173,30,49,0,3,18,40,-5,-1,-2,1,0,0,0,0,1,0.942307692307692,0.6,0.769230769230769,"1","orthodox"
"99",27,26,170,169,180,169,123,123,6,5,2,1,1,4,1,1,11,0,0,0,0,0,0.75,0.833333333333333,0.125,0.666666666666667,"1","southpaw"
"495",31,21,169,180,175,184,147,147,43,22,2,0,20,19,10,-11,-9,0,0,0,0,0,0.955555555555556,1,0.444444444444444,0.863636363636364,"1","southpaw"
"505",21,25,179,171,182,173,166,171,65,83,17,22,7,24,-4,8,9,-5,0,0,0,0,0.792682926829268,0.79047619047619,0.0853658536585366,0.228571428571429,"1","orthodox"
"893",36,38,177,175,183,178,172,157,25,20,29,6,14,19,-2,2,5,15,1,1,1,0,0.462962962962963,0.769230769230769,0.259259259259259,0.730769230769231,"1","Unknown"
"580",21,32,175,168,178,173,138,138,24,76,4,21,7,31,-11,7,5,0,0,0,0,0,0.857142857142857,0.783505154639175,0.25,0.319587628865979,"1","orthodox"
"628",27,27,171,169,179,175,140,138,28,36,3,0,23,16,0,2,4,2,0,0,0,0,0.903225806451613,1,0.741935483870968,0.444444444444444,"1","orthodox"
"799",34,26,188,187,206,198,236,232,38,27,11,3,30,23,8,1,8,4,0,0,0,0,0.775510204081633,0.9,0.612244897959184,0.766666666666667,"1","orthodox"
"486",23,21,178,177,183,174,151,154,16,18,8,2,4,11,2,1,9,-3,0,0,0,0,0.666666666666667,0.9,0.166666666666667,0.55,"1","orthodox"
"52",25,22,157,160,160,152,112,112,22,29,1,2,17,22,3,-3,8,0,0,0,0,0,0.956521739130435,0.935483870967742,0.739130434782609,0.709677419354839,"1","orthodox"
"473",34,24,183,188,185,203,191,192,89,23,14,3,49,11,10,-5,-18,-1,0,0,0,0,0.864077669902913,0.884615384615385,0.475728155339806,0.423076923076923,"1","orthodox"
"450",35,22,171,178,183,187,157,159,77,42,14,2,21,37,13,-7,-4,-2,1,0,0,0,0.846153846153846,0.954545454545455,0.230769230769231,0.840909090909091,"1","orthodox"
"938",37,28,173,180,175,183,150,145,24,25,15,2,12,16,9,-7,-8,5,1,0,0,0,0.615384615384615,0.925925925925926,0.307692307692308,0.592592592592593,"1","orthodox"
"686",23,21,170,164,183,174,137,138,31,11,1,0,18,7,2,6,9,-1,0,0,0,0,0.96875,1,0.5625,0.636363636363636,"1","southpaw"
"798",39,27,188,191,206,198,244,217,54,18,12,0,44,12,12,-3,8,27,1,0,1,0,0.818181818181818,1,0.666666666666667,0.666666666666667,"1","orthodox"
"647",24,27,166,170,165,178,140,140,40,118,13,22,16,64,-3,-4,-13,0,0,0,0,0,0.754716981132076,0.842857142857143,0.30188679245283,0.457142857142857,"1","Unknown"
"246",28,26,183,185,175,196,159,159,25,18,1,3,9,17,2,-2,-21,0,0,0,0,0,0.961538461538462,0.857142857142857,0.346153846153846,0.80952380952381,"1","orthodox"
"976",28,20,163,169,169,178,128,130,54,29,21,1,12,9,8,-6,-9,-2,0,0,0,0,0.72,0.966666666666667,0.16,0.3,"1","Unknown"
"522",31,29,185,189,196,196,168,167,43,25,2,1,28,16,2,-4,0,1,0,0,0,0,0.955555555555556,0.961538461538462,0.622222222222222,0.615384615384615,"1","southpaw"
"552",33,25,185,183,185,194,218,188,10,13,2,0,4,10,8,2,-9,30,0,0,1,0,0.833333333333333,1,0.333333333333333,0.769230769230769,"1","orthodox"
"500",30,33,180,184,185,188,177,174,89,89,12,4,58,42,-3,-4,-3,3,0,0,0,0,0.881188118811881,0.956989247311828,0.574257425742574,0.451612903225806,"1","orthodox"
"995",36,24,183,177,185,179,196,192,22,19,14,0,16,13,12,6,6,4,1,0,0,0,0.611111111111111,1,0.444444444444444,0.684210526315789,"1","orthodox"
"1006",41,29,185,185,196,196,215,214,11,14,25,2,4,14,12,0,0,1,1,0,0,0,0.305555555555556,0.875,0.111111111111111,0.875,"1","orthodox"
"70",28,27,173,173,178,178,140,140,15,23,0,4,5,16,1,0,0,0,0,0,0,0,1,0.851851851851852,0.333333333333333,0.592592592592593,"1","southpaw"
"403",23,24,173,180,170,184,150,159,52,56,9,1,14,38,-1,-7,-14,-9,0,0,0,0,0.852459016393443,0.982456140350877,0.229508196721311,0.666666666666667,"1","orthodox"
"902",28,25,187,185,192,193,174,172,17,11,6,8,16,2,3,2,-1,2,0,0,0,0,0.739130434782609,0.578947368421053,0.695652173913043,0.105263157894737,"1","orthodox"
"388",30,37,183,183,185,188,182,194,71,49,5,16,39,31,-7,0,-3,-12,0,1,0,0,0.934210526315789,0.753846153846154,0.513157894736842,0.476923076923077,"1","orthodox"
"8",32,30,180,171,196,184,168,164,13,16,0,15,10,6,2,9,12,4,0,0,0,0,1,0.516129032258065,0.769230769230769,0.193548387096774,"1","southpaw"
"456",29,28,185,185,198,188,160,160,45,24,2,4,38,15,1,0,10,0,0,0,0,0,0.957446808510638,0.857142857142857,0.808510638297872,0.535714285714286,"1","orthodox"
"755",31,28,175,174,183,183,168,169,49,45,27,19,17,8,3,1,0,-1,0,0,0,0,0.644736842105263,0.703125,0.223684210526316,0.125,"1","Unknown"
"890",34,24,160,168,168,168,112,112,31,22,10,18,27,12,10,-8,0,0,0,0,0,0,0.75609756097561,0.55,0.658536585365854,0.3,"1","Unknown"
"2",29,26,196,198,203,208,244,245,23,15,0,0,21,15,3,-2,-5,-1,0,0,0,0,1,1,0.91304347826087,1,"1","southpaw"
"340",42,29,190,189,206,198,210,233,54,27,3,0,37,22,13,1,8,-23,1,0,0,1,0.947368421052632,1,0.649122807017544,0.814814814814815,"1","orthodox"
"277",38,24,173,170,185,161,139,140,42,8,6,0,18,5,14,3,24,-1,1,0,0,0,0.875,1,0.375,0.625,"1","orthodox"
"43",23,24,173,165,171,168,114,115,11,17,3,2,3,9,-1,8,3,-1,0,0,0,0,0.785714285714286,0.894736842105263,0.214285714285714,0.473684210526316,"1","orthodox"
"5931",27,20,164,157,166,160,128,133,75,37,20,6,35,21,7,7,6,-5,0,0,0,0,0.789473684210526,0.86046511627907,0.368421052631579,0.488372093023256,"1","Unknown"
"958",35,32,193,188,203,193,273,221,48,20,4,0,42,17,3,5,10,52,1,0,1,0,0.923076923076923,1,0.807692307692308,0.85,"1","orthodox"
"398",35,29,170,173,173,183,146,147,43,36,9,0,13,24,6,-3,-10,-1,1,0,0,0,0.826923076923077,1,0.25,0.666666666666667,"1","orthodox"
"94",28,22,188,180,196,188,245,270,12,11,0,15,12,9,6,8,8,-25,0,0,0,1,1,0.423076923076923,1,0.346153846153846,"1","orthodox"
"624",22,29,157,164,160,171,119,120,63,111,12,21,8,24,-7,-7,-11,-1,0,0,0,0,0.84,0.840909090909091,0.106666666666667,0.181818181818182,"1","Unknown"
"155",24,23,183,202,198,201,223,255,13,10,0,1,11,7,1,-19,-3,-32,0,0,0,1,1,0.909090909090909,0.846153846153846,0.636363636363636,"1","orthodox"
"898",36,25,187,191,192,198,190,188,26,16,12,1,24,13,11,-4,-6,2,1,0,0,0,0.684210526315789,0.941176470588235,0.631578947368421,0.764705882352941,"1","orthodox"
"124",23,26,178,178,178,178,130,130,13,12,1,4,8,4,-3,0,0,0,0,0,0,0,0.928571428571429,0.75,0.571428571428571,0.25,"1","orthodox"
"917",31,25,187,183,196,183,214,203,6,22,2,6,4,19,6,4,13,11,0,0,0,0,0.75,0.785714285714286,0.5,0.678571428571429,"1","orthodox"
"681",33,30,173,169,188,178,146,145,36,61,12,3,23,44,3,4,10,1,0,0,0,0,0.75,0.953125,0.479166666666667,0.6875,"1","orthodox"
"853",25,28,188,191,200,192,198,199,11,11,0,1,9,4,-3,-3,8,-1,0,0,0,0,1,0.916666666666667,0.818181818181818,0.333333333333333,"1","orthodox"
"654",31,28,168,174,174,178,147,146,44,26,12,1,30,15,3,-6,-4,1,0,0,0,0,0.785714285714286,0.962962962962963,0.535714285714286,0.555555555555556,"1","Unknown"
"713",26,34,193,185,216,198,213,218,17,27,1,11,13,18,-8,8,18,-5,0,0,0,0,0.944444444444444,0.710526315789474,0.722222222222222,0.473684210526316,"1","orthodox"
"409",37,41,188,185,191,191,174,174,24,46,3,4,18,32,-4,3,0,0,1,1,0,0,0.888888888888889,0.92,0.666666666666667,0.64,"1","southpaw"
"519",32,26,170,164,173,165,122,122,40,18,4,4,22,9,6,6,8,0,0,0,0,0,0.909090909090909,0.818181818181818,0.5,0.409090909090909,"1","southpaw"
"424",30,34,178,189,180,198,215,222,45,32,1,3,39,23,-4,-11,-18,-7,0,0,0,0,0.978260869565217,0.914285714285714,0.847826086956522,0.657142857142857,"1","orthodox"
"584",30,26,168,168,173,178,135,135,70,67,16,11,29,7,4,0,-5,0,0,0,0,0,0.813953488372093,0.858974358974359,0.337209302325581,0.0897435897435897,"1","orthodox"
"968",36,33,196,201,208,218,237,230,52,26,3,0,43,16,3,-5,-10,7,1,0,0,0,0.945454545454545,1,0.781818181818182,0.615384615384615,"1","orthodox"
"803",30,33,182,188,193,203,188,190,26,27,4,4,15,20,-3,-6,-10,-2,0,0,0,0,0.866666666666667,0.870967741935484,0.5,0.645161290322581,"1","orthodox"
"20",24,32,170,168,180,174,127,128,23,21,0,11,10,12,-8,2,6,-1,0,0,0,0,1,0.65625,0.434782608695652,0.375,"1","orthodox"
"951",26,21,165,173,174,180,124,123,34,32,9,1,8,7,5,-8,-6,1,0,0,0,0,0.790697674418605,0.96969696969697,0.186046511627907,0.212121212121212,"1","orthodox"
"88",27,26,171,171,179,170,125,125,35,15,1,0,21,8,1,0,9,0,0,0,0,0,0.972222222222222,1,0.583333333333333,0.533333333333333,"1","orthodox"
"437",29,27,180,179,191,185,147,147,34,31,1,1,24,25,2,1,6,0,0,0,0,0,0.971428571428571,0.96875,0.685714285714286,0.78125,"1","orthodox"
"361",27,28,189,184,203,188,195,195,4,36,6,5,4,16,-1,5,15,0,0,0,0,0,0.4,0.878048780487805,0.4,0.390243902439024,"1","Unknown"
"107",27,25,168,175,165,178,131,131,8,8,0,1,3,4,2,-7,-13,0,0,0,0,0,1,0.888888888888889,0.375,0.444444444444444,"1","orthodox"
"102",43,22,165,180,168,178,148,150,26,15,15,0,17,14,21,-15,-10,-2,1,0,0,0,0.634146341463415,1,0.414634146341463,0.933333333333333,"1","orthodox"
"887",32,26,163,173,160,180,120,124,24,32,33,1,16,22,6,-10,-20,-4,0,0,0,0,0.421052631578947,0.96969696969697,0.280701754385965,0.666666666666667,"1","orthodox"
"962",32,32,170,175,178,178,152,152,22,42,6,5,16,29,0,-5,0,0,0,0,0,0,0.785714285714286,0.893617021276596,0.571428571428571,0.617021276595745,"1","orthodox"
"658",24,23,178,177,184,178,162,161,61,16,13,1,17,8,1,1,6,1,0,0,0,0,0.824324324324324,0.941176470588235,0.22972972972973,0.470588235294118,"1","Unknown"
"299",26,26,163,163,157,173,118,118,10,4,4,6,5,0,0,0,-16,0,0,0,0,0,0.714285714285714,0.4,0.357142857142857,0,"1","orthodox"
"391",35,26,168,180,175,184,147,147,40,33,2,0,17,29,9,-12,-9,0,1,0,0,0,0.952380952380952,1,0.404761904761905,0.878787878787879,"1","southpaw"
"652",28,28,166,165,168,165,118,116,25,16,0,4,11,12,0,1,3,2,0,0,0,0,1,0.8,0.44,0.6,"1","southpaw"
"6151",21,25,168,169,169,163,135,135,24,87,0,5,21,73,-4,-1,6,0,0,0,0,0,1,0.945652173913043,0.875,0.793478260869565,"1","orthodox"
"1027",23,21,170,173,180,173,126,126,37,10,6,1,29,5,2,-3,7,0,0,0,0,0,0.86046511627907,0.909090909090909,0.674418604651163,0.454545454545455,"1","orthodox"
"265",36,37,193,192,201,206,237,250,36,24,1,17,34,19,-1,1,-5,-13,1,1,0,0,0.972972972972973,0.585365853658537,0.918918918918919,0.463414634146341,"1","orthodox"
"955",36,35,192,196,193,207,248,226,30,29,2,1,14,17,1,-4,-14,22,1,1,1,0,0.9375,0.966666666666667,0.4375,0.566666666666667,"1","orthodox"
"565",48,25,192,193,199,203,260,227,76,29,4,1,68,24,23,-1,-4,33,1,0,1,0,0.95,0.966666666666667,0.85,0.8,"1","orthodox"
"162",20,22,170,168,174,175,118,117,3,6,1,0,1,1,-2,2,-1,1,0,0,0,0,0.75,1,0.25,0.166666666666667,"1","southpaw"
"251",26,25,173,170,180,173,140,139,7,4,0,8,4,2,1,3,7,1,0,0,0,0,1,0.333333333333333,0.571428571428571,0.166666666666667,"1","Unknown"
"894",35,38,177,175,183,178,168,152,24,16,28,5,13,15,-3,2,5,16,1,1,1,0,0.461538461538462,0.761904761904762,0.25,0.714285714285714,"1","Unknown"
"844",23,26,163,179,170,180,134,138,63,74,5,10,4,20,-3,-16,-10,-4,0,0,0,0,0.926470588235294,0.880952380952381,0.0588235294117647,0.238095238095238,"1","Unknown"
"346",31,33,179,171,191,188,202,220,66,119,12,15,54,70,-2,8,3,-18,0,0,0,1,0.846153846153846,0.888059701492537,0.692307692307692,0.522388059701492,"1","orthodox"
"467",29,33,174,178,180,183,143,144,31,75,1,7,18,61,-4,-4,-3,-1,0,0,0,0,0.96875,0.914634146341463,0.5625,0.74390243902439,"1","orthodox"
"219",17,24,175,165,178,171,130,129,1,1,2,3,1,1,-7,10,7,1,0,0,0,0,0.333333333333333,0.25,0.333333333333333,0.25,"1","orthodox"
"683",38,32,168,170,165,183,126,126,55,23,4,13,28,19,6,-2,-18,0,1,0,0,0,0.932203389830508,0.638888888888889,0.474576271186441,0.527777777777778,"1","orthodox"
"228",20,23,168,170,168,170,122,121,0,4,2,0,0,0,-3,-2,-2,1,0,0,0,0,0,1,0,0,"1","southpaw"
"1035",26,29,183,178,191,188,155,158,22,42,6,5,7,26,-3,5,3,-3,0,0,0,0,0.785714285714286,0.893617021276596,0.25,0.553191489361702,"1","orthodox"
"123",32,25,178,178,180,183,145,147,28,31,3,8,20,21,7,0,-3,-2,0,0,0,0,0.903225806451613,0.794871794871795,0.645161290322581,0.538461538461538,"1","southpaw"
"117",28,22,170,165,173,168,123,123,10,11,1,0,6,6,6,5,5,0,0,0,0,0,0.909090909090909,1,0.545454545454545,0.545454545454545,"1","orthodox"
"1025",29,34,180,170,198,180,140,139,19,51,0,14,11,35,-5,10,18,1,0,0,0,0,1,0.784615384615385,0.578947368421053,0.538461538461538,"1","orthodox"
"942",26,24,192,188,206,198,218,222,24,21,2,0,13,11,2,4,8,-4,0,0,0,0,0.923076923076923,1,0.5,0.523809523809524,"1","orthodox"
"751",31,31,185,178,188,183,172,174,24,36,0,5,21,23,0,7,5,-2,0,0,0,0,1,0.878048780487805,0.875,0.560975609756098,"1","southpaw"
"490",35,30,185,196,196,213,247,238,23,28,3,1,16,24,5,-11,-17,9,1,0,0,0,0.884615384615385,0.96551724137931,0.615384615384615,0.827586206896552,"1","orthodox"
"300",17,18,167,170,170,170,108,112,0,1,1,1,0,0,-1,-3,0,-4,0,0,0,0,0,0.5,0,0,"1","orthodox"
"885",21,21,157,156,152,152,108,108,12,16,4,7,7,8,0,1,0,0,0,0,0,0,0.75,0.695652173913043,0.4375,0.347826086956522,"1","orthodox"
"373",39,27,182,183,182,194,172,219,60,16,8,0,53,13,12,-1,-12,-47,1,0,0,1,0.882352941176471,1,0.779411764705882,0.8125,"1","orthodox"
"573",23,27,171,171,180,178,139,137,43,67,4,16,25,12,-4,0,2,2,0,0,0,0,0.914893617021277,0.807228915662651,0.531914893617021,0.144578313253012,"1","orthodox"
