"","age_A","age_B","height_A","height_B","reach_A","reach_B","weight_A","weight_B","won_A","won_B","lost_A","lost_B","kos_A","kos_B","AdvAgeA","AdvHeightA","AdvReachA","AdvWgtA","Over35AgeA","Over35AgeB","Over15lbA","Over15lbB","WinPA","WinPB","KoAPer","KoBPer","binaryresult","stance"
"5710",26,37,185,193,191,206,221,268,32,23,1,11,18,21,-11,-8,-15,-47,0,1,0,1,0.96969696969697,0.676470588235294,0.545454545454545,0.617647058823529,"0","orthodox"
"1744",36,26,166,170,178,188,131,131,29,25,4,1,14,15,10,-4,-10,0,1,0,0,0,0.878787878787879,0.961538461538462,0.424242424242424,0.576923076923077,"0","orthodox"
"3161",26,32,173,166,183,168,126,126,41,34,1,1,31,12,-6,7,15,0,0,0,0,0,0.976190476190476,0.971428571428571,0.738095238095238,0.342857142857143,"0","orthodox"
"4485",20,32,178,173,178,180,153,151,10,24,0,3,10,17,-12,5,-2,2,0,0,0,0,1,0.888888888888889,1,0.62962962962963,"0","orthodox"
"3999",31,31,168,164,165,163,115,115,42,29,0,11,24,18,0,4,2,0,0,0,0,0,1,0.725,0.571428571428571,0.45,"0","orthodox"
"4291",21,28,173,175,173,175,142,145,66,54,8,28,13,26,-7,-2,-2,-3,0,0,0,0,0.891891891891892,0.658536585365854,0.175675675675676,0.317073170731707,"0","Unknown"
"2785",29,28,174,178,180,178,147,147,36,28,0,0,33,18,1,-4,2,0,0,0,0,0,1,1,0.916666666666667,0.642857142857143,"0","orthodox"
"4375",21,24,160,165,168,165,115,113,11,4,0,15,6,4,-3,-5,3,2,0,0,0,0,1,0.210526315789474,0.545454545454545,0.210526315789474,"0","orthodox"
"5685",27,28,180,182,185,185,145,146,21,21,3,1,17,16,-1,-2,0,-1,0,0,0,0,0.875,0.954545454545455,0.708333333333333,0.727272727272727,"0","orthodox"
"1554",29,28,189,184,191,191,169,170,36,21,2,0,32,16,1,5,0,-1,0,0,0,0,0.947368421052632,1,0.842105263157895,0.761904761904762,"0","orthodox"
"2811",25,26,183,182,185,193,175,186,41,52,4,7,21,20,-1,1,-8,-11,0,0,0,0,0.911111111111111,0.88135593220339,0.466666666666667,0.338983050847458,"0","orthodox"
"5715",23,38,185,191,191,203,217,253,22,30,0,18,13,27,-15,-6,-12,-36,0,1,0,1,1,0.625,0.590909090909091,0.5625,"0","orthodox"
"5946",22,19,193,198,193,208,189,221,5,5,0,2,5,5,3,-5,-15,-32,0,0,0,1,1,0.714285714285714,1,0.714285714285714,"0","orthodox"
"714",22,34,185,175,194,183,160,160,15,49,0,4,10,31,-12,10,11,0,0,0,0,0,1,0.924528301886792,0.666666666666667,0.584905660377358,"0","southpaw"
"2887",21,24,173,168,183,180,130,130,18,25,0,2,14,20,-3,5,3,0,0,0,0,0,1,0.925925925925926,0.777777777777778,0.740740740740741,"0","orthodox"
"5492",29,29,165,164,170,168,118,118,24,35,1,5,15,20,0,1,2,0,0,0,0,0,0.96,0.875,0.6,0.5,"0","southpaw"
"843",19,31,175,170,175,175,146,146,5,32,2,26,2,20,-12,5,0,0,0,0,0,0,0.714285714285714,0.551724137931034,0.285714285714286,0.344827586206897,"0","orthodox"
"6005",25,34,173,168,191,180,146,147,18,27,4,8,9,18,-9,5,11,-1,0,0,0,0,0.818181818181818,0.771428571428571,0.409090909090909,0.514285714285714,"0","southpaw"
"5748",29,30,180,175,191,183,142,141,42,19,6,7,29,15,-1,5,8,1,0,0,0,0,0.875,0.730769230769231,0.604166666666667,0.576923076923077,"0","orthodox"
"3121",28,30,174,180,180,183,146,147,32,30,0,3,30,19,-2,-6,-3,-1,0,0,0,0,1,0.909090909090909,0.9375,0.575757575757576,"0","orthodox"
"2368",22,24,164,170,169,170,124,124,23,27,2,6,16,22,-2,-6,-1,0,0,0,0,0,0.92,0.818181818181818,0.64,0.666666666666667,"0","orthodox"
"5496",40,39,171,178,173,180,160,160,99,46,16,16,78,32,1,-7,-7,0,1,1,0,0,0.860869565217391,0.741935483870968,0.678260869565217,0.516129032258065,"0","orthodox"
"2712",21,27,170,175,168,178,135,135,31,26,1,5,27,13,-6,-5,-10,0,0,0,0,0,0.96875,0.838709677419355,0.84375,0.419354838709677,"0","orthodox"
"4473",24,25,185,180,191,193,178,174,38,18,6,6,29,7,-1,5,-2,4,0,0,0,0,0.863636363636364,0.75,0.659090909090909,0.291666666666667,"0","orthodox"
"4918",36,28,192,178,211,183,244,227,30,24,5,5,20,16,8,14,28,17,1,0,1,0,0.857142857142857,0.827586206896552,0.571428571428571,0.551724137931034,"0","orthodox"
"2353",22,19,168,171,173,177,118,119,5,0,2,1,3,0,3,-3,-4,-1,0,0,0,0,0.714285714285714,0,0.428571428571429,0,"0","orthodox"
"4153",26,34,183,183,191,185,189,190,14,18,1,4,14,14,-8,0,6,-1,0,0,0,0,0.933333333333333,0.818181818181818,0.933333333333333,0.636363636363636,"0","orthodox"
"24",25,37,198,188,208,193,245,244,10,26,0,19,10,11,-12,10,15,1,0,1,0,0,1,0.577777777777778,1,0.244444444444444,"0","orthodox"
"5047",23,29,196,173,211,193,175,203,10,166,1,41,7,100,-6,23,18,-28,0,0,0,1,0.909090909090909,0.801932367149758,0.636363636363636,0.483091787439614,"0","orthodox"
"45",38,36,173,166,183,170,145,146,47,57,0,5,26,38,2,7,13,-1,1,1,0,0,1,0.919354838709677,0.553191489361702,0.612903225806452,"0","orthodox"
"1258",17,23,175,170,180,180,136,132,9,5,0,2,5,2,-6,5,0,4,0,0,0,0,1,0.714285714285714,0.555555555555556,0.285714285714286,"0","orthodox"
"5491",22,29,193,191,203,183,219,230,16,20,0,4,13,19,-7,2,20,-11,0,0,0,0,1,0.833333333333333,0.8125,0.791666666666667,"0","orthodox"
"3705",34,23,177,171,180,178,158,158,46,13,6,1,33,10,11,6,2,0,0,0,0,0,0.884615384615385,0.928571428571429,0.634615384615385,0.714285714285714,"0","orthodox"
"2638",27,28,179,171,191,188,170,198,52,85,6,7,49,48,-1,8,3,-28,0,0,0,1,0.896551724137931,0.923913043478261,0.844827586206897,0.521739130434783,"0","orthodox"
"227",31,27,191,187,188,188,199,199,22,28,2,1,14,14,4,4,0,0,0,0,0,0,0.916666666666667,0.96551724137931,0.583333333333333,0.482758620689655,"0","orthodox"
"5891",23,29,188,185,193,185,222,223,32,24,1,2,28,16,-6,3,8,-1,0,0,0,0,0.96969696969697,0.923076923076923,0.848484848484849,0.615384615384615,"0","orthodox"
"5793",25,26,191,191,193,193,229,256,17,21,0,0,15,15,-1,0,0,-27,0,0,0,1,1,1,0.882352941176471,0.714285714285714,"0","orthodox"
"3870",30,27,168,168,174,165,144,142,98,28,14,6,44,15,3,0,9,2,0,0,0,0,0.875,0.823529411764706,0.392857142857143,0.441176470588235,"0","orthodox"
"5871",24,31,188,188,206,191,225,217,21,13,0,7,15,9,-7,0,15,8,0,0,0,0,1,0.65,0.714285714285714,0.45,"0","orthodox"
"3741",33,23,169,168,174,170,122,122,35,14,4,0,22,5,10,1,4,0,0,0,0,0,0.897435897435897,1,0.564102564102564,0.357142857142857,"0","southpaw"
"2016",19,38,170,180,183,183,147,147,15,60,1,57,14,49,-19,-10,0,0,0,1,0,0,0.9375,0.512820512820513,0.875,0.418803418803419,"0","orthodox"
"2096",20,21,163,178,173,183,130,131,3,3,0,2,3,2,-1,-15,-10,-1,0,0,0,0,1,0.6,1,0.4,"0","Unknown"
"2408",24,27,175,175,183,193,156,156,8,3,2,2,4,2,-3,0,-10,0,0,0,0,0,0.8,0.6,0.4,0.4,"0","orthodox"
"4741",23,26,160,165,168,175,113,110,11,1,0,11,8,0,-3,-5,-7,3,0,0,0,0,1,0.0833333333333333,0.727272727272727,0,"0","southpaw"
"236",30,29,169,175,175,183,141,140,33,31,2,1,31,16,1,-6,-8,1,0,0,0,0,0.942857142857143,0.96875,0.885714285714286,0.5,"0","orthodox"
"4522",44,35,192,183,198,201,249,231,53,26,11,5,37,20,9,9,-3,18,1,1,1,0,0.828125,0.838709677419355,0.578125,0.645161290322581,"0","orthodox"
"4090",30,38,178,185,175,186,169,170,5,12,0,13,1,9,-8,-7,-11,-1,0,1,0,0,1,0.48,0.2,0.36,"0","orthodox"
"1034",24,25,173,178,173,178,142,141,13,20,0,2,9,9,-1,-5,-5,1,0,0,0,0,1,0.909090909090909,0.692307692307692,0.409090909090909,"0","orthodox"
"1576",31,42,180,177,187,178,158,159,24,23,5,8,11,11,-11,3,9,-1,0,1,0,0,0.827586206896552,0.741935483870968,0.379310344827586,0.354838709677419,"0","orthodox"
"3105",30,21,170,180,170,188,172,195,115,41,16,16,52,22,9,-10,-18,-23,0,0,0,1,0.877862595419847,0.719298245614035,0.396946564885496,0.385964912280702,"0","orthodox"
"4077",28,30,170,171,183,176,140,140,44,30,2,2,28,13,-2,-1,7,0,0,0,0,0,0.956521739130435,0.9375,0.608695652173913,0.40625,"0","southpaw"
"5930",25,26,171,170,170,183,135,131,32,19,2,6,24,15,-1,1,-13,4,0,0,0,0,0.941176470588235,0.76,0.705882352941177,0.6,"0","orthodox"
"4582",25,28,171,173,178,178,151,150,74,64,10,30,32,6,-3,-2,0,1,0,0,0,0,0.880952380952381,0.680851063829787,0.380952380952381,0.0638297872340425,"0","orthodox"
"3417",22,27,174,168,178,165,128,136,90,63,6,17,60,21,-5,6,13,-8,0,0,0,0,0.9375,0.7875,0.625,0.2625,"0","orthodox"
"5124",28,19,166,170,170,175,118,118,36,17,1,5,28,13,9,-4,-5,0,0,0,0,0,0.972972972972973,0.772727272727273,0.756756756756757,0.590909090909091,"0","orthodox"
"1636",30,24,170,164,178,166,130,132,20,14,2,3,7,2,6,6,12,-2,0,0,0,0,0.909090909090909,0.823529411764706,0.318181818181818,0.117647058823529,"0","orthodox"
"4992",23,33,170,173,175,178,126,125,12,24,1,5,4,10,-10,-3,-3,1,0,0,0,0,0.923076923076923,0.827586206896552,0.307692307692308,0.344827586206897,"0","orthodox"
"4178",25,39,187,190,188,193,217,244,16,9,0,2,11,9,-14,-3,-5,-27,0,1,0,1,1,0.818181818181818,0.6875,0.818181818181818,"0","southpaw"
"259",22,29,166,166,161,172,118,118,28,32,1,9,26,23,-7,0,-11,0,0,0,0,0,0.96551724137931,0.780487804878049,0.896551724137931,0.560975609756098,"0","orthodox"
"847",23,24,174,178,183,178,130,130,9,8,0,3,5,3,-1,-4,5,0,0,0,0,0,1,0.727272727272727,0.555555555555556,0.272727272727273,"0","orthodox"
"6076",30,25,170,165,178,170,112,111,12,35,3,10,7,28,5,5,8,1,0,0,0,0,0.8,0.777777777777778,0.466666666666667,0.622222222222222,"0","orthodox"
"1189",27,27,191,191,208,193,229,253,15,22,0,1,6,16,0,0,15,-24,0,0,0,1,1,0.956521739130435,0.4,0.695652173913043,"0","orthodox"
"4330",28,34,188,170,201,178,175,175,37,47,2,5,23,30,-6,18,23,0,0,0,0,0,0.948717948717949,0.903846153846154,0.58974358974359,0.576923076923077,"0","orthodox"
"48",32,39,166,174,170,180,145,147,52,46,3,6,38,39,-7,-8,-10,-2,0,1,0,0,0.945454545454545,0.884615384615385,0.690909090909091,0.75,"0","southpaw"
"3095",24,27,170,180,170,180,126,127,23,9,1,2,16,5,-3,-10,-10,-1,0,0,0,0,0.958333333333333,0.818181818181818,0.666666666666667,0.454545454545455,"0","orthodox"
"10",29,34,173,179,178,181,140,139,31,22,0,0,22,11,-5,-6,-3,1,0,0,0,0,1,1,0.709677419354839,0.5,"0","orthodox"
"3498",27,25,175,169,173,178,144,138,114,40,15,7,54,8,2,6,-5,6,0,0,0,0,0.883720930232558,0.851063829787234,0.418604651162791,0.170212765957447,"0","orthodox"
"950",24,34,179,168,188,174,140,140,17,29,0,9,14,16,-10,11,14,0,0,0,0,0,1,0.763157894736842,0.823529411764706,0.421052631578947,"0","orthodox"
"2159",18,24,170,175,170,191,137,135,9,4,0,3,3,0,-6,-5,-21,2,0,0,0,0,1,0.571428571428571,0.333333333333333,0,"0","Unknown"
"3881",34,26,170,168,170,173,137,137,49,16,6,3,32,6,8,2,-3,0,0,0,0,0,0.890909090909091,0.842105263157895,0.581818181818182,0.315789473684211,"0","orthodox"
"4663",36,27,179,173,181,178,153,153,44,29,3,1,27,15,9,6,3,0,1,0,0,0,0.936170212765957,0.966666666666667,0.574468085106383,0.5,"0","orthodox"
"3387",21,29,164,170,160,170,130,136,73,80,19,33,9,20,-8,-6,-10,-6,0,0,0,0,0.793478260869565,0.707964601769911,0.0978260869565217,0.176991150442478,"0","orthodox"
"1405",24,38,165,165,175,157,115,115,18,39,0,8,14,32,-14,0,18,0,0,1,0,0,1,0.829787234042553,0.777777777777778,0.680851063829787,"0","southpaw"
"541",32,30,180,178,185,183,154,153,37,28,6,2,27,21,2,2,2,1,0,0,0,0,0.86046511627907,0.933333333333333,0.627906976744186,0.7,"0","orthodox"
"515",36,35,190,188,208,193,207,239,24,21,4,10,12,10,1,2,15,-32,1,1,0,1,0.857142857142857,0.67741935483871,0.428571428571429,0.32258064516129,"0","orthodox"
"1833",29,31,188,173,192,184,204,222,15,13,0,6,11,7,-2,15,8,-18,0,0,0,1,1,0.684210526315789,0.733333333333333,0.368421052631579,"0","orthodox"
"4008",28,30,175,164,183,174,135,135,32,35,2,2,24,17,-2,11,9,0,0,0,0,0,0.941176470588235,0.945945945945946,0.705882352941177,0.459459459459459,"0","orthodox"
"2",25,29,175,174,179,180,155,155,46,31,1,3,32,19,-4,1,-1,0,0,0,0,0,0.978723404255319,0.911764705882353,0.680851063829787,0.558823529411765,"0","orthodox"
"1252",25,23,156,162,159,162,105,105,19,27,0,3,11,20,2,-6,-3,0,0,0,0,0,1,0.9,0.578947368421053,0.666666666666667,"0","orthodox"
"5600",32,27,193,188,201,198,246,250,34,24,4,16,28,24,5,5,3,-4,0,0,0,0,0.894736842105263,0.6,0.736842105263158,0.6,"0","orthodox"
"5554",27,30,177,175,185,183,160,158,17,15,2,26,14,12,-3,2,2,2,0,0,0,0,0.894736842105263,0.365853658536585,0.736842105263158,0.292682926829268,"0","southpaw"
"4404",22,31,180,173,180,183,135,135,39,35,1,18,30,23,-9,7,-3,0,0,0,0,0,0.975,0.660377358490566,0.75,0.433962264150943,"0","orthodox"
"1998",23,31,184,193,191,188,174,172,13,25,0,16,8,12,-8,-9,3,2,0,0,0,0,1,0.609756097560976,0.615384615384615,0.292682926829268,"0","Unknown"
"3089",31,34,170,175,170,188,125,126,43,37,2,4,33,26,-3,-5,-18,-1,0,0,0,0,0.955555555555556,0.902439024390244,0.733333333333333,0.634146341463415,"0","orthodox"
"4461",22,25,165,168,178,168,118,118,12,19,0,4,12,14,-3,-3,10,0,0,0,0,0,1,0.826086956521739,1,0.608695652173913,"0","southpaw"
"3712",26,37,201,183,201,191,238,240,16,21,0,16,16,12,-11,18,10,-2,0,1,0,0,1,0.567567567567568,1,0.324324324324324,"0","orthodox"
"3754",24,36,196,188,206,196,244,224,33,19,0,9,28,13,-12,8,10,20,0,1,1,0,1,0.678571428571429,0.848484848484849,0.464285714285714,"0","orthodox"
"1302",29,30,180,177,188,180,171,172,37,31,1,1,31,17,-1,3,8,-1,0,0,0,0,0.973684210526316,0.96875,0.815789473684211,0.53125,"0","Unknown"
"1298",34,34,180,188,188,191,175,175,48,21,1,1,38,17,0,-8,-3,0,0,0,0,0,0.979591836734694,0.954545454545455,0.775510204081633,0.772727272727273,"0","Unknown"
"2331",23,20,170,175,171,175,125,125,1,0,1,1,1,0,3,-5,-4,0,0,0,0,0,0.5,0,0.5,0,"0","southpaw"
"5646",31,27,191,185,201,196,237,230,18,9,2,8,13,8,4,6,5,7,0,0,0,0,0.9,0.529411764705882,0.65,0.470588235294118,"0","orthodox"
"5766",27,21,191,185,206,191,227,210,12,15,0,0,10,12,6,6,15,17,0,0,1,0,1,1,0.833333333333333,0.8,"0","orthodox"
"4431",23,22,173,173,173,183,136,136,21,12,0,11,18,4,1,0,-10,0,0,0,0,0,1,0.521739130434783,0.857142857142857,0.173913043478261,"0","orthodox"
"3208",19,24,179,173,182,180,155,164,43,97,9,16,6,11,-5,6,2,-9,0,0,0,0,0.826923076923077,0.858407079646018,0.115384615384615,0.0973451327433628,"0","orthodox"
"14",23,30,173,165,178,168,139,139,13,20,0,11,10,11,-7,8,10,0,0,0,0,0,1,0.645161290322581,0.769230769230769,0.354838709677419,"0","orthodox"
"3644",25,31,157,179,160,182,135,143,86,97,17,17,28,23,-6,-22,-22,-8,0,0,0,0,0.83495145631068,0.850877192982456,0.271844660194175,0.201754385964912,"0","Unknown"
"4496",31,22,171,185,178,180,147,147,28,28,1,1,19,19,9,-14,-2,0,0,0,0,0,0.96551724137931,0.96551724137931,0.655172413793103,0.655172413793103,"0","orthodox"
"3213",20,23,177,178,174,178,152,154,14,14,2,2,9,10,-3,-1,-4,-2,0,0,0,0,0.875,0.875,0.5625,0.625,"0","orthodox"
"9",18,28,175,173,179,183,147,147,22,16,0,1,15,15,-10,2,-4,0,0,0,0,0,1,0.941176470588235,0.681818181818182,0.882352941176471,"0","orthodox"
"2126",28,35,174,175,178,175,135,135,24,29,8,3,17,17,-7,-1,3,0,0,1,0,0,0.75,0.90625,0.53125,0.53125,"0","southpaw"
"4953",36,32,183,193,201,208,216,245,65,53,10,8,61,33,4,-10,-7,-29,1,0,0,1,0.866666666666667,0.868852459016393,0.813333333333333,0.540983606557377,"0","orthodox"
"2132",20,42,189,190,196,193,218,275,7,10,0,11,4,10,-22,-1,3,-57,0,1,0,1,1,0.476190476190476,0.571428571428571,0.476190476190476,"0","orthodox"
"2453",27,21,165,170,165,174,117,115,2,0,4,1,0,0,6,-5,-9,2,0,0,0,0,0.333333333333333,0,0,0,"0","southpaw"
"3425",24,27,175,173,183,177,145,145,25,84,2,17,12,37,-3,2,6,0,0,0,0,0,0.925925925925926,0.831683168316832,0.444444444444444,0.366336633663366,"0","orthodox"
"4297",22,33,175,163,180,163,146,145,18,67,0,32,14,20,-11,12,17,1,0,0,0,0,1,0.676767676767677,0.777777777777778,0.202020202020202,"0","orthodox"
"5486",23,32,193,191,203,198,220,226,23,17,0,5,18,13,-9,2,5,-6,0,0,0,0,1,0.772727272727273,0.782608695652174,0.590909090909091,"0","orthodox"
"5744",25,23,180,185,185,206,177,183,14,16,6,10,3,12,2,-5,-21,-6,0,0,0,0,0.7,0.615384615384615,0.15,0.461538461538462,"0","orthodox"
"1394",21,26,183,173,185,183,145,147,8,5,0,5,5,3,-5,10,2,-2,0,0,0,0,1,0.5,0.625,0.3,"0","orthodox"
"4322",31,31,163,164,165,165,130,130,43,24,3,13,32,16,0,-1,0,0,0,0,0,0,0.934782608695652,0.648648648648649,0.695652173913043,0.432432432432432,"0","orthodox"
"5390",28,30,157,160,160,178,105,105,15,36,0,17,12,17,-2,-3,-18,0,0,0,0,0,1,0.679245283018868,0.8,0.320754716981132,"0","orthodox"
"3599",24,24,166,160,160,157,107,107,22,23,0,3,13,7,0,6,3,0,0,0,0,0,1,0.884615384615385,0.590909090909091,0.269230769230769,"0","orthodox"
"3766",23,26,175,169,185,173,134,136,14,14,5,4,5,8,-3,6,12,-2,0,0,0,0,0.736842105263158,0.777777777777778,0.263157894736842,0.444444444444444,"0","orthodox"
"5588",31,28,188,193,191,201,190,208,59,11,13,4,39,4,3,-5,-10,-18,0,0,0,1,0.819444444444444,0.733333333333333,0.541666666666667,0.266666666666667,"0","orthodox"
"5069",24,19,178,175,183,185,180,170,11,0,4,1,3,0,5,3,-2,10,0,0,0,0,0.733333333333333,0,0.2,0,"0","Unknown"
"3456",23,27,170,179,170,173,141,140,7,16,0,0,6,9,-4,-9,-3,1,0,0,0,0,1,1,0.857142857142857,0.5625,"0","orthodox"
"4894",25,23,178,182,183,187,179,173,42,85,13,9,18,30,2,-4,-4,6,0,0,0,0,0.763636363636364,0.904255319148936,0.327272727272727,0.319148936170213,"0","orthodox"
"4554",32,34,189,196,208,206,232,237,39,29,5,2,32,23,-2,-7,2,-5,0,0,0,0,0.886363636363636,0.935483870967742,0.727272727272727,0.741935483870968,"0","orthodox"
"3714",36,30,183,191,188,213,201,219,48,18,14,0,31,16,6,-8,-25,-18,1,0,0,1,0.774193548387097,1,0.5,0.888888888888889,"0","orthodox"
"478",30,29,173,167,176,172,115,115,33,25,12,4,23,9,1,6,4,0,0,0,0,0,0.733333333333333,0.862068965517241,0.511111111111111,0.310344827586207,"0","southpaw"
"2763",23,27,170,162,170,163,125,126,19,20,1,5,14,11,-4,8,7,-1,0,0,0,0,0.95,0.8,0.7,0.44,"0","orthodox"
"4639",25,27,168,162,171,163,127,125,46,20,7,6,36,11,-2,6,8,2,0,0,0,0,0.867924528301887,0.769230769230769,0.679245283018868,0.423076923076923,"0","orthodox"
"4365",32,32,172,173,182,175,130,130,17,41,0,3,14,30,0,-1,7,0,0,0,0,0,1,0.931818181818182,0.823529411764706,0.681818181818182,"0","orthodox"
"1013",36,33,188,173,197,174,196,184,25,24,4,16,23,14,3,15,23,12,1,0,0,0,0.862068965517241,0.6,0.793103448275862,0.35,"0","orthodox"
"1746",20,23,170,170,188,175,132,132,1,6,0,0,1,3,-3,0,13,0,0,0,0,0,1,1,1,0.5,"0","orthodox"
"887",25,32,178,178,185,188,157,156,8,5,0,4,5,4,-7,0,-3,1,0,0,0,0,1,0.555555555555556,0.625,0.444444444444444,"0","southpaw"
"1927",22,39,163,160,168,168,118,118,12,27,0,17,7,18,-17,3,0,0,0,1,0,0,1,0.613636363636364,0.583333333333333,0.409090909090909,"0","southpaw"
"4628",34,35,188,180,203,183,203,218,29,33,4,13,21,17,-1,8,20,-15,0,1,0,1,0.878787878787879,0.717391304347826,0.636363636363636,0.369565217391304,"0","orthodox"
"2344",23,29,188,175,188,180,149,151,17,23,1,10,7,15,-6,13,8,-2,0,0,0,0,0.944444444444444,0.696969696969697,0.388888888888889,0.454545454545455,"0","orthodox"
"4031",25,21,175,193,178,198,187,211,64,29,11,6,26,21,4,-18,-20,-24,0,0,0,1,0.853333333333333,0.828571428571429,0.346666666666667,0.6,"0","southpaw"
"4608",27,28,175,178,188,185,140,140,24,28,2,0,13,11,-1,-3,3,0,0,0,0,0,0.923076923076923,1,0.5,0.392857142857143,"0","orthodox"
"1116",18,26,168,175,175,193,123,122,3,4,0,9,3,1,-8,-7,-18,1,0,0,0,0,1,0.307692307692308,1,0.0769230769230769,"0","orthodox"
"173",19,34,165,159,169,160,124,122,8,48,0,17,5,28,-15,6,9,2,0,0,0,0,1,0.738461538461539,0.625,0.430769230769231,"0","orthodox"
"806",28,27,182,191,178,188,153,153,34,23,1,1,21,13,1,-9,-10,0,0,0,0,0,0.971428571428571,0.958333333333333,0.6,0.541666666666667,"0","orthodox"
"5548",18,32,176,175,183,178,140,136,14,0,0,1,10,0,-14,1,5,4,0,0,0,0,1,0,0.714285714285714,0,"0","orthodox"
"3570",25,27,188,177,198,185,154,154,23,18,1,2,15,11,-2,11,13,0,0,0,0,0,0.958333333333333,0.9,0.625,0.55,"0","southpaw"
"3174",28,23,180,183,185,178,168,167,28,20,0,1,23,13,5,-3,7,1,0,0,0,0,1,0.952380952380952,0.821428571428571,0.619047619047619,"0","southpaw"
"1065",26,30,165,160,169,173,111,112,17,26,1,2,10,14,-4,5,-4,-1,0,0,0,0,0.944444444444444,0.928571428571429,0.555555555555556,0.5,"0","orthodox"
"2679",28,33,179,178,185,183,154,154,33,51,2,4,27,34,-5,1,2,0,0,0,0,0,0.942857142857143,0.927272727272727,0.771428571428571,0.618181818181818,"0","orthodox"
"1880",33,24,180,177,189,173,159,161,28,22,4,2,17,8,9,3,16,-2,0,0,0,0,0.875,0.916666666666667,0.53125,0.333333333333333,"0","orthodox"
"689",22,23,168,165,168,165,127,127,24,10,0,4,17,3,-1,3,3,0,0,0,0,0,1,0.714285714285714,0.708333333333333,0.214285714285714,"0","southpaw"
"1103",27,31,166,168,166,176,122,122,29,20,2,2,17,12,-4,-2,-10,0,0,0,0,0,0.935483870967742,0.909090909090909,0.548387096774194,0.545454545454545,"0","orthodox"
"4323",29,31,163,166,165,173,135,126,38,8,2,5,28,1,-2,-3,-8,9,0,0,0,0,0.95,0.615384615384615,0.7,0.0769230769230769,"0","orthodox"
"2440",23,27,177,169,175,175,146,147,4,17,0,12,3,12,-4,8,0,-1,0,0,0,0,1,0.586206896551724,0.75,0.413793103448276,"0","orthodox"
"5973",28,28,188,175,198,183,160,159,26,12,12,5,16,5,0,13,15,1,0,0,0,0,0.684210526315789,0.705882352941177,0.421052631578947,0.294117647058824,"0","southpaw"
"2844",23,27,178,179,188,188,147,147,23,45,0,3,14,28,-4,-1,0,0,0,0,0,0,1,0.9375,0.608695652173913,0.583333333333333,"0","orthodox"
"2531",26,34,170,180,178,183,142,139,9,39,4,32,3,34,-8,-10,-5,3,0,0,0,0,0.692307692307692,0.549295774647887,0.230769230769231,0.47887323943662,"0","southpaw"
"808",25,26,191,183,188,183,152,154,19,26,1,3,11,19,-1,8,5,-2,0,0,0,0,0.95,0.896551724137931,0.55,0.655172413793103,"0","orthodox"
"4881",25,29,179,184,185,193,205,199,36,26,4,4,28,16,-4,-5,-8,6,0,0,0,0,0.9,0.866666666666667,0.7,0.533333333333333,"0","orthodox"
"3505",20,24,189,183,193,178,167,178,2,20,0,9,1,4,-4,6,15,-11,0,0,0,0,1,0.689655172413793,0.5,0.137931034482759,"0","orthodox"
"4549",34,28,189,183,208,201,240,239,43,8,6,6,34,8,6,6,7,1,0,0,0,0,0.877551020408163,0.571428571428571,0.693877551020408,0.571428571428571,"0","orthodox"
"5430",35,27,197,183,199,208,196,195,38,13,5,1,33,6,8,14,-9,1,1,0,0,0,0.883720930232558,0.928571428571429,0.767441860465116,0.428571428571429,"0","southpaw"
"1874",35,41,178,178,178,189,168,166,26,22,8,26,24,16,-6,0,-11,2,1,1,0,0,0.764705882352941,0.458333333333333,0.705882352941177,0.333333333333333,"0","orthodox"
"4387",33,26,177,191,178,203,220,233,49,13,5,1,26,13,7,-14,-25,-13,0,0,0,0,0.907407407407407,0.928571428571429,0.481481481481481,0.928571428571429,"0","orthodox"
"4417",29,27,183,183,191,183,200,209,38,24,4,7,22,21,2,0,8,-9,0,0,0,0,0.904761904761905,0.774193548387097,0.523809523809524,0.67741935483871,"0","orthodox"
"5423",28,22,178,170,188,170,141,139,39,25,4,1,23,19,6,8,18,2,0,0,0,0,0.906976744186046,0.961538461538462,0.534883720930233,0.730769230769231,"0","orthodox"
"4686",20,28,173,170,182,170,148,146,17,117,6,33,13,57,-8,3,12,2,0,0,0,0,0.739130434782609,0.78,0.565217391304348,0.38,"0","Unknown"
"788",21,23,170,170,175,183,135,134,14,5,0,12,10,4,-2,0,-8,1,0,0,0,0,1,0.294117647058824,0.714285714285714,0.235294117647059,"0","orthodox"
"1150",26,33,178,185,183,208,148,150,12,10,3,11,6,7,-7,-7,-25,-2,0,0,0,0,0.8,0.476190476190476,0.4,0.333333333333333,"0","orthodox"
"4629",30,28,188,183,203,180,195,195,24,8,4,8,18,3,2,5,23,0,0,0,0,0,0.857142857142857,0.5,0.642857142857143,0.1875,"0","orthodox"
"427",31,31,191,189,203,191,199,200,21,21,0,1,20,21,0,2,12,-1,0,0,0,0,1,0.954545454545455,0.952380952380952,0.954545454545455,"0","orthodox"
"314",26,28,183,178,185,173,169,166,14,7,0,2,5,4,-2,5,12,3,0,0,0,0,1,0.777777777777778,0.357142857142857,0.444444444444444,"0","orthodox"
"3137",35,28,173,173,180,183,163,159,50,23,16,7,24,16,7,0,-3,4,1,0,0,0,0.757575757575758,0.766666666666667,0.363636363636364,0.533333333333333,"0","orthodox"
"663",29,26,173,169,174,171,153,154,18,5,0,0,7,4,3,4,3,-1,0,0,0,0,1,1,0.388888888888889,0.8,"0","orthodox"
"4312",25,27,178,170,188,175,155,152,35,20,1,1,21,8,-2,8,13,3,0,0,0,0,0.972222222222222,0.952380952380952,0.583333333333333,0.380952380952381,"0","orthodox"
"5217",24,25,191,185,196,203,213,216,19,22,0,1,16,17,-1,6,-7,-3,0,0,0,0,1,0.956521739130435,0.842105263157895,0.739130434782609,"0","orthodox"
"3048",31,23,184,185,188,193,209,191,50,19,5,1,23,16,8,-1,-5,18,0,0,1,0,0.909090909090909,0.95,0.418181818181818,0.8,"0","orthodox"
"5020",25,24,165,157,173,168,115,116,33,17,3,5,22,7,1,8,5,-1,0,0,0,0,0.916666666666667,0.772727272727273,0.611111111111111,0.318181818181818,"0","orthodox"
"2609",44,41,189,195,198,203,219,242,41,46,8,6,27,38,3,-6,-5,-23,1,1,0,1,0.836734693877551,0.884615384615385,0.551020408163265,0.730769230769231,"0","orthodox"
"930",20,35,168,170,170,173,128,128,9,19,0,12,4,4,-15,-2,-3,0,0,1,0,0,1,0.612903225806452,0.444444444444444,0.129032258064516,"0","orthodox"
"2605",28,27,171,173,169,175,145,142,74,23,0,3,62,14,1,-2,-6,3,0,0,0,0,1,0.884615384615385,0.837837837837838,0.538461538461538,"0","orthodox"
"5699",31,34,187,175,188,180,173,175,30,26,5,3,25,14,-3,12,8,-2,0,0,0,0,0.857142857142857,0.896551724137931,0.714285714285714,0.482758620689655,"0","orthodox"
"2853",27,30,166,160,170,160,124,126,75,105,11,22,47,25,-3,6,10,-2,0,0,0,0,0.872093023255814,0.826771653543307,0.546511627906977,0.196850393700787,"0","orthodox"
"1486",28,34,193,177,193,185,164,164,25,11,2,6,21,9,-6,16,8,0,0,0,0,0,0.925925925925926,0.647058823529412,0.777777777777778,0.529411764705882,"0","orthodox"
"1529",29,29,188,188,185,191,168,168,27,21,1,2,19,14,0,0,-6,0,0,0,0,0,0.964285714285714,0.91304347826087,0.678571428571429,0.608695652173913,"0","orthodox"
"3190",52,35,190,182,206,198,254,334,68,65,6,2,44,50,17,8,8,-80,1,1,0,1,0.918918918918919,0.970149253731343,0.594594594594595,0.746268656716418,"0","orthodox"
"3824",21,27,168,154,168,160,118,118,57,86,17,11,17,73,-6,14,8,0,0,0,0,0,0.77027027027027,0.88659793814433,0.22972972972973,0.752577319587629,"0","orthodox"
"1979",21,24,173,178,180,178,155,155,10,12,1,0,9,8,-3,-5,2,0,0,0,0,0,0.909090909090909,1,0.818181818181818,0.666666666666667,"0","southpaw"
"359",29,34,183,170,191,178,162,168,19,19,1,16,11,12,-5,13,13,-6,0,0,0,0,0.95,0.542857142857143,0.55,0.342857142857143,"0","orthodox"
"2654",31,23,179,188,191,193,208,219,61,24,10,3,53,19,8,-9,-2,-11,0,0,0,0,0.859154929577465,0.888888888888889,0.746478873239437,0.703703703703704,"0","orthodox"
"4932",29,25,166,170,177,180,126,126,34,22,2,0,21,16,4,-4,-3,0,0,0,0,0,0.944444444444444,1,0.583333333333333,0.727272727272727,"0","orthodox"
"2077",24,23,183,181,183,176,154,155,23,14,2,4,18,10,1,2,7,-1,0,0,0,0,0.92,0.777777777777778,0.72,0.555555555555556,"0","orthodox"
"5245",23,27,163,170,165,173,145,135,49,18,18,14,24,4,-4,-7,-8,10,0,0,0,0,0.73134328358209,0.5625,0.358208955223881,0.125,"0","Unknown"
"2879",30,29,173,171,183,165,147,145,38,43,0,0,24,31,1,2,18,2,0,0,0,0,1,1,0.631578947368421,0.720930232558139,"0","orthodox"
"1008",24,34,165,169,173,173,135,137,5,13,0,14,4,7,-10,-4,0,-2,0,0,0,0,1,0.481481481481481,0.8,0.259259259259259,"0","Unknown"
"3189",26,19,166,165,170,168,128,128,47,44,10,9,22,14,7,1,2,0,0,0,0,0,0.824561403508772,0.830188679245283,0.385964912280702,0.264150943396226,"0","orthodox"
"5645",31,32,191,198,201,208,230,235,19,22,2,1,14,18,-1,-7,-7,-5,0,0,0,0,0.904761904761905,0.956521739130435,0.666666666666667,0.782608695652174,"0","orthodox"
"1842",30,25,168,170,178,178,134,136,9,8,0,6,6,4,5,-2,0,-2,0,0,0,0,1,0.571428571428571,0.666666666666667,0.285714285714286,"0","orthodox"
"4816",28,25,193,183,208,185,252,196,0,2,1,0,0,2,3,10,23,56,0,0,1,0,0,1,0,1,"0","orthodox"
"1089",21,26,171,180,165,193,143,146,14,6,1,0,10,6,-5,-9,-28,-3,0,0,0,0,0.933333333333333,1,0.666666666666667,1,"0","orthodox"
"284",30,34,175,173,171,173,168,167,7,8,0,1,5,4,-4,2,-2,1,0,0,0,0,1,0.888888888888889,0.714285714285714,0.444444444444444,"0","orthodox"
"1441",24,29,175,174,175,179,130,130,17,19,1,4,5,14,-5,1,-4,0,0,0,0,0,0.944444444444444,0.826086956521739,0.277777777777778,0.608695652173913,"0","orthodox"
"2059",22,25,179,165,170,173,126,126,10,22,2,2,6,13,-3,14,-3,0,0,0,0,0,0.833333333333333,0.916666666666667,0.5,0.541666666666667,"0","orthodox"
"1783",36,26,166,170,178,188,131,131,29,25,4,1,14,15,10,-4,-10,0,1,0,0,0,0.878787878787879,0.961538461538462,0.424242424242424,0.576923076923077,"0","orthodox"
"103",29,29,160,174,166,180,108,108,28,16,1,2,16,9,0,-14,-14,0,0,0,0,0,0.96551724137931,0.888888888888889,0.551724137931034,0.5,"0","orthodox"
"5840",30,29,180,191,185,193,163,163,25,16,4,0,24,12,1,-11,-8,0,0,0,0,0,0.862068965517241,1,0.827586206896552,0.75,"0","orthodox"
"508",23,30,178,170,178,178,132,132,14,16,1,29,3,6,-7,8,0,0,0,0,0,0,0.933333333333333,0.355555555555556,0.2,0.133333333333333,"0","orthodox"
"5096",22,18,162,150,162,160,111,111,6,3,2,3,1,3,4,12,2,0,0,0,0,0,0.75,0.5,0.125,0.5,"0","orthodox"
"396",28,28,201,189,207,201,251,246,5,16,0,2,5,8,0,12,6,5,0,0,0,0,1,0.888888888888889,1,0.444444444444444,"0","orthodox"
"3287",23,24,179,174,182,173,172,165,101,65,22,16,8,24,-1,5,9,7,0,0,0,0,0.821138211382114,0.802469135802469,0.0650406504065041,0.296296296296296,"0","orthodox"
"1237",27,19,168,178,183,183,150,149,12,8,3,1,11,4,8,-10,0,1,0,0,0,0,0.8,0.888888888888889,0.733333333333333,0.444444444444444,"0","orthodox"
"2820",27,24,168,172,175,175,135,135,24,26,1,2,13,16,3,-4,0,0,0,0,0,0,0.96,0.928571428571429,0.52,0.571428571428571,"0","southpaw"
"5863",32,38,188,180,206,198,242,232,34,18,2,7,25,7,-6,8,8,10,0,1,0,0,0.944444444444444,0.72,0.694444444444444,0.28,"0","orthodox"
"875",25,23,175,178,177,180,142,141,11,6,0,8,9,2,2,-3,-3,1,0,0,0,0,1,0.428571428571429,0.818181818181818,0.142857142857143,"0","orthodox"
"2919",28,29,185,172,191,178,158,160,21,26,1,14,16,11,-1,13,13,-2,0,0,0,0,0.954545454545455,0.65,0.727272727272727,0.275,"0","orthodox"
"5498",39,34,171,178,173,180,162,161,94,22,15,5,75,19,5,-7,-7,1,1,0,0,0,0.862385321100917,0.814814814814815,0.688073394495413,0.703703703703704,"0","orthodox"
"1954",21,21,165,164,165,163,119,119,6,3,0,0,2,2,0,1,2,0,0,0,0,0,1,1,0.333333333333333,0.666666666666667,"0","orthodox"
"1102",24,27,175,169,178,175,147,147,9,15,0,9,5,11,-3,6,3,0,0,0,0,0,1,0.625,0.555555555555556,0.458333333333333,"0","Unknown"
"6036",18,27,178,170,183,173,133,133,11,24,2,5,3,20,-9,8,10,0,0,0,0,0,0.846153846153846,0.827586206896552,0.230769230769231,0.689655172413793,"0","orthodox"
"126",20,28,168,165,173,168,130,130,10,5,0,3,8,0,-8,3,5,0,0,0,0,0,1,0.625,0.8,0,"0","orthodox"
"4664",32,35,175,179,175,181,154,154,26,44,5,2,22,27,-3,-4,-6,0,0,1,0,0,0.838709677419355,0.956521739130435,0.709677419354839,0.58695652173913,"0","orthodox"
"645",24,26,170,175,173,173,136,136,23,34,0,7,12,21,-2,-5,0,0,0,0,0,0,1,0.829268292682927,0.521739130434783,0.51219512195122,"0","southpaw"
"3151",28,26,168,183,175,188,140,139,29,28,1,1,14,26,2,-15,-13,1,0,0,0,0,0.966666666666667,0.96551724137931,0.466666666666667,0.896551724137931,"0","southpaw"
"3334",30,22,178,185,189,182,187,166,50,32,11,8,27,7,8,-7,7,21,0,0,1,0,0.819672131147541,0.8,0.442622950819672,0.175,"0","orthodox"
"3612",28,24,168,168,173,171,135,132,62,54,13,24,24,24,4,0,2,3,0,0,0,0,0.826666666666667,0.692307692307692,0.32,0.307692307692308,"0","orthodox"
"4171",31,28,187,178,188,178,215,233,33,38,2,2,19,33,3,9,10,-18,0,0,0,1,0.942857142857143,0.95,0.542857142857143,0.825,"0","southpaw"
"1815",38,36,169,173,174,173,147,146,28,42,0,10,9,21,2,-4,1,1,1,1,0,0,1,0.807692307692308,0.321428571428571,0.403846153846154,"0","orthodox"
"5515",31,34,188,196,196,206,227,236,30,29,2,1,27,23,-3,-8,-10,-9,0,0,0,0,0.9375,0.966666666666667,0.84375,0.766666666666667,"0","orthodox"
"2916",39,34,185,177,191,185,159,160,43,36,2,4,31,27,5,8,6,-1,1,0,0,0,0.955555555555556,0.9,0.688888888888889,0.675,"0","orthodox"
"789",29,29,170,170,175,173,137,139,18,14,0,17,10,8,0,0,2,-2,0,0,0,0,1,0.451612903225806,0.555555555555556,0.258064516129032,"0","orthodox"
"1195",20,21,170,170,169,168,122,122,10,11,0,2,6,5,-1,0,1,0,0,0,0,0,1,0.846153846153846,0.6,0.384615384615385,"0","southpaw"
"5964",21,19,159,168,163,168,105,105,15,9,0,11,12,4,2,-9,-5,0,0,0,0,0,1,0.45,0.8,0.2,"0","orthodox"
"794",24,28,183,178,183,183,160,162,10,23,0,3,9,13,-4,5,0,-2,0,0,0,0,1,0.884615384615385,0.9,0.5,"0","orthodox"
"4574",34,28,190,196,201,208,234,233,32,14,4,0,19,10,6,-6,-7,1,0,0,0,0,0.888888888888889,1,0.527777777777778,0.714285714285714,"0","orthodox"
"2640",27,27,171,185,188,194,165,196,76,22,7,8,42,19,0,-14,-6,-31,0,0,0,1,0.91566265060241,0.733333333333333,0.506024096385542,0.633333333333333,"0","orthodox"
"791",25,28,165,163,170,160,122,123,20,16,1,0,11,9,-3,2,10,-1,0,0,0,0,0.952380952380952,1,0.523809523809524,0.5625,"0","orthodox"
"5152",27,20,165,169,165,175,124,128,48,25,11,10,20,10,7,-4,-10,-4,0,0,0,0,0.813559322033898,0.714285714285714,0.338983050847458,0.285714285714286,"0","Unknown"
"1960",28,28,163,157,169,163,113,115,34,22,2,7,25,12,0,6,6,-2,0,0,0,0,0.944444444444444,0.758620689655172,0.694444444444444,0.413793103448276,"0","orthodox"
"1858",28,31,180,175,188,183,140,140,27,37,2,3,18,27,-3,5,5,0,0,0,0,0,0.931034482758621,0.925,0.620689655172414,0.675,"0","orthodox"
"2349",20,25,187,175,188,176,169,170,10,10,0,1,3,3,-5,12,12,-1,0,0,0,0,1,0.909090909090909,0.3,0.272727272727273,"0","orthodox"
"2787",28,30,174,180,180,183,146,147,32,30,0,3,30,19,-2,-6,-3,-1,0,0,0,0,1,0.909090909090909,0.9375,0.575757575757576,"0","orthodox"
"2140",42,48,179,182,183,193,251,238,25,31,17,9,21,17,-6,-3,-10,13,1,1,0,0,0.595238095238095,0.775,0.5,0.425,"0","orthodox"
"5981",23,26,163,168,165,166,116,118,21,26,1,14,18,21,-3,-5,-1,-2,0,0,0,0,0.954545454545455,0.65,0.818181818181818,0.525,"0","orthodox"
"291",25,28,166,170,165,183,126,124,4,17,0,4,3,14,-3,-4,-18,2,0,0,0,0,1,0.80952380952381,0.75,0.666666666666667,"0","orthodox"
"5711",26,24,185,191,191,196,217,250,30,31,1,4,16,24,2,-6,-5,-33,0,0,0,1,0.967741935483871,0.885714285714286,0.516129032258065,0.685714285714286,"0","orthodox"
"1908",22,33,163,170,160,175,138,137,3,1,1,8,2,0,-11,-7,-15,1,0,0,0,0,0.75,0.111111111111111,0.5,0,"0","Unknown"
"1972",24,21,173,173,175,191,136,137,14,8,0,0,9,5,3,0,-16,-1,0,0,0,0,1,1,0.642857142857143,0.625,"0","orthodox"
"5937",25,25,173,178,175,183,130,131,11,15,0,2,7,10,0,-5,-8,-1,0,0,0,0,1,0.882352941176471,0.636363636363636,0.588235294117647,"0","orthodox"
"5034",24,27,175,168,170,168,123,122,26,20,2,16,17,13,-3,7,2,1,0,0,0,0,0.928571428571429,0.555555555555556,0.607142857142857,0.361111111111111,"0","orthodox"
"4247",27,25,170,171,177,177,122,122,49,23,3,1,34,18,2,-1,0,0,0,0,0,0,0.942307692307692,0.958333333333333,0.653846153846154,0.75,"0","orthodox"
"1830",22,37,202,185,201,191,258,222,7,29,1,17,6,16,-15,17,10,36,0,1,1,0,0.875,0.630434782608696,0.75,0.347826086956522,"0","orthodox"
"2242",23,21,165,175,170,175,127,127,12,17,4,7,6,12,2,-10,-5,0,0,0,0,0,0.75,0.708333333333333,0.375,0.5,"0","orthodox"
"1929",36,33,185,177,196,175,156,155,35,15,12,15,23,6,3,8,21,1,1,0,0,0,0.74468085106383,0.5,0.48936170212766,0.2,"0","orthodox"
"3496",32,34,175,168,173,174,154,146,127,91,24,23,60,44,-2,7,-1,8,0,0,0,0,0.841059602649007,0.798245614035088,0.397350993377483,0.385964912280702,"0","orthodox"
"6073",35,35,165,165,166,170,124,122,21,41,9,26,16,31,0,0,-4,2,1,1,0,0,0.7,0.611940298507463,0.533333333333333,0.462686567164179,"0","orthodox"
"189",32,32,173,169,178,168,130,130,23,25,1,3,17,15,0,4,10,0,0,0,0,0,0.958333333333333,0.892857142857143,0.708333333333333,0.535714285714286,"0","orthodox"
"2803",35,28,173,173,180,183,163,159,50,23,16,7,24,16,7,0,-3,4,1,0,0,0,0.757575757575758,0.766666666666667,0.363636363636364,0.533333333333333,"0","orthodox"
"1897",31,28,178,188,183,198,195,197,57,14,4,1,37,11,3,-10,-15,-2,0,0,0,0,0.934426229508197,0.933333333333333,0.60655737704918,0.733333333333333,"0","orthodox"
"5087",23,22,159,156,163,152,105,105,24,22,1,7,18,11,1,3,11,0,0,0,0,0,0.96,0.758620689655172,0.72,0.379310344827586,"0","orthodox"
"5388",30,22,173,170,173,170,142,139,34,24,5,0,18,18,8,3,3,3,0,0,0,0,0.871794871794872,1,0.461538461538462,0.75,"0","orthodox"
"2270",23,32,173,168,173,183,129,130,26,34,0,5,19,23,-9,5,-10,-1,0,0,0,0,1,0.871794871794872,0.730769230769231,0.58974358974359,"0","orthodox"
"624",30,34,169,166,168,173,130,129,22,37,1,3,12,19,-4,3,-5,1,0,0,0,0,0.956521739130435,0.925,0.521739130434783,0.475,"0","orthodox"
"1225",25,36,178,180,183,188,146,146,33,12,8,6,23,9,-11,-2,-5,0,0,1,0,0,0.804878048780488,0.666666666666667,0.560975609756098,0.5,"0","orthodox"
"5378",26,21,180,179,183,175,148,146,21,18,0,15,12,11,5,1,8,2,0,0,0,0,1,0.545454545454545,0.571428571428571,0.333333333333333,"0","orthodox"
"1716",29,16,170,161,180,162,117,118,18,7,3,0,11,3,13,9,18,-1,0,0,0,0,0.857142857142857,1,0.523809523809524,0.428571428571429,"0","southpaw"
"3774",34,29,169,173,175,173,153,152,61,31,3,10,29,13,5,-4,2,1,0,0,0,0,0.953125,0.75609756097561,0.453125,0.317073170731707,"0","southpaw"
"5205",25,32,168,163,165,168,139,139,19,97,4,19,10,64,-7,5,-3,0,0,0,0,0,0.826086956521739,0.836206896551724,0.434782608695652,0.551724137931034,"0","orthodox"
"2485",20,34,170,168,166,180,118,118,18,24,0,29,15,11,-14,2,-14,0,0,0,0,0,1,0.452830188679245,0.833333333333333,0.207547169811321,"0","orthodox"
"6087",26,33,180,173,175,173,157,154,29,14,5,0,24,13,-7,7,2,3,0,0,0,0,0.852941176470588,1,0.705882352941177,0.928571428571429,"0","orthodox"
"3260",23,27,185,180,196,178,175,185,46,144,4,31,34,22,-4,5,18,-10,0,0,0,0,0.92,0.822857142857143,0.68,0.125714285714286,"0","orthodox"
"4856",39,35,188,180,198,185,250,239,47,25,4,10,37,13,4,8,13,11,1,1,0,0,0.92156862745098,0.714285714285714,0.725490196078431,0.371428571428571,"0","southpaw"
"4166",27,23,168,168,178,168,146,141,49,33,16,12,22,16,4,0,10,5,0,0,0,0,0.753846153846154,0.733333333333333,0.338461538461538,0.355555555555556,"0","orthodox"
"5326",18,22,164,170,165,173,126,119,40,33,5,12,6,20,-4,-6,-8,7,0,0,0,0,0.888888888888889,0.733333333333333,0.133333333333333,0.444444444444444,"0","Unknown"
"5985",37,35,177,173,175,183,160,162,25,12,1,34,19,4,2,4,-8,-2,1,1,0,0,0.961538461538462,0.260869565217391,0.730769230769231,0.0869565217391304,"0","southpaw"
"925",26,38,178,178,187,178,164,168,3,5,0,9,3,1,-12,0,9,-4,0,1,0,0,1,0.357142857142857,1,0.0714285714285714,"0","orthodox"
"2301",26,35,170,163,168,170,120,120,16,15,2,10,6,6,-9,7,-2,0,0,1,0,0,0.888888888888889,0.6,0.333333333333333,0.24,"0","orthodox"
"3890",23,35,184,174,178,183,175,174,4,39,0,12,4,12,-12,10,-5,1,0,1,0,0,1,0.764705882352941,1,0.235294117647059,"0","orthodox"
"2767",27,25,178,171,183,168,130,129,58,43,5,8,48,32,2,7,15,1,0,0,0,0,0.920634920634921,0.843137254901961,0.761904761904762,0.627450980392157,"0","orthodox"
"3074",35,26,165,168,165,173,107,107,50,17,0,2,37,9,9,-3,-8,0,1,0,0,0,1,0.894736842105263,0.74,0.473684210526316,"0","orthodox"
"1825",29,30,180,183,185,185,163,163,17,22,5,1,11,6,-1,-3,0,0,0,0,0,0,0.772727272727273,0.956521739130435,0.5,0.260869565217391,"0","orthodox"
"4690",25,26,165,157,174,168,127,125,27,47,9,7,7,31,-1,8,6,2,0,0,0,0,0.75,0.87037037037037,0.194444444444444,0.574074074074074,"0","orthodox"
"1682",30,29,168,168,175,178,135,135,37,27,1,1,32,16,1,0,-3,0,0,0,0,0,0.973684210526316,0.964285714285714,0.842105263157895,0.571428571428571,"0","orthodox"
"2355",20,41,183,173,188,185,149,146,23,44,0,11,12,18,-21,10,3,3,0,1,0,0,1,0.8,0.521739130434783,0.327272727272727,"0","orthodox"
"4594",23,27,168,173,178,185,138,138,58,77,5,17,7,43,-4,-5,-7,0,0,0,0,0,0.920634920634921,0.819148936170213,0.111111111111111,0.457446808510638,"0","orthodox"
"2070",24,21,170,178,170,180,133,134,1,1,0,0,0,1,3,-8,-10,-1,0,0,0,0,1,1,0,1,"0","orthodox"
"233",26,28,175,170,183,172,114,115,18,19,3,0,16,3,-2,5,11,-1,0,0,0,0,0.857142857142857,1,0.761904761904762,0.157894736842105,"0","southpaw"
"237",29,31,175,175,183,188,139,140,30,28,1,5,15,16,-2,0,-5,-1,0,0,0,0,0.967741935483871,0.848484848484849,0.483870967741935,0.484848484848485,"0","orthodox"
"5487",23,28,193,188,203,188,222,231,22,14,0,4,17,6,-5,5,15,-9,0,0,0,0,1,0.777777777777778,0.772727272727273,0.333333333333333,"0","orthodox"
"4634",18,34,168,171,180,165,153,147,19,22,1,13,12,13,-16,-3,15,6,0,0,0,0,0.95,0.628571428571429,0.6,0.371428571428571,"0","orthodox"
"5229",25,26,187,173,185,173,159,159,14,23,0,3,8,10,-1,14,12,0,0,0,0,0,1,0.884615384615385,0.571428571428571,0.384615384615385,"0","orthodox"
"2528",25,34,178,180,183,183,151,149,25,45,2,39,12,37,-9,-2,0,2,0,0,0,0,0.925925925925926,0.535714285714286,0.444444444444444,0.44047619047619,"0","orthodox"
"424",24,26,187,173,192,177,161,159,22,22,0,2,12,5,-2,14,15,2,0,0,0,0,1,0.916666666666667,0.545454545454545,0.208333333333333,"0","orthodox"
"946",28,27,191,188,192,192,262,242,5,9,0,3,3,2,1,3,0,20,0,0,1,0,1,0.75,0.6,0.166666666666667,"0","orthodox"
"3934",24,31,188,183,188,180,189,189,16,14,0,18,15,5,-7,5,8,0,0,0,0,0,1,0.4375,0.9375,0.15625,"0","southpaw"
"5459",20,24,168,170,177,170,123,123,12,19,0,5,7,8,-4,-2,7,0,0,0,0,0,1,0.791666666666667,0.583333333333333,0.333333333333333,"0","orthodox"
"2699",33,26,171,169,183,170,147,145,76,40,5,2,52,26,7,2,13,2,0,0,0,0,0.938271604938272,0.952380952380952,0.641975308641975,0.619047619047619,"0","orthodox"
"5979",23,24,198,185,202,193,200,189,31,40,1,8,21,31,-1,13,9,11,0,0,0,0,0.96875,0.833333333333333,0.65625,0.645833333333333,"0","orthodox"
"6045",27,35,185,181,201,199,244,228,19,35,0,20,17,30,-8,4,2,16,0,1,1,0,1,0.636363636363636,0.894736842105263,0.545454545454545,"0","orthodox"
"1603",35,40,168,168,170,183,130,131,28,46,8,20,15,30,-5,0,-13,-1,1,1,0,0,0.777777777777778,0.696969696969697,0.416666666666667,0.454545454545455,"0","orthodox"
"5616",36,34,185,180,196,181,153,154,35,23,3,6,22,17,2,5,15,-1,1,0,0,0,0.921052631578947,0.793103448275862,0.578947368421053,0.586206896551724,"0","southpaw"
"3690",25,30,177,175,180,175,146,146,31,25,2,3,11,22,-5,2,5,0,0,0,0,0,0.939393939393939,0.892857142857143,0.333333333333333,0.785714285714286,"0","southpaw"
"3338",31,21,180,175,191,175,160,158,78,17,3,0,32,8,10,5,16,2,0,0,0,0,0.962962962962963,1,0.395061728395062,0.470588235294118,"0","orthodox"
"3528",21,22,164,169,169,173,126,127,21,10,2,0,16,6,-1,-5,-4,-1,0,0,0,0,0.91304347826087,1,0.695652173913043,0.6,"0","orthodox"
"5299",30,31,175,170,188,175,124,125,28,21,2,0,22,16,-1,5,13,-1,0,0,0,0,0.933333333333333,1,0.733333333333333,0.761904761904762,"0","southpaw"
"2234",22,28,177,170,175,183,147,147,3,10,0,4,2,7,-6,7,-8,0,0,0,0,0,1,0.714285714285714,0.666666666666667,0.5,"0","orthodox"
"520",31,27,175,178,175,185,148,147,19,24,3,2,9,16,4,-3,-10,1,0,0,0,0,0.863636363636364,0.923076923076923,0.409090909090909,0.615384615384615,"0","orthodox"
"1844",29,23,168,178,178,180,142,141,7,6,0,5,5,2,6,-10,-2,1,0,0,0,0,1,0.545454545454545,0.714285714285714,0.181818181818182,"0","orthodox"
"4339",36,37,188,198,198,208,233,268,42,38,7,8,29,23,-1,-10,-10,-35,1,1,0,1,0.857142857142857,0.826086956521739,0.591836734693878,0.5,"0","orthodox"
"598",20,31,170,168,180,173,128,128,12,20,0,16,6,9,-11,2,7,0,0,0,0,0,1,0.555555555555556,0.5,0.25,"0","orthodox"
"4063",24,23,165,163,170,163,125,125,18,15,0,4,10,6,1,2,7,0,0,0,0,0,1,0.789473684210526,0.555555555555556,0.315789473684211,"0","orthodox"
"5528",24,30,188,183,196,180,220,201,11,11,0,17,11,3,-6,5,16,19,0,0,1,0,1,0.392857142857143,1,0.107142857142857,"0","orthodox"
"1153",21,23,178,188,183,196,153,154,6,5,0,6,3,3,-2,-10,-13,-1,0,0,0,0,1,0.454545454545455,0.5,0.272727272727273,"0","orthodox"
"621",31,23,180,188,179,194,160,160,23,22,0,0,14,18,8,-8,-15,0,0,0,0,0,1,1,0.608695652173913,0.818181818181818,"0","southpaw"
"317",26,30,170,175,170,178,141,140,8,16,0,1,6,12,-4,-5,-8,1,0,0,0,0,1,0.941176470588235,0.75,0.705882352941177,"0","orthodox"
"4742",23,28,160,163,168,165,111,111,7,14,0,15,5,10,-5,-3,3,0,0,0,0,0,1,0.482758620689655,0.714285714285714,0.344827586206897,"0","southpaw"
"3321",27,30,182,182,193,188,163,172,57,121,4,6,45,93,-3,0,5,-9,0,0,0,0,0.934426229508197,0.952755905511811,0.737704918032787,0.732283464566929,"0","Unknown"
"2085",24,32,170,168,180,173,130,130,12,24,0,11,10,14,-8,2,7,0,0,0,0,0,1,0.685714285714286,0.833333333333333,0.4,"0","southpaw"
"1600",23,26,173,173,175,173,127,128,16,15,0,2,7,9,-3,0,2,-1,0,0,0,0,1,0.882352941176471,0.4375,0.529411764705882,"0","orthodox"
"5972",29,35,188,183,198,185,162,168,31,29,12,8,21,16,-6,5,13,-6,0,1,0,0,0.720930232558139,0.783783783783784,0.488372093023256,0.432432432432432,"0","southpaw"
"559",23,24,170,164,168,170,118,117,29,46,0,2,18,31,-1,6,-2,1,0,0,0,0,1,0.958333333333333,0.620689655172414,0.645833333333333,"0","orthodox"
"5500",26,33,178,171,178,173,154,153,33,86,1,7,21,70,-7,7,5,1,0,0,0,0,0.970588235294118,0.924731182795699,0.617647058823529,0.752688172043011,"0","orthodox"
"963",25,25,165,174,168,178,119,119,11,20,1,3,4,18,0,-9,-10,0,0,0,0,0,0.916666666666667,0.869565217391304,0.333333333333333,0.782608695652174,"0","orthodox"
"492",26,33,172,172,176,171,122,122,13,24,1,7,4,7,-7,0,5,0,0,0,0,0,0.928571428571429,0.774193548387097,0.285714285714286,0.225806451612903,"0","orthodox"
"2993",30,24,173,187,180,193,169,173,228,45,14,4,41,16,6,-14,-13,-4,0,0,0,0,0.942148760330578,0.918367346938776,0.169421487603306,0.326530612244898,"0","orthodox"
"3746",25,27,159,160,165,169,125,126,36,59,5,12,16,21,-2,-1,-4,-1,0,0,0,0,0.878048780487805,0.830985915492958,0.390243902439024,0.295774647887324,"0","orthodox"
"1309",23,26,163,165,173,175,122,121,9,12,1,7,1,3,-3,-2,-2,1,0,0,0,0,0.9,0.631578947368421,0.1,0.157894736842105,"0","southpaw"
"4111",24,26,193,182,193,191,180,190,23,39,2,6,18,23,-2,11,2,-10,0,0,0,0,0.92,0.866666666666667,0.72,0.511111111111111,"0","orthodox"
"2797",23,26,168,170,170,178,146,139,48,114,7,21,18,61,-3,-2,-8,7,0,0,0,0,0.872727272727273,0.844444444444444,0.327272727272727,0.451851851851852,"0","orthodox"
"5501",32,33,171,175,173,178,154,158,82,13,6,1,69,9,-1,-4,-5,-4,0,0,0,0,0.931818181818182,0.928571428571429,0.784090909090909,0.642857142857143,"0","orthodox"
"3140",30,29,183,185,185,182,189,178,72,77,6,17,40,21,1,-2,3,11,0,0,0,0,0.923076923076923,0.819148936170213,0.512820512820513,0.223404255319149,"0","orthodox"
"130",25,22,178,173,183,178,131,129,14,18,0,5,12,9,3,5,5,2,0,0,0,0,1,0.782608695652174,0.857142857142857,0.391304347826087,"0","southpaw"
"2922",29,28,191,191,198,193,227,256,32,29,1,2,26,20,1,0,5,-29,0,0,0,1,0.96969696969697,0.935483870967742,0.787878787878788,0.645161290322581,"0","orthodox"
"3591",19,22,170,170,175,170,132,133,52,25,1,10,36,8,-3,0,5,-1,0,0,0,0,0.981132075471698,0.714285714285714,0.679245283018868,0.228571428571429,"0","Unknown"
"2384",34,34,188,185,198,191,206,235,41,13,2,10,33,9,0,3,7,-29,0,0,0,1,0.953488372093023,0.565217391304348,0.767441860465116,0.391304347826087,"0","southpaw"
"5004",25,31,198,175,213,183,247,240,54,77,5,25,48,54,-6,23,30,7,0,0,0,0,0.915254237288136,0.754901960784314,0.813559322033898,0.529411764705882,"0","orthodox"
"5576",27,26,170,165,175,164,126,126,34,29,1,2,15,19,1,5,11,0,0,0,0,0,0.971428571428571,0.935483870967742,0.428571428571429,0.612903225806452,"0","southpaw"
"1507",26,40,191,178,194,183,250,226,14,15,0,3,8,6,-14,13,11,24,0,1,1,0,1,0.833333333333333,0.571428571428571,0.333333333333333,"0","orthodox"
"2194",29,31,191,188,203,191,227,244,18,23,2,2,9,12,-2,3,12,-17,0,0,0,1,0.9,0.92,0.45,0.48,"0","orthodox"
"3305",23,29,178,191,180,197,217,215,37,20,1,4,33,14,-6,-13,-17,2,0,0,0,0,0.973684210526316,0.833333333333333,0.868421052631579,0.583333333333333,"0","orthodox"
"1365",25,35,178,175,178,184,150,150,24,13,0,9,19,13,-10,3,-6,0,0,1,0,0,1,0.590909090909091,0.791666666666667,0.590909090909091,"0","orthodox"
"4102",21,25,173,163,178,163,132,131,77,46,4,12,8,8,-4,10,15,1,0,0,0,0,0.950617283950617,0.793103448275862,0.0987654320987654,0.137931034482759,"0","orthodox"
"868",28,31,175,178,177,180,142,146,25,18,0,7,18,5,-3,-3,-3,-4,0,0,0,0,1,0.72,0.72,0.2,"0","orthodox"
"1472",37,30,170,171,178,175,137,140,37,18,19,0,22,3,7,-1,3,-3,1,0,0,0,0.660714285714286,1,0.392857142857143,0.166666666666667,"0","southpaw"
"2421",36,41,201,196,210,211,240,238,11,14,0,7,6,13,-5,5,-1,2,1,1,0,0,1,0.666666666666667,0.545454545454545,0.619047619047619,"0","orthodox"
"341",33,33,168,165,170,164,130,130,42,53,12,4,29,33,0,3,6,0,0,0,0,0,0.777777777777778,0.929824561403509,0.537037037037037,0.578947368421053,"0","orthodox"
"652",29,38,191,188,198,198,222,231,23,44,1,8,21,30,-9,3,0,-9,0,1,0,0,0.958333333333333,0.846153846153846,0.875,0.576923076923077,"0","orthodox"
"2739",25,23,163,168,165,165,133,130,97,93,14,5,30,40,2,-5,0,3,0,0,0,0,0.873873873873874,0.948979591836735,0.27027027027027,0.408163265306122,"0","orthodox"
"4603",21,23,182,182,187,187,173,164,74,72,7,11,25,43,-2,0,0,9,0,0,0,0,0.91358024691358,0.867469879518072,0.308641975308642,0.518072289156627,"0","Unknown"
"3079",37,28,182,188,182,199,158,195,58,27,8,5,51,15,9,-6,-17,-37,1,0,0,1,0.878787878787879,0.84375,0.772727272727273,0.46875,"0","orthodox"
"411",26,33,188,175,189,183,170,171,20,14,0,17,17,10,-7,13,6,-1,0,0,0,0,1,0.451612903225806,0.85,0.32258064516129,"0","orthodox"
"3910",22,29,158,165,159,161,105,105,16,25,2,6,7,10,-7,-7,-2,0,0,0,0,0,0.888888888888889,0.806451612903226,0.388888888888889,0.32258064516129,"0","orthodox"
"2913",42,35,185,179,191,183,170,170,47,51,4,3,32,25,7,6,8,0,1,1,0,0,0.92156862745098,0.944444444444444,0.627450980392157,0.462962962962963,"0","orthodox"
"2917",38,33,185,175,191,184,160,159,42,34,2,2,31,25,5,10,7,1,1,0,0,0,0.954545454545455,0.944444444444444,0.704545454545455,0.694444444444444,"0","orthodox"
"475",22,32,173,170,175,168,133,135,16,30,2,5,7,26,-10,3,7,-2,0,0,0,0,0.888888888888889,0.857142857142857,0.388888888888889,0.742857142857143,"0","orthodox"
"5265",26,33,183,168,183,165,155,155,32,20,2,18,23,3,-7,15,18,0,0,0,0,0,0.941176470588235,0.526315789473684,0.676470588235294,0.0789473684210526,"0","southpaw"
"94",32,33,183,183,180,184,175,175,30,30,0,0,15,26,-1,0,-4,0,0,0,0,0,1,1,0.5,0.866666666666667,"0","orthodox"
"2343",27,30,183,178,186,178,160,160,4,3,3,2,1,1,-3,5,8,0,0,0,0,0,0.571428571428571,0.6,0.142857142857143,0.2,"0","orthodox"
"564",24,27,168,165,165,175,122,122,26,33,0,9,18,27,-3,3,-10,0,0,0,0,0,1,0.785714285714286,0.692307692307692,0.642857142857143,"0","orthodox"
"5739",26,36,180,180,193,185,186,203,13,107,2,51,5,36,-10,0,8,-17,0,1,0,1,0.866666666666667,0.677215189873418,0.333333333333333,0.227848101265823,"0","orthodox"
"3676",25,22,171,184,183,193,165,167,153,19,8,3,53,9,3,-13,-10,-2,0,0,0,0,0.950310559006211,0.863636363636364,0.329192546583851,0.409090909090909,"0","orthodox"
"2050",24,20,165,163,170,173,114,114,8,6,4,0,5,4,4,2,-3,0,0,0,0,0,0.666666666666667,1,0.416666666666667,0.666666666666667,"0","orthodox"
"4833",27,29,171,168,179,170,142,141,28,25,4,2,23,13,-2,3,9,1,0,0,0,0,0.875,0.925925925925926,0.71875,0.481481481481481,"0","orthodox"
"1701",21,22,173,175,173,173,137,139,7,0,2,1,5,0,-1,-2,0,-2,0,0,0,0,0.777777777777778,0,0.555555555555556,0,"0","orthodox"
"2631",33,29,171,180,188,201,190,176,118,114,15,8,69,64,4,-9,-13,14,0,0,0,0,0.887218045112782,0.934426229508197,0.518796992481203,0.524590163934426,"0","orthodox"
"4562",23,32,189,185,208,183,234,237,16,14,0,31,14,9,-9,4,25,-3,0,0,0,0,1,0.311111111111111,0.875,0.2,"0","orthodox"
"3760",25,24,179,168,182,173,140,135,58,62,4,12,14,27,1,11,9,5,0,0,0,0,0.935483870967742,0.837837837837838,0.225806451612903,0.364864864864865,"0","orthodox"
"5792",26,26,191,180,193,183,245,221,21,26,0,1,19,18,0,11,10,24,0,0,1,0,1,0.962962962962963,0.904761904761905,0.666666666666667,"0","orthodox"
"2433",33,27,180,183,183,188,235,213,31,31,2,9,20,19,6,-3,-5,22,0,0,1,0,0.939393939393939,0.775,0.606060606060606,0.475,"0","orthodox"
"2240",27,25,165,175,170,193,120,120,3,2,1,5,3,0,2,-10,-23,0,0,0,0,0,0.75,0.285714285714286,0.75,0,"0","Unknown"
"3933",25,34,188,188,188,203,188,188,20,30,0,4,18,22,-9,0,-15,0,0,0,0,0,1,0.882352941176471,0.9,0.647058823529412,"0","southpaw"
"3720",23,24,185,184,196,193,185,187,48,46,4,7,36,18,-1,1,3,-2,0,0,0,0,0.923076923076923,0.867924528301887,0.692307692307692,0.339622641509434,"0","orthodox"
"6054",22,27,185,178,198,178,178,178,6,4,0,9,5,1,-5,7,20,0,0,0,0,0,1,0.307692307692308,0.833333333333333,0.0769230769230769,"0","orthodox"
"1731",23,25,173,173,179,175,140,140,9,9,0,1,3,5,-2,0,4,0,0,0,0,0,1,0.9,0.333333333333333,0.5,"0","Unknown"
"1439",24,26,180,171,188,184,157,157,20,10,1,4,15,4,-2,9,4,0,0,0,0,0,0.952380952380952,0.714285714285714,0.714285714285714,0.285714285714286,"0","orthodox"
"3792",27,32,171,175,187,185,140,140,31,55,5,7,22,40,-5,-4,2,0,0,0,0,0,0.861111111111111,0.887096774193548,0.611111111111111,0.645161290322581,"0","orthodox"
"5041",27,27,179,183,188,178,168,166,17,26,0,6,14,17,0,-4,10,2,0,0,0,0,1,0.8125,0.823529411764706,0.53125,"0","orthodox"
"4766",21,42,178,179,178,185,152,152,11,65,1,24,8,50,-21,-1,-7,0,0,1,0,0,0.916666666666667,0.730337078651685,0.666666666666667,0.561797752808989,"0","orthodox"
"2214",37,37,180,188,183,191,227,213,36,20,5,13,23,9,0,-8,-8,14,1,1,0,0,0.878048780487805,0.606060606060606,0.560975609756098,0.272727272727273,"0","orthodox"
"446",28,24,163,168,174,170,108,108,29,32,2,5,25,17,4,-5,4,0,0,0,0,0,0.935483870967742,0.864864864864865,0.806451612903226,0.459459459459459,"0","orthodox"
"4666",24,20,179,179,181,175,140,140,10,16,0,12,7,9,4,0,6,0,0,0,0,0,1,0.571428571428571,0.7,0.321428571428571,"0","orthodox"
"5669",28,38,175,175,180,185,147,147,28,88,5,13,12,58,-10,0,-5,0,0,1,0,0,0.848484848484849,0.871287128712871,0.363636363636364,0.574257425742574,"0","orthodox"
"647",23,30,170,175,173,178,137,137,19,28,0,10,9,24,-7,-5,-5,0,0,0,0,0,1,0.736842105263158,0.473684210526316,0.631578947368421,"0","southpaw"
"3603",23,28,168,165,168,168,119,119,80,131,23,32,28,11,-5,3,0,0,0,0,0,0,0.776699029126214,0.803680981595092,0.271844660194175,0.0674846625766871,"0","orthodox"
"1063",27,28,191,191,213,188,225,244,13,25,0,1,6,18,-1,0,25,-19,0,0,0,1,1,0.961538461538462,0.461538461538462,0.692307692307692,"0","orthodox"
"2216",29,22,165,168,169,168,117,117,2,8,0,2,0,0,7,-3,1,0,0,0,0,0,1,0.8,0,0,"0","southpaw"
"4849",26,29,194,188,215,198,215,206,36,11,6,4,29,7,-3,6,17,9,0,0,0,0,0.857142857142857,0.733333333333333,0.69047619047619,0.466666666666667,"0","southpaw"
"5978",34,22,173,188,173,198,160,162,15,14,1,7,14,9,12,-15,-25,-2,0,0,0,0,0.9375,0.666666666666667,0.875,0.428571428571429,"0","orthodox"
"6030",26,27,178,170,183,170,135,135,24,21,3,3,15,11,-1,8,13,0,0,0,0,0,0.888888888888889,0.875,0.555555555555556,0.458333333333333,"0","orthodox"
"2759",25,28,170,163,170,168,127,130,28,23,1,11,21,18,-3,7,2,-3,0,0,0,0,0.96551724137931,0.676470588235294,0.724137931034483,0.529411764705882,"0","orthodox"
"2606",26,29,171,169,169,163,135,134,61,101,0,6,50,82,-3,2,6,1,0,0,0,0,1,0.94392523364486,0.819672131147541,0.766355140186916,"0","orthodox"
"3351",30,28,160,165,165,165,118,118,20,17,1,4,14,12,2,-5,0,0,0,0,0,0,0.952380952380952,0.80952380952381,0.666666666666667,0.571428571428571,"0","orthodox"
"5090",24,21,175,173,175,178,131,135,9,5,0,3,6,1,3,2,-3,-4,0,0,0,0,1,0.625,0.666666666666667,0.125,"0","orthodox"
"972",20,22,168,173,170,173,133,135,2,1,1,2,2,0,-2,-5,-3,-2,0,0,0,0,0.666666666666667,0.333333333333333,0.666666666666667,0,"0","orthodox"
"4413",30,34,188,175,193,178,179,178,33,18,2,2,20,15,-4,13,15,1,0,0,0,0,0.942857142857143,0.9,0.571428571428571,0.75,"0","orthodox"
"1308",22,32,180,179,188,185,158,155,15,48,0,9,15,40,-10,1,3,3,0,0,0,0,1,0.842105263157895,1,0.701754385964912,"0","Unknown"
"4720",25,26,178,173,185,183,158,161,36,17,1,3,7,11,-1,5,2,-3,0,0,0,0,0.972972972972973,0.85,0.189189189189189,0.55,"0","orthodox"
"742",24,29,183,171,193,184,165,160,11,16,0,12,8,6,-5,12,9,5,0,0,0,0,1,0.571428571428571,0.727272727272727,0.214285714285714,"0","orthodox"
"5026",27,28,173,175,180,185,139,140,23,16,1,1,5,9,-1,-2,-5,-1,0,0,0,0,0.958333333333333,0.941176470588235,0.208333333333333,0.529411764705882,"0","orthodox"
"2525",33,36,168,180,178,183,143,144,29,52,3,51,17,42,-3,-12,-5,-1,0,1,0,0,0.90625,0.504854368932039,0.53125,0.407766990291262,"0","orthodox"
"5015",30,35,175,173,193,175,168,168,30,63,3,3,23,42,-5,2,18,0,0,1,0,0,0.909090909090909,0.954545454545455,0.696969696969697,0.636363636363636,"0","orthodox"
"5966",25,33,185,180,188,193,166,163,6,69,1,25,4,50,-8,5,-5,3,0,0,0,0,0.857142857142857,0.734042553191489,0.571428571428571,0.531914893617021,"0","southpaw"
"470",29,30,173,170,175,175,132,132,29,19,6,13,16,7,-1,3,0,0,0,0,0,0,0.828571428571429,0.59375,0.457142857142857,0.21875,"0","orthodox"
"273",27,28,166,168,173,160,115,114,22,27,1,4,14,12,-1,-2,13,1,0,0,0,0,0.956521739130435,0.870967741935484,0.608695652173913,0.387096774193548,"0","orthodox"
"2713",34,32,184,179,188,175,212,193,53,51,5,15,25,34,2,5,13,19,0,0,1,0,0.913793103448276,0.772727272727273,0.431034482758621,0.515151515151515,"0","orthodox"
"1027",26,30,165,160,169,173,111,112,17,26,1,2,10,14,-4,5,-4,-1,0,0,0,0,0.944444444444444,0.928571428571429,0.555555555555556,0.5,"0","orthodox"
"4250",31,24,166,170,173,177,122,122,27,39,0,2,12,30,7,-4,-4,0,0,0,0,0,1,0.951219512195122,0.444444444444444,0.731707317073171,"0","orthodox"
"1708",26,28,166,175,173,185,135,135,16,18,0,3,7,12,-2,-9,-12,0,0,0,0,0,1,0.857142857142857,0.4375,0.571428571428571,"0","orthodox"
"928",34,22,166,168,164,169,114,115,33,13,2,1,27,9,12,-2,-5,-1,0,0,0,0,0.942857142857143,0.928571428571429,0.771428571428571,0.642857142857143,"0","southpaw"
"184",21,38,163,157,168,168,116,116,13,28,0,40,13,16,-17,6,0,0,0,1,0,0,1,0.411764705882353,1,0.235294117647059,"0","orthodox"
"764",31,37,187,182,183,188,168,166,28,29,0,0,23,16,-6,5,-5,2,0,1,0,0,1,1,0.821428571428571,0.551724137931034,"0","southpaw"
"2906",24,29,183,180,185,191,174,171,37,80,4,11,19,62,-5,3,-6,3,0,0,0,0,0.902439024390244,0.879120879120879,0.463414634146341,0.681318681318681,"0","orthodox"
"4535",30,26,192,183,198,185,223,248,27,16,3,2,18,10,4,9,13,-25,0,0,0,1,0.9,0.888888888888889,0.6,0.555555555555556,"0","orthodox"
"4994",28,24,165,157,173,152,112,112,40,25,3,7,23,13,4,8,21,0,0,0,0,0,0.930232558139535,0.78125,0.534883720930233,0.40625,"0","orthodox"
"5850",35,33,191,188,196,193,252,230,59,50,1,4,42,41,2,3,3,22,1,0,1,0,0.983333333333333,0.925925925925926,0.7,0.759259259259259,"0","orthodox"
"819",26,28,171,170,179,168,126,126,33,32,1,3,20,23,-2,1,11,0,0,0,0,0,0.970588235294118,0.914285714285714,0.588235294117647,0.657142857142857,"0","orthodox"
"5044",24,36,179,178,188,188,168,165,2,14,0,7,2,11,-12,1,0,3,0,1,0,0,1,0.666666666666667,1,0.523809523809524,"0","orthodox"
"841",21,30,175,165,175,178,149,150,11,26,2,25,5,22,-9,10,-3,-1,0,0,0,0,0.846153846153846,0.509803921568627,0.384615384615385,0.431372549019608,"0","orthodox"
"1705",24,26,160,155,163,161,105,105,25,4,4,1,15,1,-2,5,2,0,0,0,0,0,0.862068965517241,0.8,0.517241379310345,0.2,"0","southpaw"
"2894",26,27,180,180,184,178,152,148,79,30,1,20,53,4,-1,0,6,4,0,0,0,0,0.9875,0.6,0.6625,0.08,"0","orthodox"
"1867",41,24,188,192,191,195,232,221,27,16,6,4,19,11,17,-4,-4,11,1,0,0,0,0.818181818181818,0.8,0.575757575757576,0.55,"0","southpaw"
"862",32,39,188,191,196,202,239,258,18,15,1,31,17,10,-7,-3,-6,-19,0,1,0,1,0.947368421052632,0.326086956521739,0.894736842105263,0.217391304347826,"0","orthodox"
"5886",38,35,188,191,193,213,220,215,46,4,3,2,40,2,3,-3,-20,5,1,1,0,0,0.938775510204082,0.666666666666667,0.816326530612245,0.333333333333333,"0","orthodox"
"1956",20,33,163,160,165,168,108,108,14,25,1,5,12,17,-13,3,-3,0,0,0,0,0,0.933333333333333,0.833333333333333,0.8,0.566666666666667,"0","southpaw"
"3225",25,22,173,168,180,178,122,122,42,43,2,0,26,31,3,5,2,0,0,0,0,0,0.954545454545455,1,0.590909090909091,0.720930232558139,"0","orthodox"
"5202",25,31,165,170,170,175,115,114,21,23,1,4,14,12,-6,-5,-5,1,0,0,0,0,0.954545454545455,0.851851851851852,0.636363636363636,0.444444444444444,"0","southpaw"
"4647",29,34,196,182,203,188,236,224,16,22,3,7,11,11,-5,14,15,12,0,0,0,0,0.842105263157895,0.758620689655172,0.578947368421053,0.379310344827586,"0","orthodox"
"708",33,34,185,188,194,193,175,176,33,23,4,4,18,17,-1,-3,1,-1,0,0,0,0,0.891891891891892,0.851851851851852,0.486486486486487,0.62962962962963,"0","southpaw"
"3845",48,24,174,175,178,175,147,147,30,8,3,7,18,8,24,-1,3,0,1,0,0,0,0.909090909090909,0.533333333333333,0.545454545454545,0.533333333333333,"0","orthodox"
"179",25,35,183,183,192,191,180,179,1,17,0,21,1,9,-10,0,1,1,0,1,0,0,1,0.447368421052632,1,0.236842105263158,"0","orthodox"
"5125",27,26,166,159,170,160,119,118,33,36,1,5,25,25,1,7,10,1,0,0,0,0,0.970588235294118,0.878048780487805,0.735294117647059,0.609756097560976,"0","orthodox"
"2664",28,28,173,180,180,191,165,181,196,22,10,27,33,14,0,-7,-11,-16,0,0,0,1,0.951456310679612,0.448979591836735,0.160194174757282,0.285714285714286,"0","orthodox"
"1484",44,34,193,173,193,184,239,205,39,16,3,10,30,9,10,20,9,34,1,0,1,0,0.928571428571429,0.615384615384615,0.714285714285714,0.346153846153846,"0","orthodox"
"5635",27,25,180,173,185,178,147,147,22,43,3,3,18,33,2,7,7,0,0,0,0,0,0.88,0.934782608695652,0.72,0.717391304347826,"0","orthodox"
"1275",28,23,173,178,173,173,133,135,25,15,4,4,12,8,5,-5,0,-2,0,0,0,0,0.862068965517241,0.789473684210526,0.413793103448276,0.421052631578947,"0","southpaw"
"4405",21,27,180,165,180,173,135,134,33,43,1,4,25,29,-6,15,7,1,0,0,0,0,0.970588235294118,0.914893617021277,0.735294117647059,0.617021276595745,"0","orthodox"
"3597",29,21,166,163,160,163,111,112,43,15,2,4,28,10,8,3,-3,-1,0,0,0,0,0.955555555555556,0.789473684210526,0.622222222222222,0.526315789473684,"0","orthodox"
"2360",27,31,173,175,185,178,134,135,25,30,1,2,13,25,-4,-2,7,-1,0,0,0,0,0.961538461538462,0.9375,0.5,0.78125,"0","orthodox"
"529",29,33,182,186,195,196,188,194,9,7,0,10,5,5,-4,-4,-1,-6,0,0,0,0,1,0.411764705882353,0.555555555555556,0.294117647058824,"0","southpaw"
"20",29,32,179,173,178,180,160,158,20,27,0,7,17,17,-3,6,-2,2,0,0,0,0,1,0.794117647058823,0.85,0.5,"0","orthodox"
"1185",27,30,173,165,178,175,135,135,25,37,4,18,18,29,-3,8,3,0,0,0,0,0,0.862068965517241,0.672727272727273,0.620689655172414,0.527272727272727,"0","orthodox"
"3982",24,28,157,165,160,173,131,127,40,43,7,11,28,28,-4,-8,-13,4,0,0,0,0,0.851063829787234,0.796296296296296,0.595744680851064,0.518518518518518,"0","Unknown"
"5339",31,24,152,168,165,168,105,105,33,22,1,2,28,19,7,-16,-3,0,0,0,0,0,0.970588235294118,0.916666666666667,0.823529411764706,0.791666666666667,"0","orthodox"
"2878",32,36,173,170,183,170,146,142,39,50,0,4,25,37,-4,3,13,4,0,1,0,0,1,0.925925925925926,0.641025641025641,0.685185185185185,"0","orthodox"
"969",26,31,168,168,170,168,134,133,29,7,1,12,21,1,-5,0,2,1,0,0,0,0,0.966666666666667,0.368421052631579,0.7,0.0526315789473684,"0","orthodox"
"3123",26,33,174,170,180,170,135,135,26,45,0,4,24,30,-7,4,10,0,0,0,0,0,1,0.918367346938776,0.923076923076923,0.612244897959184,"0","orthodox"
"4214",27,24,166,170,168,168,118,117,21,14,0,6,8,5,3,-4,0,1,0,0,0,0,1,0.7,0.380952380952381,0.25,"0","southpaw"
"3701",22,22,168,170,178,175,136,136,96,36,5,12,21,8,0,-2,3,0,0,0,0,0,0.95049504950495,0.75,0.207920792079208,0.166666666666667,"0","southpaw"
"1919",24,23,168,173,175,173,133,133,9,16,2,1,6,10,1,-5,2,0,0,0,0,0,0.818181818181818,0.941176470588235,0.545454545454545,0.588235294117647,"0","southpaw"
"5017",23,33,170,173,175,178,126,125,12,24,1,5,4,10,-10,-3,-3,1,0,0,0,0,0.923076923076923,0.827586206896552,0.307692307692308,0.344827586206897,"0","orthodox"
"1105",30,26,168,174,176,178,118,118,18,22,0,3,10,16,4,-6,-2,0,0,0,0,0,1,0.88,0.555555555555556,0.64,"0","orthodox"
"5777",35,42,198,177,208,188,275,226,33,29,6,17,21,15,-7,21,20,49,1,1,1,0,0.846153846153846,0.630434782608696,0.538461538461538,0.326086956521739,"0","orthodox"
"5901",27,35,171,170,173,175,146,142,23,19,2,14,6,10,-8,1,-2,4,0,1,0,0,0.92,0.575757575757576,0.24,0.303030303030303,"0","orthodox"
"6006",31,28,168,171,180,175,126,126,26,12,4,1,17,9,3,-3,5,0,0,0,0,0,0.866666666666667,0.923076923076923,0.566666666666667,0.692307692307692,"0","southpaw"
"5076",27,25,177,173,173,183,140,140,38,23,4,15,26,14,2,4,-10,0,0,0,0,0,0.904761904761905,0.605263157894737,0.619047619047619,0.368421052631579,"0","orthodox"
"1535",23,24,168,180,175,173,132,131,11,14,0,0,3,9,-1,-12,2,1,0,0,0,0,1,1,0.272727272727273,0.642857142857143,"0","southpaw"
"4904",26,28,185,188,191,196,265,223,33,30,1,2,18,23,-2,-3,-5,42,0,0,1,0,0.970588235294118,0.9375,0.529411764705882,0.71875,"0","orthodox"
"4278",25,31,185,191,196,198,209,195,25,34,2,13,18,26,-6,-6,-2,14,0,0,0,0,0.925925925925926,0.723404255319149,0.666666666666667,0.553191489361702,"0","orthodox"
"4400",22,31,177,188,178,198,210,215,16,29,1,6,9,15,-9,-11,-20,-5,0,0,0,0,0.941176470588235,0.828571428571429,0.529411764705882,0.428571428571429,"0","orthodox"
"1138",19,23,171,177,183,181,141,140,7,3,0,6,6,1,-4,-6,2,1,0,0,0,0,1,0.333333333333333,0.857142857142857,0.111111111111111,"0","southpaw"
"267",23,34,180,175,184,188,153,153,14,30,0,6,8,20,-11,5,-4,0,0,0,0,0,1,0.833333333333333,0.571428571428571,0.555555555555556,"0","orthodox"
"215",32,36,193,185,213,201,236,215,14,32,0,13,12,28,-4,8,12,21,0,1,1,0,1,0.711111111111111,0.857142857142857,0.622222222222222,"0","southpaw"
"1574",31,36,183,188,190,196,237,247,21,12,3,12,16,6,-5,-5,-6,-10,0,1,0,0,0.875,0.5,0.666666666666667,0.25,"0","orthodox"
"5800",29,29,175,183,180,185,154,152,16,9,1,0,12,5,0,-8,-5,2,0,0,0,0,0.941176470588235,1,0.705882352941177,0.555555555555556,"0","orthodox"
"6034",24,31,178,170,183,178,140,144,16,4,2,13,11,1,-7,8,5,-4,0,0,0,0,0.888888888888889,0.235294117647059,0.611111111111111,0.0588235294117647,"0","orthodox"
"1391",28,25,183,178,185,183,147,147,22,26,2,2,13,12,3,5,2,0,0,0,0,0,0.916666666666667,0.928571428571429,0.541666666666667,0.428571428571429,"0","orthodox"
"2860",31,47,191,190,196,206,247,248,31,65,0,5,19,42,-16,1,-10,-1,0,1,0,0,1,0.928571428571429,0.612903225806452,0.6,"0","orthodox"
"4196",25,34,197,175,216,185,264,187,53,38,4,42,43,9,-9,22,31,77,0,0,1,0,0.929824561403509,0.475,0.754385964912281,0.1125,"0","orthodox"
"3514",23,32,172,165,176,173,145,143,26,53,0,13,18,14,-9,7,3,2,0,0,0,0,1,0.803030303030303,0.692307692307692,0.212121212121212,"0","orthodox"
"1127",34,24,171,170,183,175,138,138,41,26,7,0,28,15,10,1,8,0,0,0,0,0,0.854166666666667,1,0.583333333333333,0.576923076923077,"0","southpaw"
"1141",35,32,163,174,165,178,130,129,23,26,4,7,11,20,3,-11,-13,1,1,0,0,0,0.851851851851852,0.787878787878788,0.407407407407407,0.606060606060606,"0","southpaw"
"3500",25,24,175,173,173,185,135,133,100,66,12,8,50,39,1,2,-12,2,0,0,0,0,0.892857142857143,0.891891891891892,0.446428571428571,0.527027027027027,"0","orthodox"
"148",34,30,177,185,183,185,168,168,26,16,3,0,13,11,4,-8,-2,0,0,0,0,0,0.896551724137931,1,0.448275862068966,0.6875,"0","Unknown"
"3353",34,32,188,170,191,178,175,175,20,44,1,3,17,29,2,18,13,0,0,0,0,0,0.952380952380952,0.936170212765957,0.80952380952381,0.617021276595745,"0","southpaw"
"3147",33,24,168,182,175,185,147,146,39,20,1,0,16,13,9,-14,-10,1,0,0,0,0,0.975,1,0.4,0.65,"0","southpaw"
"3706",30,28,177,180,180,180,153,153,40,21,2,3,30,15,2,-3,0,0,0,0,0,0,0.952380952380952,0.875,0.714285714285714,0.625,"0","orthodox"
"3558",19,26,168,169,165,175,125,126,39,40,0,39,22,9,-7,-1,-10,-1,0,0,0,0,1,0.506329113924051,0.564102564102564,0.113924050632911,"0","orthodox"
"1148",27,34,178,175,183,188,150,150,16,30,3,5,8,20,-7,3,-5,0,0,0,0,0,0.842105263157895,0.857142857142857,0.421052631578947,0.571428571428571,"0","orthodox"
"2648",29,25,188,198,193,206,216,236,72,20,6,23,43,12,4,-10,-13,-20,0,0,0,1,0.923076923076923,0.465116279069767,0.551282051282051,0.27906976744186,"0","orthodox"
"5434",31,36,175,168,178,161,134,134,29,37,2,8,24,27,-5,7,17,0,0,1,0,0,0.935483870967742,0.822222222222222,0.774193548387097,0.6,"0","orthodox"
"2482",25,24,178,178,182,182,140,140,8,5,0,10,3,2,1,0,0,0,0,0,0,0,1,0.333333333333333,0.375,0.133333333333333,"0","orthodox"
"1743",19,27,175,170,175,188,130,130,23,27,1,2,19,15,-8,5,-13,0,0,0,0,0,0.958333333333333,0.931034482758621,0.791666666666667,0.517241379310345,"0","southpaw"
"4588",33,18,163,168,174,164,112,112,31,10,2,0,20,7,15,-5,10,0,0,0,0,0,0.939393939393939,1,0.606060606060606,0.7,"0","orthodox"
"2388",26,29,183,185,189,191,221,225,9,7,2,1,2,3,-3,-2,-2,-4,0,0,0,0,0.818181818181818,0.875,0.181818181818182,0.375,"0","orthodox"
"5479",33,36,193,196,203,208,253,265,43,25,4,6,37,16,-3,-3,-5,-12,0,1,0,0,0.914893617021277,0.806451612903226,0.787234042553192,0.516129032258065,"0","orthodox"
"2674",22,27,173,179,180,197,157,160,54,23,8,15,8,9,-5,-6,-17,-3,0,0,0,0,0.870967741935484,0.605263157894737,0.129032258064516,0.236842105263158,"0","orthodox"
"2963",33,36,171,178,188,188,198,198,120,103,16,20,70,64,-3,-7,0,0,0,1,0,0,0.882352941176471,0.83739837398374,0.514705882352941,0.520325203252033,"0","orthodox"
"1875",33,40,178,178,178,189,160,161,23,22,6,20,21,16,-7,0,-11,-1,0,1,0,0,0.793103448275862,0.523809523809524,0.724137931034483,0.380952380952381,"0","orthodox"
"286",33,25,166,170,165,170,133,133,24,16,1,1,17,3,8,-4,-5,0,0,0,0,0,0.96,0.941176470588235,0.68,0.176470588235294,"0","orthodox"
"2737",26,28,163,165,165,170,135,136,113,81,16,14,35,24,-2,-2,-5,-1,0,0,0,0,0.875968992248062,0.852631578947368,0.271317829457364,0.252631578947368,"0","orthodox"
"6081",20,24,170,163,180,157,132,133,10,10,0,0,7,3,-4,7,23,-1,0,0,0,0,1,1,0.7,0.3,"0","orthodox"
"4265",20,25,173,160,178,160,126,126,42,32,3,10,21,18,-5,13,18,0,0,0,0,0,0.933333333333333,0.761904761904762,0.466666666666667,0.428571428571429,"0","orthodox"
"1669",28,40,185,175,196,183,172,177,19,47,1,27,9,26,-12,10,13,-5,0,1,0,0,0.95,0.635135135135135,0.45,0.351351351351351,"0","Unknown"
"2624",25,31,189,185,198,203,202,210,18,38,0,13,14,29,-6,4,-5,-8,0,0,0,0,1,0.745098039215686,0.777777777777778,0.568627450980392,"0","orthodox"
"4220",29,33,170,168,180,165,126,126,45,54,1,8,31,31,-4,2,15,0,0,0,0,0,0.978260869565217,0.870967741935484,0.673913043478261,0.5,"0","southpaw"
"900",33,31,161,160,170,165,112,111,47,35,7,2,28,22,2,1,5,1,0,0,0,0,0.87037037037037,0.945945945945946,0.518518518518518,0.594594594594595,"0","orthodox"
"2424",28,30,193,196,208,211,269,240,7,9,0,1,3,9,-2,-3,-3,29,0,0,1,0,1,0.9,0.428571428571429,0.9,"0","orthodox"
"2616",26,31,188,189,198,198,214,214,34,30,0,1,30,22,-5,-1,0,0,0,0,0,0,1,0.967741935483871,0.882352941176471,0.709677419354839,"0","southpaw"
"2877",33,38,173,174,183,180,146,147,40,46,0,5,25,39,-5,-1,3,-1,0,1,0,0,1,0.901960784313726,0.625,0.764705882352941,"0","orthodox"
"3757",22,24,196,187,206,198,225,220,25,18,0,1,22,15,-2,9,8,5,0,0,0,0,1,0.947368421052632,0.88,0.789473684210526,"0","orthodox"
"4602",22,23,182,182,187,187,168,170,78,78,8,12,27,43,-1,0,0,-2,0,0,0,0,0.906976744186046,0.866666666666667,0.313953488372093,0.477777777777778,"0","Unknown"
"5052",26,28,180,193,188,209,204,207,72,88,30,32,38,39,-2,-13,-21,-3,0,0,0,0,0.705882352941177,0.733333333333333,0.372549019607843,0.325,"0","Unknown"
"583",25,29,178,175,180,178,147,146,13,27,0,3,7,26,-4,3,2,1,0,0,0,0,1,0.9,0.538461538461538,0.866666666666667,"0","orthodox"
"1132",27,26,171,177,183,180,146,147,32,34,2,2,23,11,1,-6,3,-1,0,0,0,0,0.941176470588235,0.944444444444444,0.676470588235294,0.305555555555556,"0","southpaw"
"2665",27,30,173,174,180,180,164,163,192,95,10,26,32,35,-3,-1,0,1,0,0,0,0,0.95049504950495,0.785123966942149,0.158415841584158,0.289256198347107,"0","orthodox"
"1773",23,20,170,185,178,190,140,141,6,0,0,4,6,0,3,-15,-12,-1,0,0,0,0,1,0,1,0,"0","orthodox"
"5986",32,24,177,174,175,175,154,154,22,22,0,0,17,22,8,3,0,0,0,0,0,0,1,1,0.772727272727273,1,"0","southpaw"
"1226",25,30,178,173,183,173,146,146,32,19,8,2,22,10,-5,5,10,0,0,0,0,0,0.8,0.904761904761905,0.55,0.476190476190476,"0","orthodox"
"4016",28,27,175,179,185,187,162,161,34,21,7,5,16,6,1,-4,-2,1,0,0,0,0,0.829268292682927,0.807692307692308,0.390243902439024,0.230769230769231,"0","Unknown"
"824",24,38,187,188,188,201,254,216,7,26,0,17,4,11,-14,-1,-13,38,0,1,1,0,1,0.604651162790698,0.571428571428571,0.255813953488372,"0","orthodox"
"3815",23,23,163,157,168,165,122,119,54,32,5,5,16,12,0,6,3,3,0,0,0,0,0.915254237288136,0.864864864864865,0.271186440677966,0.324324324324324,"0","Unknown"
"1445",25,26,168,172,175,178,131,131,11,8,0,0,5,7,-1,-4,-3,0,0,0,0,0,1,1,0.454545454545455,0.875,"0","orthodox"
"5601",31,31,193,188,201,196,247,238,33,24,3,6,27,17,0,5,5,9,0,0,0,0,0.916666666666667,0.8,0.75,0.566666666666667,"0","orthodox"
"3943",27,38,168,163,173,165,126,126,16,40,3,8,12,27,-11,5,8,0,0,1,0,0,0.842105263157895,0.833333333333333,0.631578947368421,0.5625,"0","orthodox"
"2593",21,26,188,189,193,206,198,210,21,40,0,8,17,30,-5,-1,-13,-12,0,0,0,0,1,0.833333333333333,0.80952380952381,0.625,"0","orthodox"
"1851",31,30,179,160,170,169,130,130,31,36,6,2,16,20,1,19,1,0,0,0,0,0,0.837837837837838,0.947368421052632,0.432432432432432,0.526315789473684,"0","orthodox"
"1315",23,33,173,173,188,185,133,132,26,30,0,12,19,18,-10,0,3,1,0,0,0,0,1,0.714285714285714,0.730769230769231,0.428571428571429,"0","orthodox"
"1182",25,27,178,166,182,173,144,140,23,26,2,28,16,21,-2,12,9,4,0,0,0,0,0.92,0.481481481481481,0.64,0.388888888888889,"0","orthodox"
"3085",21,28,165,165,175,173,133,126,87,96,19,10,33,19,-7,0,2,7,0,0,0,0,0.820754716981132,0.905660377358491,0.311320754716981,0.179245283018868,"0","orthodox"
"4650",22,31,187,180,222,188,193,181,48,72,13,45,15,17,-9,7,34,12,0,0,0,0,0.786885245901639,0.615384615384615,0.245901639344262,0.145299145299145,"0","Unknown"
"3899",26,34,185,183,188,188,168,167,36,38,0,6,27,14,-8,2,0,1,0,0,0,0,1,0.863636363636364,0.75,0.318181818181818,"0","orthodox"
"1713",23,28,185,188,187,201,168,168,13,19,2,1,12,15,-5,-3,-14,0,0,0,0,0,0.866666666666667,0.95,0.8,0.75,"0","orthodox"
"632",28,26,175,173,183,178,147,147,23,23,2,3,12,16,2,2,5,0,0,0,0,0,0.92,0.884615384615385,0.48,0.615384615384615,"0","southpaw"
"4532",33,39,192,198,198,201,238,226,34,19,3,2,22,14,-6,-6,-3,12,0,1,0,0,0.918918918918919,0.904761904761905,0.594594594594595,0.666666666666667,"0","orthodox"
"5808",30,27,201,188,218,196,224,222,18,14,0,3,12,12,3,13,22,2,0,0,0,0,1,0.823529411764706,0.666666666666667,0.705882352941177,"0","orthodox"
"3782",28,31,166,165,175,173,124,125,30,25,1,2,27,8,-3,1,2,-1,0,0,0,0,0.967741935483871,0.925925925925926,0.870967741935484,0.296296296296296,"0","southpaw"
"2724",32,40,171,173,183,180,157,167,63,60,11,18,20,27,-8,-2,3,-10,0,1,0,0,0.851351351351351,0.769230769230769,0.27027027027027,0.346153846153846,"0","orthodox"
"5255",21,28,198,193,213,209,230,240,36,88,3,31,33,39,-7,5,4,-10,0,0,0,0,0.923076923076923,0.739495798319328,0.846153846153846,0.327731092436975,"0","orthodox"
"5022",23,26,165,160,173,157,112,111,26,24,2,8,17,8,-3,5,16,1,0,0,0,0,0.928571428571429,0.75,0.607142857142857,0.25,"0","orthodox"
"1114",25,22,180,180,183,183,159,159,3,2,1,1,3,0,3,0,0,0,0,0,0,0,0.75,0.666666666666667,0.75,0,"0","orthodox"
"5198",32,28,193,198,206,213,241,235,39,16,8,7,28,12,4,-5,-7,6,0,0,0,0,0.829787234042553,0.695652173913043,0.595744680851064,0.521739130434783,"0","orthodox"
"4757",30,30,188,178,191,187,173,180,53,77,12,11,37,62,0,10,4,-7,0,0,0,0,0.815384615384615,0.875,0.569230769230769,0.704545454545455,"0","orthodox"
"1098",34,30,183,183,185,179,160,160,27,23,3,1,9,14,4,0,6,0,0,0,0,0,0.9,0.958333333333333,0.3,0.583333333333333,"0","orthodox"
"545",21,22,180,180,185,178,151,147,17,16,3,1,10,10,-1,0,7,4,0,0,0,0,0.85,0.941176470588235,0.5,0.588235294117647,"0","orthodox"
"4896",22,29,175,173,183,178,145,135,83,141,25,20,49,49,-7,2,5,10,0,0,0,0,0.768518518518518,0.875776397515528,0.453703703703704,0.304347826086957,"0","Unknown"
"1821",30,26,165,168,165,183,130,130,39,43,2,1,28,25,4,-3,-18,0,0,0,0,0,0.951219512195122,0.977272727272727,0.682926829268293,0.568181818181818,"0","orthodox"
"5827",22,24,187,189,203,185,198,205,21,32,3,14,10,14,-2,-2,18,-7,0,0,0,0,0.875,0.695652173913043,0.416666666666667,0.304347826086957,"0","Unknown"
"4160",31,23,168,170,178,170,147,148,102,84,24,17,61,40,8,-2,8,-1,0,0,0,0,0.80952380952381,0.831683168316832,0.484126984126984,0.396039603960396,"0","orthodox"
"3044",31,25,170,173,168,178,152,149,75,29,4,8,56,26,6,-3,-10,3,0,0,0,0,0.949367088607595,0.783783783783784,0.708860759493671,0.702702702702703,"0","orthodox"
"2299",27,22,183,169,183,173,168,159,3,10,5,5,0,7,5,14,10,9,0,0,0,0,0.375,0.666666666666667,0,0.466666666666667,"0","Unknown"
"4551",34,32,189,188,208,180,261,238,41,25,6,3,33,7,2,1,28,23,0,0,1,0,0.872340425531915,0.892857142857143,0.702127659574468,0.25,"0","orthodox"
"1559",24,32,169,168,173,183,127,127,24,35,2,9,21,24,-8,1,-10,0,0,0,0,0,0.923076923076923,0.795454545454545,0.807692307692308,0.545454545454545,"0","southpaw"
"2554",21,32,173,180,183,183,130,130,17,38,0,1,13,17,-11,-7,0,0,0,0,0,0,1,0.974358974358974,0.764705882352941,0.435897435897436,"0","orthodox"
"4235",28,23,179,183,184,188,163,185,69,24,17,7,41,1,5,-4,-4,-22,0,0,0,1,0.802325581395349,0.774193548387097,0.476744186046512,0.032258064516129,"0","orthodox"
"449",31,32,163,167,177,172,115,115,14,28,3,7,7,11,-1,-4,5,0,0,0,0,0,0.823529411764706,0.8,0.411764705882353,0.314285714285714,"0","orthodox"
"2139",26,44,173,173,177,175,147,149,8,29,1,32,5,12,-18,0,2,-2,0,1,0,0,0.888888888888889,0.475409836065574,0.555555555555556,0.19672131147541,"0","orthodox"
"519",25,34,175,173,180,183,146,146,4,3,0,5,3,1,-9,2,-3,0,0,0,0,0,1,0.375,0.75,0.125,"0","orthodox"
"723",32,31,170,171,168,165,126,126,29,30,2,4,20,13,1,-1,3,0,0,0,0,0,0.935483870967742,0.882352941176471,0.645161290322581,0.382352941176471,"0","orthodox"
"1199",20,37,168,163,164,173,130,128,3,9,0,32,3,1,-17,5,-9,2,0,1,0,0,1,0.219512195121951,1,0.024390243902439,"0","orthodox"
"1485",34,32,193,179,193,183,213,227,33,21,3,12,26,18,2,14,10,-14,0,0,0,0,0.916666666666667,0.636363636363636,0.722222222222222,0.545454545454545,"0","orthodox"
"1620",21,24,165,165,168,165,121,122,8,11,1,13,5,6,-3,0,3,-1,0,0,0,0,0.888888888888889,0.458333333333333,0.555555555555556,0.25,"0","orthodox"
"2661",28,20,173,182,180,185,166,166,205,36,10,6,35,7,8,-9,-5,0,0,0,0,0,0.953488372093023,0.857142857142857,0.162790697674419,0.166666666666667,"0","orthodox"
"4053",31,26,170,180,173,187,120,121,18,17,5,0,11,13,5,-10,-14,-1,0,0,0,0,0.782608695652174,1,0.478260869565217,0.764705882352941,"0","southpaw"
"5169",21,26,173,165,173,178,136,141,20,19,0,12,15,10,-5,8,-5,-5,0,0,0,0,1,0.612903225806452,0.75,0.32258064516129,"0","orthodox"
"1796",23,31,160,165,163,165,119,119,6,9,0,12,5,3,-8,-5,-2,0,0,0,0,0,1,0.428571428571429,0.833333333333333,0.142857142857143,"0","orthodox"
"4458",24,32,165,168,178,173,121,121,23,28,0,8,22,17,-8,-3,5,0,0,0,0,0,1,0.777777777777778,0.956521739130435,0.472222222222222,"0","southpaw"
"718",31,35,186,188,191,192,199,196,46,21,2,1,33,13,-4,-2,-1,3,0,1,0,0,0.958333333333333,0.954545454545455,0.6875,0.590909090909091,"0","orthodox"
"675",23,29,180,173,182,188,164,164,9,8,0,6,8,4,-6,7,-6,0,0,0,0,0,1,0.571428571428571,0.888888888888889,0.285714285714286,"0","orthodox"
"3289",21,25,179,171,182,173,165,164,60,83,16,21,7,24,-4,8,9,1,0,0,0,0,0.789473684210526,0.798076923076923,0.0921052631578947,0.230769230769231,"0","orthodox"
"665",36,31,182,182,188,180,166,167,28,28,0,3,16,19,5,0,8,-1,1,0,0,0,1,0.903225806451613,0.571428571428571,0.612903225806452,"0","southpaw"
"4735",20,18,172,175,175,183,130,130,13,13,4,1,5,13,2,-3,-8,0,0,0,0,0,0.764705882352941,0.928571428571429,0.294117647058824,0.928571428571429,"0","orthodox"
"4550",34,40,189,188,208,193,250,238,42,55,6,9,33,44,-6,1,15,12,0,1,0,0,0.875,0.859375,0.6875,0.6875,"0","orthodox"
"250",21,30,168,162,163,165,122,121,7,18,0,12,5,10,-9,6,-2,1,0,0,0,0,1,0.6,0.714285714285714,0.333333333333333,"0","southpaw"
"3818",25,29,189,180,191,189,164,164,32,27,0,1,29,17,-4,9,2,0,0,0,0,0,1,0.964285714285714,0.90625,0.607142857142857,"0","orthodox"
"6021",24,24,170,170,180,170,131,131,38,11,8,0,30,10,0,0,10,0,0,0,0,0,0.826086956521739,1,0.652173913043478,0.909090909090909,"0","orthodox"
"5103",25,33,173,164,180,163,120,124,31,29,1,14,21,18,-8,9,17,-4,0,0,0,0,0.96875,0.674418604651163,0.65625,0.418604651162791,"0","orthodox"
"4922",30,26,173,168,170,175,130,130,26,23,1,0,16,9,4,5,-5,0,0,0,0,0,0.962962962962963,1,0.592592592592593,0.391304347826087,"0","orthodox"
"4130",21,25,173,192,188,211,185,207,30,43,12,12,17,34,-4,-19,-23,-22,0,0,0,1,0.714285714285714,0.781818181818182,0.404761904761905,0.618181818181818,"0","orthodox"
"5448",29,27,196,187,207,188,240,212,11,6,1,1,5,4,2,9,19,28,0,0,1,0,0.916666666666667,0.857142857142857,0.416666666666667,0.571428571428571,"0","southpaw"
"1093",21,24,173,163,176,168,116,115,15,19,5,1,8,14,-3,10,8,1,0,0,0,0,0.75,0.95,0.4,0.7,"0","southpaw"
"3867",26,32,175,183,184,188,159,159,23,35,0,1,19,26,-6,-8,-4,0,0,0,0,0,1,0.972222222222222,0.826086956521739,0.722222222222222,"0","orthodox"
"4140",34,25,175,178,183,183,169,177,98,32,29,3,46,26,9,-3,0,-8,0,0,0,0,0.771653543307087,0.914285714285714,0.362204724409449,0.742857142857143,"0","orthodox"
"3807",26,32,179,170,178,175,130,130,37,30,2,1,31,19,-6,9,3,0,0,0,0,0,0.948717948717949,0.967741935483871,0.794871794871795,0.612903225806452,"0","orthodox"
"1033",26,28,170,177,165,179,147,147,19,26,0,0,15,14,-2,-7,-14,0,0,0,0,0,1,1,0.789473684210526,0.538461538461538,"0","orthodox"
"1605",22,21,168,170,175,175,125,125,10,3,1,5,5,2,1,-2,0,0,0,0,0,0,0.909090909090909,0.375,0.454545454545455,0.25,"0","Unknown"
"1752",24,32,198,180,203,185,224,228,7,24,0,8,4,12,-8,18,18,-4,0,0,0,0,1,0.75,0.571428571428571,0.375,"0","orthodox"
"3080",32,26,182,182,182,188,165,180,52,104,6,4,45,81,6,0,-6,-15,0,0,0,1,0.896551724137931,0.962962962962963,0.775862068965517,0.75,"0","orthodox"
"4752",31,25,178,175,183,175,159,159,39,28,6,7,20,24,6,3,8,0,0,0,0,0,0.866666666666667,0.8,0.444444444444444,0.685714285714286,"0","orthodox"
"4722",24,33,187,183,188,183,175,175,17,34,0,2,12,28,-9,4,5,0,0,0,0,0,1,0.944444444444444,0.705882352941177,0.777777777777778,"0","orthodox"
"5877",28,30,175,180,180,181,139,140,23,19,2,4,14,13,-2,-5,-1,-1,0,0,0,0,0.92,0.826086956521739,0.56,0.565217391304348,"0","orthodox"
"3970",22,35,168,163,177,160,118,118,20,39,1,12,7,13,-13,5,17,0,0,1,0,0,0.952380952380952,0.764705882352941,0.333333333333333,0.254901960784314,"0","southpaw"
"4285",24,29,192,188,211,183,183,207,38,71,8,21,31,38,-5,4,28,-24,0,0,0,1,0.826086956521739,0.771739130434783,0.673913043478261,0.41304347826087,"0","Unknown"
"2073",28,31,191,183,193,188,175,175,12,15,0,0,10,7,-3,8,5,0,0,0,0,0,1,1,0.833333333333333,0.466666666666667,"0","orthodox"
"1604",30,29,175,173,183,178,136,135,21,13,4,15,16,1,1,2,5,1,0,0,0,0,0.84,0.464285714285714,0.64,0.0357142857142857,"0","orthodox"
"309",26,31,168,175,174,178,130,130,28,19,0,1,20,12,-5,-7,-4,0,0,0,0,0,1,0.95,0.714285714285714,0.6,"0","southpaw"
"3622",26,22,162,170,161,175,112,112,51,14,2,6,27,5,4,-8,-14,0,0,0,0,0,0.962264150943396,0.7,0.509433962264151,0.25,"0","southpaw"
"5929",29,25,165,166,175,168,116,118,26,16,11,5,13,4,4,-1,7,-2,0,0,0,0,0.702702702702703,0.761904761904762,0.351351351351351,0.19047619047619,"0","orthodox"
"3359",34,34,185,185,189,196,175,175,39,52,4,3,19,34,0,0,-7,0,0,0,0,0,0.906976744186046,0.945454545454545,0.441860465116279,0.618181818181818,"0","southpaw"
"4377",21,24,182,188,185,180,200,213,62,6,7,12,44,4,-3,-6,5,-13,0,0,0,0,0.898550724637681,0.333333333333333,0.63768115942029,0.222222222222222,"0","orthodox"
"1978",22,30,173,183,180,191,150,153,11,34,1,9,9,12,-8,-10,-11,-3,0,0,0,0,0.916666666666667,0.790697674418605,0.75,0.27906976744186,"0","southpaw"
"5560",25,24,160,157,163,152,108,107,25,24,4,6,23,13,1,3,11,1,0,0,0,0,0.862068965517241,0.8,0.793103448275862,0.433333333333333,"0","orthodox"
"2356",24,40,173,173,178,185,135,135,16,44,1,10,7,18,-16,0,-7,0,0,1,0,0,0.941176470588235,0.814814814814815,0.411764705882353,0.333333333333333,"0","orthodox"
"2167",26,34,188,180,185,191,174,174,20,17,2,9,9,17,-8,8,-6,0,0,0,0,0,0.909090909090909,0.653846153846154,0.409090909090909,0.653846153846154,"0","orthodox"
"5206",30,29,185,187,194,196,195,204,26,21,13,8,20,14,1,-2,-2,-9,0,0,0,0,0.666666666666667,0.724137931034483,0.512820512820513,0.482758620689655,"0","orthodox"
"445",30,36,170,167,177,172,115,115,21,33,0,10,13,14,-6,3,5,0,0,1,0,0,1,0.767441860465116,0.619047619047619,0.325581395348837,"0","southpaw"
"1818",31,32,168,173,183,183,143,144,59,24,2,14,34,8,-1,-5,0,-1,0,0,0,0,0.967213114754098,0.631578947368421,0.557377049180328,0.210526315789474,"0","orthodox"
"3608",30,24,173,173,188,180,152,155,83,23,6,4,37,18,6,0,8,-3,0,0,0,0,0.932584269662921,0.851851851851852,0.415730337078652,0.666666666666667,"0","orthodox"
"3410",22,22,183,180,193,188,192,192,14,19,6,6,3,13,0,3,5,0,0,0,0,0,0.7,0.76,0.15,0.52,"0","orthodox"
"5480",33,20,193,180,203,188,258,260,40,7,4,5,34,5,13,13,15,-2,0,0,0,0,0.909090909090909,0.583333333333333,0.772727272727273,0.416666666666667,"0","orthodox"
"5078",27,21,187,171,190,178,155,156,22,12,0,0,11,9,6,16,12,-1,0,0,0,0,1,1,0.5,0.75,"0","Unknown"
"3073",25,23,163,168,165,165,133,130,97,93,14,5,30,40,2,-5,0,3,0,0,0,0,0.873873873873874,0.948979591836735,0.27027027027027,0.408163265306122,"0","orthodox"
"2865",43,28,190,191,206,208,234,240,55,16,4,6,37,15,15,-1,-2,-6,1,0,0,0,0.932203389830508,0.727272727272727,0.627118644067797,0.681818181818182,"0","orthodox"
"5040",27,28,179,185,188,191,167,167,18,26,0,1,14,15,-1,-6,-3,0,0,0,0,0,1,0.962962962962963,0.777777777777778,0.555555555555556,"0","orthodox"
"4775",41,36,175,185,175,198,172,165,29,9,8,23,23,1,5,-10,-23,7,1,1,0,0,0.783783783783784,0.28125,0.621621621621622,0.03125,"0","orthodox"
"2195",31,29,188,193,191,208,210,242,22,10,2,2,12,5,2,-5,-17,-32,0,0,0,1,0.916666666666667,0.833333333333333,0.5,0.416666666666667,"0","southpaw"
"268",23,37,180,179,184,185,155,154,12,33,0,4,7,19,-14,1,-1,1,0,1,0,0,1,0.891891891891892,0.583333333333333,0.513513513513513,"0","orthodox"
"4162",31,22,168,169,178,192,147,151,93,13,24,8,53,4,9,-1,-14,-4,0,0,0,0,0.794871794871795,0.619047619047619,0.452991452991453,0.19047619047619,"0","orthodox"
"4951",25,29,169,179,165,180,138,140,126,91,21,25,74,22,-4,-10,-15,-2,0,0,0,0,0.857142857142857,0.78448275862069,0.503401360544218,0.189655172413793,"0","orthodox"
"2018",21,23,174,165,180,170,118,119,9,1,1,4,6,1,-2,9,10,-1,0,0,0,0,0.9,0.2,0.6,0.2,"0","orthodox"
"5701",32,27,180,191,185,183,194,229,20,16,4,1,15,15,5,-11,2,-35,0,0,0,1,0.833333333333333,0.941176470588235,0.625,0.882352941176471,"0","Unknown"
"469",26,33,174,173,179,175,129,129,20,34,0,6,12,19,-7,1,4,0,0,0,0,0,1,0.85,0.6,0.475,"0","orthodox"
"2090",35,27,168,168,178,173,134,135,11,14,3,0,4,4,8,0,5,-1,1,0,0,0,0.785714285714286,1,0.285714285714286,0.285714285714286,"0","Unknown"
"976",25,28,183,183,185,188,177,173,12,12,0,3,11,5,-3,0,-3,4,0,0,0,0,1,0.8,0.916666666666667,0.333333333333333,"0","orthodox"
"6077",22,21,165,157,170,173,112,112,24,13,5,1,21,5,1,8,-3,0,0,0,0,0,0.827586206896552,0.928571428571429,0.724137931034483,0.357142857142857,"0","orthodox"
"1375",25,31,168,170,188,178,160,160,14,19,3,2,9,12,-6,-2,10,0,0,0,0,0,0.823529411764706,0.904761904761905,0.529411764705882,0.571428571428571,"0","orthodox"
"2954",28,42,189,192,198,199,208,257,25,69,0,2,21,65,-14,-3,-1,-49,0,1,0,1,1,0.971830985915493,0.84,0.915492957746479,"0","orthodox"
"5821",27,26,185,185,198,206,168,168,27,13,5,1,19,5,1,0,-8,0,0,0,0,0,0.84375,0.928571428571429,0.59375,0.357142857142857,"0","orthodox"
"5139",30,30,180,178,180,168,157,157,22,14,4,5,15,8,0,2,12,0,0,0,0,0,0.846153846153846,0.736842105263158,0.576923076923077,0.421052631578947,"0","orthodox"
"5351",28,34,188,170,201,178,175,175,37,47,2,5,23,30,-6,18,23,0,0,0,0,0,0.948717948717949,0.903846153846154,0.58974358974359,0.576923076923077,"0","orthodox"
"3767",28,29,182,178,188,185,171,190,26,46,4,2,17,28,-1,4,3,-19,0,0,0,1,0.866666666666667,0.958333333333333,0.566666666666667,0.583333333333333,"0","orthodox"
"751",18,26,170,165,173,165,118,118,2,6,0,3,2,3,-8,5,8,0,0,0,0,0,1,0.666666666666667,1,0.333333333333333,"0","orthodox"
"6018",30,34,170,172,180,193,136,137,47,33,11,18,34,20,-4,-2,-13,-1,0,0,0,0,0.810344827586207,0.647058823529412,0.586206896551724,0.392156862745098,"0","orthodox"
"3660",27,22,170,170,170,170,142,150,69,65,3,12,19,28,5,0,0,-8,0,0,0,0,0.958333333333333,0.844155844155844,0.263888888888889,0.363636363636364,"0","orthodox"
"3631",29,36,175,171,175,175,144,145,21,60,4,9,10,52,-7,4,0,-1,0,1,0,0,0.84,0.869565217391304,0.4,0.753623188405797,"0","orthodox"
"2176",38,36,180,175,188,178,160,158,22,33,7,8,11,24,2,5,10,2,1,1,0,0,0.758620689655172,0.804878048780488,0.379310344827586,0.585365853658537,"0","orthodox"
"2203",26,26,188,180,191,193,188,188,9,9,0,7,7,9,0,8,-2,0,0,0,0,0,1,0.5625,0.777777777777778,0.5625,"0","southpaw"
"5724",32,23,163,175,168,175,130,130,36,27,7,11,25,18,9,-12,-7,0,0,0,0,0,0.837209302325581,0.710526315789474,0.581395348837209,0.473684210526316,"0","orthodox"
"2024",28,30,191,201,198,218,254,218,21,38,0,2,16,29,-2,-10,-20,36,0,0,1,0,1,0.95,0.761904761904762,0.725,"0","orthodox"
"1054",24,31,182,188,180,197,212,237,11,9,0,0,10,8,-7,-6,-17,-25,0,0,0,1,1,1,0.909090909090909,0.888888888888889,"0","orthodox"
"3858",28,31,184,194,193,215,188,207,69,76,12,8,30,62,-3,-10,-22,-19,0,0,0,1,0.851851851851852,0.904761904761905,0.37037037037037,0.738095238095238,"0","orthodox"
"59",29,33,180,180,196,182,167,167,5,12,0,12,5,4,-4,0,14,0,0,0,0,0,1,0.5,1,0.166666666666667,"0","southpaw"
"4887",33,25,165,175,173,180,139,139,38,19,12,2,20,12,8,-10,-7,0,0,0,0,0,0.76,0.904761904761905,0.4,0.571428571428571,"0","orthodox"
"4787",26,28,168,170,180,180,135,135,37,26,5,5,29,18,-2,-2,0,0,0,0,0,0,0.880952380952381,0.838709677419355,0.69047619047619,0.580645161290323,"0","orthodox"
"4010",28,30,164,168,174,170,136,136,30,29,2,29,15,19,-2,-4,4,0,0,0,0,0,0.9375,0.5,0.46875,0.327586206896552,"0","southpaw"
"5060",20,26,171,168,180,170,145,145,8,22,1,3,2,18,-6,3,10,0,0,0,0,0,0.888888888888889,0.88,0.222222222222222,0.72,"0","Unknown"
"3325",27,30,191,178,201,191,170,174,20,57,3,20,16,37,-3,13,10,-4,0,0,0,0,0.869565217391304,0.74025974025974,0.695652173913043,0.480519480519481,"0","orthodox"
"3486",22,36,183,187,194,196,218,195,6,51,0,3,6,29,-14,-4,-2,23,0,1,1,0,1,0.944444444444444,1,0.537037037037037,"0","orthodox"
"2026",29,33,201,185,218,191,258,243,33,19,2,10,24,13,-4,16,27,15,0,0,1,0,0.942857142857143,0.655172413793103,0.685714285714286,0.448275862068966,"0","orthodox"
"349",28,21,173,168,173,170,133,135,47,14,4,7,33,9,7,5,3,-2,0,0,0,0,0.92156862745098,0.666666666666667,0.647058823529412,0.428571428571429,"0","orthodox"
"3669",40,29,178,180,188,178,200,182,118,20,25,10,69,10,11,-2,10,18,1,0,1,0,0.825174825174825,0.666666666666667,0.482517482517482,0.333333333333333,"0","orthodox"
"677",21,27,180,180,185,182,145,145,18,18,0,4,14,12,-6,0,3,0,0,0,0,0,1,0.818181818181818,0.777777777777778,0.545454545454545,"0","orthodox"
"1547",26,30,187,185,198,187,204,223,9,10,0,11,8,6,-4,2,11,-19,0,0,0,1,1,0.476190476190476,0.888888888888889,0.285714285714286,"0","orthodox"
"3356",38,30,185,187,196,203,185,193,55,18,4,7,36,15,8,-2,-7,-8,1,0,0,0,0.932203389830508,0.72,0.610169491525424,0.6,"0","southpaw"
"5751",35,29,191,188,206,196,240,228,38,17,2,5,23,8,6,3,10,12,1,0,0,0,0.95,0.772727272727273,0.575,0.363636363636364,"0","orthodox"
"374",28,32,171,168,173,183,150,149,31,23,3,1,9,13,-4,3,-10,1,0,0,0,0,0.911764705882353,0.958333333333333,0.264705882352941,0.541666666666667,"0","orthodox"
"4581",31,33,175,171,191,178,165,155,113,175,26,18,63,79,-2,4,13,10,0,0,0,0,0.81294964028777,0.906735751295337,0.453237410071942,0.409326424870466,"0","orthodox"
"2043",22,24,168,182,178,178,119,119,13,8,0,4,8,6,-2,-14,0,0,0,0,0,0,1,0.666666666666667,0.615384615384615,0.5,"0","orthodox"
"3557",22,29,168,169,165,175,132,132,71,52,4,70,37,11,-7,-1,-10,0,0,0,0,0,0.946666666666667,0.426229508196721,0.493333333333333,0.0901639344262295,"0","orthodox"
"113",30,23,180,182,178,185,160,159,16,20,0,0,13,17,7,-2,-7,1,0,0,0,0,1,1,0.8125,0.85,"0","orthodox"
"3155",27,34,170,173,175,183,140,140,29,51,2,6,27,35,-7,-3,-8,0,0,0,0,0,0.935483870967742,0.894736842105263,0.870967741935484,0.614035087719298,"0","orthodox"
"1464",23,26,174,175,174,183,129,130,27,19,1,0,19,15,-3,-1,-9,-1,0,0,0,0,0.964285714285714,1,0.678571428571429,0.789473684210526,"0","orthodox"
"2115",27,28,178,188,180,188,151,150,11,10,0,2,7,6,-1,-10,-8,1,0,0,0,0,1,0.833333333333333,0.636363636363636,0.5,"0","southpaw"
"773",22,31,163,170,170,170,122,121,8,5,0,1,5,2,-9,-7,0,1,0,0,0,0,1,0.833333333333333,0.625,0.333333333333333,"0","orthodox"
"5950",23,26,171,179,178,183,141,148,43,32,6,5,20,26,-3,-8,-5,-7,0,0,0,0,0.877551020408163,0.864864864864865,0.408163265306122,0.702702702702703,"0","orthodox"
"744",23,34,170,163,173,163,122,124,20,29,2,7,15,20,-11,7,10,-2,0,0,0,0,0.909090909090909,0.805555555555556,0.681818181818182,0.555555555555556,"0","orthodox"
"1018",27,30,175,170,178,174,130,129,16,14,2,3,6,11,-3,5,4,1,0,0,0,0,0.888888888888889,0.823529411764706,0.333333333333333,0.647058823529412,"0","orthodox"
"5952",31,25,163,165,160,175,118,118,34,25,9,4,11,19,6,-2,-15,0,0,0,0,0,0.790697674418605,0.862068965517241,0.255813953488372,0.655172413793103,"0","southpaw"
"849",22,21,174,170,183,175,131,129,5,3,0,4,2,2,1,4,8,2,0,0,0,0,1,0.428571428571429,0.4,0.285714285714286,"0","orthodox"
"2748",25,26,165,157,175,160,136,134,151,93,20,18,61,32,-1,8,15,2,0,0,0,0,0.883040935672515,0.837837837837838,0.35672514619883,0.288288288288288,"0","orthodox"
"1187",24,33,206,191,216,208,240,248,19,28,0,2,14,13,-9,15,8,-8,0,0,0,0,1,0.933333333333333,0.736842105263158,0.433333333333333,"0","orthodox"
"1489",21,30,173,175,177,165,139,139,4,1,0,8,2,0,-9,-2,12,0,0,0,0,0,1,0.111111111111111,0.5,0,"0","orthodox"
"2662",28,28,173,180,180,196,164,188,202,35,10,29,35,16,0,-7,-16,-24,0,0,0,1,0.952830188679245,0.546875,0.165094339622642,0.25,"0","orthodox"
"4864",21,25,188,180,198,196,171,171,14,16,0,0,14,15,-4,8,2,0,0,0,0,0,1,1,1,0.9375,"0","southpaw"
"2636",31,22,171,188,188,193,190,210,109,23,10,1,65,19,9,-17,-5,-20,0,0,0,1,0.915966386554622,0.958333333333333,0.546218487394958,0.791666666666667,"0","orthodox"
"3928",30,29,185,188,201,188,212,227,28,33,0,1,25,29,1,-3,13,-15,0,0,0,1,1,0.970588235294118,0.892857142857143,0.852941176470588,"0","orthodox"
"3257",33,29,163,161,164,160,124,124,91,63,21,21,49,40,4,2,4,0,0,0,0,0,0.8125,0.75,0.4375,0.476190476190476,"0","orthodox"
"149",29,34,185,180,185,191,170,170,13,17,0,7,9,17,-5,5,-6,0,0,0,0,0,1,0.708333333333333,0.692307692307692,0.708333333333333,"0","orthodox"
"1273",25,30,178,168,173,178,135,135,17,17,5,2,9,14,-5,10,-5,0,0,0,0,0,0.772727272727273,0.894736842105263,0.409090909090909,0.736842105263158,"0","orthodox"
"3401",18,27,164,165,168,170,117,119,15,39,2,14,11,30,-9,-1,-2,-2,0,0,0,0,0.882352941176471,0.735849056603774,0.647058823529412,0.566037735849057,"0","orthodox"
"1992",28,32,173,170,178,193,139,142,9,12,0,4,5,7,-4,3,-15,-3,0,0,0,0,1,0.75,0.555555555555556,0.4375,"0","southpaw"
"247",21,29,175,170,185,185,145,146,4,5,0,4,2,4,-8,5,0,-1,0,0,0,0,1,0.555555555555556,0.5,0.444444444444444,"0","orthodox"
"254",25,32,168,179,175,180,141,140,29,27,1,5,22,22,-7,-11,-5,1,0,0,0,0,0.966666666666667,0.84375,0.733333333333333,0.6875,"0","orthodox"
"1194",24,31,175,168,184,178,130,130,12,4,0,9,9,2,-7,7,6,0,0,0,0,0,1,0.307692307692308,0.75,0.153846153846154,"0","orthodox"
"61",25,30,174,169,174,175,140,140,26,34,0,2,16,32,-5,5,-1,0,0,0,0,0,1,0.944444444444444,0.615384615384615,0.888888888888889,"0","orthodox"
"1151",24,23,178,175,183,178,154,158,11,7,2,2,5,6,1,3,5,-4,0,0,0,0,0.846153846153846,0.777777777777778,0.384615384615385,0.666666666666667,"0","orthodox"
"295",22,29,169,173,173,173,135,134,19,24,0,4,12,16,-7,-4,0,1,0,0,0,0,1,0.857142857142857,0.631578947368421,0.571428571428571,"0","orthodox"
"2120",31,33,180,168,184,183,156,154,13,39,1,9,8,24,-2,12,1,2,0,0,0,0,0.928571428571429,0.8125,0.571428571428571,0.5,"0","southpaw"
"76",25,33,170,173,177,173,147,147,21,40,0,8,14,29,-8,-3,4,0,0,0,0,0,1,0.833333333333333,0.666666666666667,0.604166666666667,"0","orthodox"
"1904",21,19,172,168,173,168,121,121,8,5,0,1,3,2,2,4,5,0,0,0,0,0,1,0.833333333333333,0.375,0.333333333333333,"0","southpaw"
"3075",31,24,165,159,165,163,105,105,46,25,0,1,35,18,7,6,2,0,0,0,0,0,1,0.961538461538462,0.760869565217391,0.692307692307692,"0","orthodox"
"3186",29,28,166,168,170,168,134,147,95,77,11,47,62,36,1,-2,2,-13,0,0,0,0,0.89622641509434,0.620967741935484,0.584905660377358,0.290322580645161,"0","orthodox"
"1387",23,37,191,180,193,185,221,235,15,26,0,18,12,14,-14,11,8,-14,0,1,0,0,1,0.590909090909091,0.8,0.318181818181818,"0","orthodox"
"4919",28,34,192,188,211,198,226,219,27,35,4,6,19,26,-6,4,13,7,0,0,0,0,0.870967741935484,0.853658536585366,0.612903225806452,0.634146341463415,"0","orthodox"
"19",30,27,179,180,178,178,159,159,23,28,0,1,20,21,3,-1,0,0,0,0,0,0,1,0.96551724137931,0.869565217391304,0.724137931034483,"0","orthodox"
"4135",31,27,163,174,164,175,123,126,78,45,15,11,41,15,4,-11,-11,-3,0,0,0,0,0.838709677419355,0.803571428571429,0.440860215053763,0.267857142857143,"0","orthodox"
"4239",24,23,165,179,170,184,153,146,56,25,14,4,32,12,1,-14,-14,7,0,0,0,0,0.8,0.862068965517241,0.457142857142857,0.413793103448276,"0","orthodox"
"384",25,29,188,168,178,173,147,147,12,16,0,13,6,13,-4,20,5,0,0,0,0,0,1,0.551724137931034,0.5,0.448275862068966,"0","orthodox"
"2978",22,27,171,169,188,178,155,160,29,72,2,21,16,51,-5,2,10,-5,0,0,0,0,0.935483870967742,0.774193548387097,0.516129032258065,0.548387096774194,"0","orthodox"
"5490",22,31,193,183,203,180,222,204,17,6,0,12,14,3,-9,10,23,18,0,0,1,0,1,0.333333333333333,0.823529411764706,0.166666666666667,"0","orthodox"
"1451",30,31,184,171,193,184,166,172,19,19,2,17,9,8,-1,13,9,-6,0,0,0,0,0.904761904761905,0.527777777777778,0.428571428571429,0.222222222222222,"0","orthodox"
"1847",27,32,180,170,183,176,141,142,22,19,2,12,19,14,-5,10,7,-1,0,0,0,0,0.916666666666667,0.612903225806452,0.791666666666667,0.451612903225806,"0","orthodox"
"4264",24,22,173,173,178,173,126,126,50,37,6,2,24,26,2,0,5,0,0,0,0,0,0.892857142857143,0.948717948717949,0.428571428571429,0.666666666666667,"0","orthodox"
"2733",27,26,185,185,198,198,160,160,40,22,2,0,34,16,1,0,0,0,0,0,0,0,0.952380952380952,1,0.80952380952381,0.727272727272727,"0","orthodox"
"4009",28,26,164,179,174,183,139,140,32,10,2,2,15,5,2,-15,-9,-1,0,0,0,0,0.941176470588235,0.833333333333333,0.441176470588235,0.416666666666667,"0","southpaw"
"1514",21,33,168,168,170,175,139,139,4,9,0,10,3,3,-12,0,-5,0,0,0,0,0,1,0.473684210526316,0.75,0.157894736842105,"0","southpaw"
"2290",22,27,170,165,166,178,136,136,17,16,0,15,12,13,-5,5,-12,0,0,0,0,0,1,0.516129032258065,0.705882352941177,0.419354838709677,"0","orthodox"
"3508",35,24,179,183,178,189,176,176,92,29,13,5,45,18,11,-4,-11,0,1,0,0,0,0.876190476190476,0.852941176470588,0.428571428571429,0.529411764705882,"0","orthodox"
"194",19,27,164,162,161,154,105,105,4,24,0,1,2,13,-8,2,7,0,0,0,0,0,1,0.96,0.5,0.52,"0","orthodox"
"2937",32,31,171,168,169,183,140,139,91,45,1,4,76,32,1,3,-14,1,0,0,0,0,0.989130434782609,0.918367346938776,0.826086956521739,0.653061224489796,"0","orthodox"
"2276",23,31,163,160,164,163,121,123,11,7,17,23,9,7,-8,3,1,-2,0,0,0,0,0.392857142857143,0.233333333333333,0.321428571428571,0.233333333333333,"0","orthodox"
"4902",28,20,170,164,170,164,135,135,67,14,30,10,20,9,8,6,6,0,0,0,0,0,0.690721649484536,0.583333333333333,0.206185567010309,0.375,"0","Unknown"
"5121",27,34,183,178,188,183,187,177,17,51,6,31,8,21,-7,5,5,10,0,0,0,0,0.739130434782609,0.621951219512195,0.347826086956522,0.25609756097561,"0","Unknown"
"3542",46,26,192,191,199,193,256,221,73,21,4,1,68,10,20,1,6,35,1,0,1,0,0.948051948051948,0.954545454545455,0.883116883116883,0.454545454545455,"0","orthodox"
"1561",26,24,175,170,182,180,143,137,12,6,0,10,6,2,2,5,2,6,0,0,0,0,1,0.375,0.5,0.125,"0","southpaw"
"1668",23,20,170,168,173,175,118,118,9,10,0,0,1,3,3,2,-2,0,0,0,0,0,1,1,0.111111111111111,0.3,"0","orthodox"
"4468",29,41,175,173,173,188,143,143,38,40,19,21,25,25,-12,2,-15,0,0,1,0,0,0.666666666666667,0.655737704918033,0.43859649122807,0.409836065573771,"0","orthodox"
"320",26,33,179,169,180,168,132,128,16,25,0,6,12,14,-7,10,12,4,0,0,0,0,1,0.806451612903226,0.75,0.451612903225806,"0","orthodox"
"952",24,23,179,171,188,177,140,139,15,19,0,2,13,16,1,8,11,1,0,0,0,0,1,0.904761904761905,0.866666666666667,0.761904761904762,"0","orthodox"
"5598",39,34,193,198,201,203,241,288,39,34,6,5,32,29,5,-5,-2,-47,1,0,0,1,0.866666666666667,0.871794871794872,0.711111111111111,0.743589743589744,"0","orthodox"
"4547",37,39,189,191,208,201,254,228,48,22,7,17,39,11,-2,-2,7,26,1,1,1,0,0.872727272727273,0.564102564102564,0.709090909090909,0.282051282051282,"0","orthodox"
"101",31,26,160,169,166,173,108,108,32,19,1,1,18,10,5,-9,-7,0,0,0,0,0,0.96969696969697,0.95,0.545454545454545,0.5,"0","orthodox"
"4307",23,19,170,168,173,168,126,126,4,6,0,2,2,4,4,2,5,0,0,0,0,0,1,0.75,0.5,0.5,"0","orthodox"
"5240",26,21,171,156,180,166,128,129,69,54,15,10,7,6,5,15,14,-1,0,0,0,0,0.821428571428571,0.84375,0.0833333333333333,0.09375,"0","orthodox"
"2486",25,31,169,168,174,180,115,115,11,21,1,26,6,10,-6,1,-6,0,0,0,0,0,0.916666666666667,0.446808510638298,0.5,0.212765957446809,"0","orthodox"
"4827",23,35,165,163,168,174,112,112,21,35,0,2,14,22,-12,2,-6,0,0,1,0,0,1,0.945945945945946,0.666666666666667,0.594594594594595,"0","southpaw"
"2998",28,28,173,180,180,191,165,181,196,22,10,27,33,14,0,-7,-11,-16,0,0,0,1,0.951456310679612,0.448979591836735,0.160194174757282,0.285714285714286,"0","orthodox"
"3938",27,32,178,177,189,180,166,178,29,136,6,42,17,88,-5,1,9,-12,0,0,0,0,0.828571428571429,0.764044943820225,0.485714285714286,0.49438202247191,"0","orthodox"
"5404",21,31,178,198,178,201,213,271,12,16,0,8,11,10,-10,-20,-23,-58,0,0,0,1,1,0.666666666666667,0.916666666666667,0.416666666666667,"0","orthodox"
"5826",21,19,177,168,173,173,138,138,22,14,2,3,17,9,2,9,0,0,0,0,0,0,0.916666666666667,0.823529411764706,0.708333333333333,0.529411764705882,"0","orthodox"
"857",27,29,165,171,168,182,143,144,29,13,2,0,19,6,-2,-6,-14,-1,0,0,0,0,0.935483870967742,1,0.612903225806452,0.461538461538462,"0","orthodox"
"1005",18,19,175,175,178,190,136,137,5,1,0,3,3,1,-1,0,-12,-1,0,0,0,0,1,0.25,0.6,0.25,"0","southpaw"
"509",22,31,178,173,184,175,141,141,14,26,0,7,11,13,-9,5,9,0,0,0,0,0,1,0.787878787878788,0.785714285714286,0.393939393939394,"0","orthodox"
"4195",30,25,189,197,201,216,268,200,76,57,11,4,39,46,5,-8,-15,68,0,0,1,0,0.873563218390805,0.934426229508197,0.448275862068966,0.754098360655738,"0","orthodox"
"1454",24,26,180,171,188,184,157,157,20,10,1,4,15,4,-2,9,4,0,0,0,0,0,0.952380952380952,0.714285714285714,0.714285714285714,0.285714285714286,"0","orthodox"
"2337",32,35,175,170,173,180,148,145,15,11,2,7,11,7,-3,5,-7,3,0,1,0,0,0.882352941176471,0.611111111111111,0.647058823529412,0.388888888888889,"0","orthodox"
"3256",23,26,185,180,193,188,185,190,40,50,4,23,28,15,-3,5,5,-5,0,0,0,0,0.909090909090909,0.684931506849315,0.636363636363636,0.205479452054795,"0","orthodox"
"5447",31,37,196,180,207,198,253,230,18,15,1,5,10,7,-6,16,9,23,0,1,1,0,0.947368421052632,0.75,0.526315789473684,0.35,"0","southpaw"
"1989",21,23,170,170,172,172,146,146,6,8,4,2,3,7,-2,0,0,0,0,0,0,0,0.6,0.8,0.3,0.7,"0","orthodox"
"4755",22,34,173,169,185,175,135,131,42,164,7,41,22,84,-12,4,10,4,0,0,0,0,0.857142857142857,0.8,0.448979591836735,0.409756097560976,"0","orthodox"
"2029",26,26,201,191,218,185,250,243,28,25,0,1,20,12,0,10,33,7,0,0,0,0,1,0.961538461538462,0.714285714285714,0.461538461538462,"0","orthodox"
"366",27,24,170,171,178,165,141,141,21,18,0,3,15,12,3,-1,13,0,0,0,0,0,1,0.857142857142857,0.714285714285714,0.571428571428571,"0","orthodox"
"3677",25,36,171,179,183,175,171,190,149,60,8,31,52,42,-11,-8,8,-19,0,1,0,1,0.949044585987261,0.659340659340659,0.331210191082803,0.461538461538462,"0","orthodox"
"3601",24,28,179,170,180,173,147,145,64,89,12,5,18,25,-4,9,7,2,0,0,0,0,0.842105263157895,0.946808510638298,0.236842105263158,0.265957446808511,"0","orthodox"
"500",31,31,157,157,160,165,115,114,35,25,5,8,24,15,0,0,-5,1,0,0,0,0,0.875,0.757575757575758,0.6,0.454545454545455,"0","orthodox"
"192",28,25,173,168,178,170,130,129,16,16,0,0,13,7,3,5,8,1,0,0,0,0,1,1,0.8125,0.4375,"0","orthodox"
"2082",26,23,170,170,180,173,135,134,18,4,3,10,13,2,3,0,7,1,0,0,0,0,0.857142857142857,0.285714285714286,0.619047619047619,0.142857142857143,"0","southpaw"
"60",30,27,165,168,157,165,127,127,23,33,1,3,14,24,3,-3,-8,0,0,0,0,0,0.958333333333333,0.916666666666667,0.583333333333333,0.666666666666667,"0","orthodox"
"1782",19,27,175,170,175,188,130,130,23,27,1,2,19,15,-8,5,-13,0,0,0,0,0,0.958333333333333,0.931034482758621,0.791666666666667,0.517241379310345,"0","southpaw"
"1269",30,27,173,168,178,188,159,160,10,18,0,7,6,11,3,5,-10,-1,0,0,0,0,1,0.72,0.6,0.44,"0","orthodox"
"2810",26,33,183,178,185,189,173,168,48,60,5,15,24,30,-7,5,-4,5,0,0,0,0,0.905660377358491,0.8,0.452830188679245,0.4,"0","orthodox"
"611",20,20,173,173,173,183,133,133,13,10,0,3,10,6,0,0,-10,0,0,0,0,0,1,0.769230769230769,0.769230769230769,0.461538461538462,"0","orthodox"
"1944",20,26,183,178,185,180,150,150,6,10,0,23,6,4,-6,5,5,0,0,0,0,0,1,0.303030303030303,1,0.121212121212121,"0","orthodox"
"4909",24,32,188,185,196,191,247,226,20,41,0,4,17,35,-8,3,5,21,0,0,1,0,1,0.911111111111111,0.85,0.777777777777778,"0","orthodox"
"4718",25,22,188,180,208,183,232,228,14,5,3,6,9,1,3,8,25,4,0,0,0,0,0.823529411764706,0.454545454545455,0.529411764705882,0.0909090909090909,"0","orthodox"
"3950",28,37,163,165,165,170,108,108,23,36,4,8,17,33,-9,-2,-5,0,0,1,0,0,0.851851851851852,0.818181818181818,0.62962962962963,0.75,"0","southpaw"
"5171",23,22,170,168,170,170,122,120,37,23,0,2,35,11,1,2,0,2,0,0,0,0,1,0.92,0.945945945945946,0.44,"0","orthodox"
"1104",24,30,168,168,177,176,118,118,28,19,1,0,10,11,-6,0,1,0,0,0,0,0,0.96551724137931,1,0.344827586206897,0.578947368421053,"0","southpaw"
"692",23,21,165,170,169,170,130,130,26,25,0,2,14,16,2,-5,-1,0,0,0,0,0,1,0.925925925925926,0.538461538461538,0.592592592592593,"0","orthodox"
"4100",27,25,163,165,173,165,125,125,84,31,11,7,41,16,2,-2,8,0,0,0,0,0,0.884210526315789,0.815789473684211,0.431578947368421,0.421052631578947,"0","orthodox"
"5080",23,38,160,160,163,150,105,105,23,62,4,8,13,32,-15,0,13,0,0,1,0,0,0.851851851851852,0.885714285714286,0.481481481481481,0.457142857142857,"0","southpaw"
"5173",40,29,165,169,165,175,137,133,46,94,28,45,10,30,11,-4,-10,4,1,0,0,0,0.621621621621622,0.676258992805755,0.135135135135135,0.215827338129496,"0","Unknown"
"649",19,27,170,168,173,168,129,129,11,7,0,4,3,1,-8,2,5,0,0,0,0,0,1,0.636363636363636,0.272727272727273,0.0909090909090909,"0","southpaw"
"3197",43,30,190,195,206,203,243,237,58,32,4,9,40,23,13,-5,3,6,1,0,0,0,0.935483870967742,0.780487804878049,0.645161290322581,0.560975609756098,"0","orthodox"
"4436",28,27,152,161,160,168,104,105,15,18,0,5,3,13,1,-9,-8,-1,0,0,0,0,1,0.782608695652174,0.2,0.565217391304348,"0","southpaw"
"721",27,32,192,173,191,184,177,178,11,13,0,8,9,7,-5,19,7,-1,0,0,0,0,1,0.619047619047619,0.818181818181818,0.333333333333333,"0","orthodox"
"812",21,33,168,170,184,173,127,128,9,19,0,12,6,12,-12,-2,11,-1,0,0,0,0,1,0.612903225806452,0.666666666666667,0.387096774193548,"0","southpaw"
"2314",22,22,180,184,183,182,159,159,4,3,0,3,2,3,0,-4,1,0,0,0,0,0,1,0.5,0.5,0.5,"0","southpaw"
"2510",31,32,196,180,216,188,208,258,10,3,0,14,6,2,-1,16,28,-50,0,0,0,1,1,0.176470588235294,0.6,0.117647058823529,"0","orthodox"
"4906",24,30,188,188,196,180,243,235,23,23,0,1,20,6,-6,0,16,8,0,0,0,0,1,0.958333333333333,0.869565217391304,0.25,"0","orthodox"
"4853",24,24,188,183,191,198,186,187,13,41,0,12,8,23,0,5,-7,-1,0,0,0,0,1,0.773584905660377,0.615384615384615,0.433962264150943,"0","orthodox"
"3992",23,26,169,157,178,168,115,115,22,19,0,8,16,8,-3,12,10,0,0,0,0,0,1,0.703703703703704,0.727272727272727,0.296296296296296,"0","orthodox"
"476",27,25,179,180,178,185,153,154,25,23,1,1,15,15,2,-1,-7,-1,0,0,0,0,0.961538461538462,0.958333333333333,0.576923076923077,0.625,"0","orthodox"
"84",20,35,164,168,168,173,118,119,8,5,0,5,5,2,-15,-4,-5,-1,0,1,0,0,1,0.5,0.625,0.2,"0","orthodox"
"1720",24,33,170,178,188,183,142,144,8,9,1,17,4,4,-9,-8,5,-2,0,0,0,0,0.888888888888889,0.346153846153846,0.444444444444444,0.153846153846154,"0","orthodox"
"1247",33,29,166,164,164,168,115,115,31,51,1,4,25,39,4,2,-4,0,0,0,0,0,0.96875,0.927272727272727,0.78125,0.709090909090909,"0","southpaw"
"4084",34,37,188,175,193,191,172,175,39,44,3,10,25,29,-3,13,2,-3,0,1,0,0,0.928571428571429,0.814814814814815,0.595238095238095,0.537037037037037,"0","orthodox"
"2559",29,22,180,179,184,178,158,159,114,41,1,3,74,23,7,1,6,-1,0,0,0,0,0.991304347826087,0.931818181818182,0.643478260869565,0.522727272727273,"0","orthodox"
"2649",29,40,188,192,193,204,210,212,71,26,6,8,42,16,-11,-4,-11,-2,0,1,0,0,0.922077922077922,0.764705882352941,0.545454545454545,0.470588235294118,"0","orthodox"
"5305",25,22,179,170,173,173,140,147,22,35,13,1,11,30,3,9,0,-7,0,0,0,0,0.628571428571429,0.972222222222222,0.314285714285714,0.833333333333333,"0","Unknown"
"1778",29,18,180,182,185,178,165,168,14,14,2,0,12,13,11,-2,7,-3,0,0,0,0,0.875,1,0.75,0.928571428571429,"0","orthodox"
"5379",23,33,180,173,183,183,142,143,12,21,0,12,7,12,-10,7,0,-1,0,0,0,0,1,0.636363636363636,0.583333333333333,0.363636363636364,"0","orthodox"
"1983",30,30,185,177,187,177,190,200,4,9,0,10,2,4,0,8,10,-10,0,0,0,0,1,0.473684210526316,0.5,0.210526315789474,"0","orthodox"
"36",24,36,171,169,175,178,117,118,20,46,0,3,11,23,-12,2,-3,-1,0,1,0,0,1,0.938775510204082,0.55,0.469387755102041,"0","orthodox"
"3698",24,23,169,168,175,169,134,135,28,28,0,1,15,24,1,1,6,-1,0,0,0,0,1,0.96551724137931,0.535714285714286,0.827586206896552,"0","southpaw"
"361",26,24,158,163,166,168,111,111,30,11,1,5,12,8,2,-5,-2,0,0,0,0,0,0.967741935483871,0.6875,0.387096774193548,0.5,"0","orthodox"
"2125",29,35,174,173,178,178,136,136,25,30,8,6,17,22,-6,1,0,0,0,1,0,0,0.757575757575758,0.833333333333333,0.515151515151515,0.611111111111111,"0","southpaw"
"5732",24,22,163,170,168,173,120,122,20,26,5,3,12,24,2,-7,-5,-2,0,0,0,0,0.8,0.896551724137931,0.48,0.827586206896552,"0","orthodox"
"5637",34,32,183,178,173,176,153,154,36,34,0,1,23,24,2,5,-3,-1,0,0,0,0,1,0.971428571428571,0.638888888888889,0.685714285714286,"0","southpaw"
"1997",26,24,174,175,178,185,147,152,18,18,0,6,11,11,2,-1,-7,-5,0,0,0,0,1,0.75,0.611111111111111,0.458333333333333,"0","orthodox"
"3184",32,28,166,170,170,170,143,145,116,115,15,32,80,55,4,-4,0,-2,0,0,0,0,0.885496183206107,0.782312925170068,0.610687022900763,0.374149659863946,"0","orthodox"
"3204",29,23,190,182,206,188,214,207,29,13,0,0,20,9,6,8,18,7,0,0,0,0,1,1,0.689655172413793,0.692307692307692,"0","orthodox"
"4122",24,21,168,164,170,168,115,114,16,12,0,0,9,10,3,4,2,1,0,0,0,0,1,1,0.5625,0.833333333333333,"0","orthodox"
"3489",35,32,182,185,189,186,167,167,42,12,1,6,34,9,3,-3,3,0,1,0,0,0,0.976744186046512,0.666666666666667,0.790697674418605,0.5,"0","orthodox"
"2109",24,29,175,168,183,167,126,126,12,52,0,37,7,30,-5,7,16,0,0,0,0,0,1,0.584269662921348,0.583333333333333,0.337078651685393,"0","orthodox"
"6075",26,28,165,161,170,173,113,110,37,15,12,9,29,8,-2,4,-3,3,0,0,0,0,0.755102040816326,0.625,0.591836734693878,0.333333333333333,"0","orthodox"
"140",29,36,170,166,174,164,118,118,15,37,0,4,11,27,-7,4,10,0,0,1,0,0,1,0.902439024390244,0.733333333333333,0.658536585365854,"0","southpaw"
"4187",37,38,193,185,208,198,211,247,23,34,8,14,18,24,-1,8,10,-36,1,1,0,1,0.741935483870968,0.708333333333333,0.580645161290323,0.5,"0","orthodox"
"385",24,33,188,173,178,175,148,152,7,6,0,2,5,3,-9,15,3,-4,0,0,0,0,1,0.75,0.714285714285714,0.375,"0","orthodox"
"4622",23,32,188,187,206,203,231,230,17,28,0,9,15,18,-9,1,3,1,0,0,0,0,1,0.756756756756757,0.882352941176471,0.486486486486487,"0","orthodox"
"364",21,37,158,160,166,150,106,106,17,62,0,6,5,32,-16,-2,16,0,0,1,0,0,1,0.911764705882353,0.294117647058824,0.470588235294118,"0","orthodox"
"980",41,38,185,201,188,210,229,240,19,14,0,1,14,6,3,-16,-22,-11,1,1,0,0,1,0.933333333333333,0.736842105263158,0.4,"0","southpaw"
"3983",21,24,165,169,173,170,127,126,20,9,2,3,14,6,-3,-4,3,1,0,0,0,0,0.909090909090909,0.75,0.636363636363636,0.5,"0","orthodox"
"1042",20,31,178,182,185,185,160,160,17,18,0,4,14,12,-11,-4,0,0,0,0,0,0,1,0.818181818181818,0.823529411764706,0.545454545454545,"0","orthodox"
"2069",29,19,175,170,177,170,134,134,5,2,2,1,4,1,10,5,7,0,0,0,0,0,0.714285714285714,0.666666666666667,0.571428571428571,0.333333333333333,"0","orthodox"
"3106",28,28,170,180,170,185,164,175,97,50,16,14,40,17,0,-10,-15,-11,0,0,0,0,0.858407079646018,0.78125,0.353982300884956,0.265625,"0","orthodox"
"5557",28,31,157,157,152,168,110,110,28,23,10,19,15,13,-3,0,-16,0,0,0,0,0,0.736842105263158,0.547619047619048,0.394736842105263,0.30952380952381,"0","orthodox"
"305",21,36,189,183,196,188,168,167,11,11,2,13,3,6,-15,6,8,1,0,1,0,0,0.846153846153846,0.458333333333333,0.230769230769231,0.25,"0","orthodox"
"936",24,31,173,175,180,189,140,140,20,15,1,1,10,7,-7,-2,-9,0,0,0,0,0,0.952380952380952,0.9375,0.476190476190476,0.4375,"0","orthodox"
"1925",17,29,175,173,183,180,147,143,1,0,0,3,0,0,-12,2,3,4,0,0,0,0,1,0,0,0,"0","Unknown"
"3649",26,26,155,157,160,165,114,115,69,16,12,16,8,0,0,-2,-5,-1,0,0,0,0,0.851851851851852,0.5,0.0987654320987654,0,"0","Unknown"
"156",23,29,160,168,163,160,108,108,27,30,0,7,23,15,-6,-8,3,0,0,0,0,0,1,0.810810810810811,0.851851851851852,0.405405405405405,"0","orthodox"
"2322",26,40,195,191,201,201,279,236,27,45,1,20,13,34,-14,4,0,43,0,1,1,0,0.964285714285714,0.692307692307692,0.464285714285714,0.523076923076923,"0","orthodox"
"1208",25,28,180,177,183,177,164,167,14,19,0,15,12,8,-3,3,6,-3,0,0,0,0,1,0.558823529411765,0.857142857142857,0.235294117647059,"0","orthodox"
"644",25,25,178,170,183,173,134,135,32,26,3,0,13,14,0,8,10,-1,0,0,0,0,0.914285714285714,1,0.371428571428571,0.538461538461538,"0","orthodox"
"499",28,22,169,163,173,165,108,107,22,18,2,3,12,12,6,6,8,1,0,0,0,0,0.916666666666667,0.857142857142857,0.5,0.571428571428571,"0","orthodox"
"5347",21,24,178,173,185,168,130,131,12,7,0,2,12,5,-3,5,17,-1,0,0,0,0,1,0.777777777777778,1,0.555555555555556,"0","orthodox"
"4379",21,28,182,180,185,185,194,193,56,35,6,16,39,19,-7,2,0,1,0,0,0,0,0.903225806451613,0.686274509803922,0.629032258064516,0.372549019607843,"0","orthodox"
"5721",31,26,178,188,183,208,167,168,32,25,5,1,23,19,5,-10,-25,-1,0,0,0,0,0.864864864864865,0.961538461538462,0.621621621621622,0.730769230769231,"0","orthodox"
"2796",20,34,165,165,173,165,128,127,65,90,1,24,23,17,-14,0,8,1,0,0,0,0,0.984848484848485,0.789473684210526,0.348484848484849,0.149122807017544,"0","orthodox"
"301",26,34,189,188,196,201,176,176,24,26,2,7,14,23,-8,1,-5,0,0,0,0,0,0.923076923076923,0.787878787878788,0.538461538461538,0.696969696969697,"0","orthodox"
"2526",23,36,183,180,183,183,154,154,22,52,1,49,17,42,-13,3,0,0,0,1,0,0,0.956521739130435,0.514851485148515,0.739130434782609,0.415841584158416,"0","orthodox"
"38",22,28,171,168,175,178,119,121,13,4,0,1,5,2,-6,3,-3,-2,0,0,0,0,1,0.8,0.384615384615385,0.4,"0","orthodox"
"884",33,21,169,178,173,178,160,163,56,18,9,0,42,11,12,-9,-5,-3,0,0,0,0,0.861538461538462,1,0.646153846153846,0.611111111111111,"1","Unknown"
"852",28,25,164,162,165,164,115,115,21,13,3,2,14,7,3,2,1,0,0,0,0,0,0.875,0.866666666666667,0.583333333333333,0.466666666666667,"1","Unknown"
"560",21,25,182,171,193,185,180,206,23,29,2,12,10,9,-4,11,8,-26,0,0,0,1,0.92,0.707317073170732,0.4,0.219512195121951,"1","orthodox"
"518",20,22,185,182,182,193,178,176,15,26,3,5,5,10,-2,3,-11,2,0,0,0,0,0.833333333333333,0.838709677419355,0.277777777777778,0.32258064516129,"1","orthodox"
"246",35,23,168,174,175,170,130,131,36,14,3,2,24,5,12,-6,5,-1,1,0,0,0,0.923076923076923,0.875,0.615384615384615,0.3125,"1","orthodox"
"574",29,27,170,179,170,180,149,139,142,79,22,12,29,20,2,-9,-10,10,0,0,0,0,0.865853658536585,0.868131868131868,0.176829268292683,0.21978021978022,"1","Unknown"
"745",21,33,183,183,183,191,187,193,17,48,0,8,10,29,-12,0,-8,-6,0,0,0,0,1,0.857142857142857,0.588235294117647,0.517857142857143,"1","orthodox"
"244",26,19,164,155,163,157,110,112,5,1,2,0,1,0,7,9,6,-2,0,0,0,0,0.714285714285714,1,0.142857142857143,0,"1","orthodox"
"838",26,21,165,173,170,178,132,135,79,63,8,13,23,8,5,-8,-8,-3,0,0,0,0,0.908045977011494,0.828947368421053,0.264367816091954,0.105263157894737,"1","orthodox"
"435",25,29,173,184,180,188,165,166,154,49,9,0,26,10,-4,-11,-8,-1,0,0,0,0,0.94478527607362,1,0.159509202453988,0.204081632653061,"1","orthodox"
"582",31,31,168,169,173,173,135,135,75,30,19,13,31,18,0,-1,0,0,0,0,0,0,0.797872340425532,0.697674418604651,0.329787234042553,0.418604651162791,"1","orthodox"
"157",42,23,171,177,178,183,147,147,48,13,10,3,34,10,19,-6,-5,0,1,0,0,0,0.827586206896552,0.8125,0.586206896551724,0.625,"1","orthodox"
"172",26,25,178,181,180,183,154,156,0,4,3,0,0,3,1,-3,-3,-2,0,0,0,0,0,1,0,0.75,"1","orthodox"
"8571",30,27,178,178,180,183,159,160,41,22,10,1,34,10,3,0,-3,-1,0,0,0,0,0.803921568627451,0.956521739130435,0.666666666666667,0.434782608695652,"1","orthodox"
"275",24,26,168,168,183,168,136,136,3,2,1,1,1,0,-2,0,15,0,0,0,0,0,0.75,0.666666666666667,0.25,0,"1","orthodox"
"817",25,25,178,175,191,175,156,172,8,11,0,3,5,9,0,3,16,-16,0,0,0,1,1,0.785714285714286,0.625,0.642857142857143,"1","orthodox"
"306",37,32,178,178,185,193,160,160,17,3,8,23,4,3,5,0,-8,0,1,0,0,0,0.68,0.115384615384615,0.16,0.115384615384615,"1","orthodox"
"886",19,19,156,160,152,163,107,109,0,9,3,1,0,7,0,-4,-11,-2,0,0,0,0,0,0.9,0,0.7,"1","orthodox"
"41",31,29,170,169,170,175,126,125,26,45,3,7,14,39,2,1,-5,1,0,0,0,0,0.896551724137931,0.865384615384615,0.482758620689655,0.75,"1","orthodox"
"316",23,24,173,180,170,184,150,159,52,56,9,1,14,38,-1,-7,-14,-9,0,0,0,0,0.852459016393443,0.982456140350877,0.229508196721311,0.666666666666667,"1","orthodox"
"132",27,28,170,180,178,188,175,174,27,34,0,1,18,29,-1,-10,-10,1,0,0,0,0,1,0.971428571428571,0.666666666666667,0.828571428571429,"1","orthodox"
"380",29,33,174,178,180,183,143,144,31,75,1,7,18,61,-4,-4,-3,-1,0,0,0,0,0.96875,0.914634146341463,0.5625,0.74390243902439,"1","orthodox"
"472",31,33,173,173,175,180,159,160,55,45,4,14,24,21,-2,0,-5,-1,0,0,0,0,0.932203389830508,0.76271186440678,0.406779661016949,0.355932203389831,"1","orthodox"
"486",30,27,183,178,178,188,160,160,22,16,0,1,12,6,3,5,-10,0,0,0,0,0,1,0.941176470588235,0.545454545454545,0.352941176470588,"1","orthodox"
"1001",37,33,171,173,173,178,145,145,35,15,12,2,11,7,4,-2,-5,0,1,0,0,0,0.74468085106383,0.882352941176471,0.234042553191489,0.411764705882353,"1","orthodox"
"920",25,22,189,193,191,209,194,180,37,50,11,6,22,24,3,-4,-18,14,0,0,0,0,0.770833333333333,0.892857142857143,0.458333333333333,0.428571428571429,"1","orthodox"
"991",33,22,180,180,175,178,148,149,28,14,2,1,21,9,11,0,-3,-1,0,0,0,0,0.933333333333333,0.933333333333333,0.7,0.6,"1","orthodox"
"1732",23,23,165,164,164,170,118,118,28,42,1,1,20,27,0,1,-6,0,0,0,0,0,0.96551724137931,0.976744186046512,0.689655172413793,0.627906976744186,"1","southpaw"
"144",17,21,172,168,176,170,133,133,1,5,0,0,0,5,-4,4,6,0,0,0,0,0,1,1,0,1,"1","Unknown"
"3641",22,20,171,174,183,183,151,151,17,24,1,2,6,7,2,-3,0,0,0,0,0,0,0.944444444444444,0.923076923076923,0.333333333333333,0.269230769230769,"1","orthodox"
"639",20,30,156,163,165,168,124,124,31,109,6,16,18,38,-10,-7,-3,0,0,0,0,0,0.837837837837838,0.872,0.486486486486487,0.304,"1","southpaw"
"487",25,21,177,177,185,174,154,155,10,16,0,2,9,11,4,0,11,-1,0,0,0,0,1,0.888888888888889,0.9,0.611111111111111,"1","southpaw"
"87",25,25,170,170,173,173,115,114,14,21,0,2,1,18,0,0,0,1,0,0,0,0,1,0.91304347826087,0.0714285714285714,0.782608695652174,"1","orthodox"
"9461",24,28,180,177,193,182,190,191,7,26,3,3,7,23,-4,3,11,-1,0,0,0,0,0.7,0.896551724137931,0.7,0.793103448275862,"1","orthodox"
"1019",23,26,165,168,178,168,133,132,10,23,0,1,5,13,-3,-3,10,1,0,0,0,0,1,0.958333333333333,0.5,0.541666666666667,"1","Unknown"
"623",28,25,154,157,160,160,121,125,91,95,18,29,78,18,3,-3,0,-4,0,0,0,0,0.834862385321101,0.766129032258065,0.715596330275229,0.145161290322581,"1","Unknown"
"726",35,33,188,191,196,198,258,234,18,47,7,3,13,32,2,-3,-2,24,1,0,1,0,0.72,0.94,0.52,0.64,"1","orthodox"
"586",19,31,191,189,196,206,223,207,29,66,1,12,26,50,-12,2,-10,16,0,0,1,0,0.966666666666667,0.846153846153846,0.866666666666667,0.641025641025641,"1","orthodox"
"1032",26,31,171,170,175,180,133,135,26,25,0,3,19,19,-5,1,-5,-2,0,0,0,0,1,0.892857142857143,0.730769230769231,0.678571428571429,"1","orthodox"
"12",35,29,185,188,201,185,196,197,30,6,11,0,26,5,6,-3,16,-1,1,0,0,0,0.731707317073171,1,0.634146341463415,0.833333333333333,"1","orthodox"
"814",29,23,157,173,168,180,128,126,59,50,16,4,34,9,6,-16,-12,2,0,0,0,0,0.786666666666667,0.925925925925926,0.453333333333333,0.166666666666667,"1","Unknown"
"204",32,24,185,178,188,183,167,168,30,33,7,0,18,22,8,7,5,-1,0,0,0,0,0.810810810810811,1,0.486486486486487,0.666666666666667,"1","orthodox"
"1131",18,20,173,157,176,163,112,113,11,4,1,0,7,4,-2,16,13,-1,0,0,0,0,0.916666666666667,1,0.583333333333333,1,"1","southpaw"
"680",33,27,169,182,178,183,146,153,73,14,5,3,48,6,6,-13,-5,-7,0,0,0,0,0.935897435897436,0.823529411764706,0.615384615384615,0.352941176470588,"1","orthodox"
"270",21,19,172,175,175,175,161,160,1,4,1,1,0,4,2,-3,0,1,0,0,0,0,0.5,0.8,0,0.8,"1","orthodox"
"8121",23,24,182,166,183,183,157,160,12,45,6,13,8,22,-1,16,0,-3,0,0,0,0,0.666666666666667,0.775862068965517,0.444444444444444,0.379310344827586,"1","Unknown"
"635",29,29,179,173,178,178,149,149,40,30,4,2,33,20,0,6,0,0,0,0,0,0,0.909090909090909,0.9375,0.75,0.625,"1","orthodox"
"5201",27,24,170,168,173,160,118,118,28,23,2,0,15,13,3,2,13,0,0,0,0,0,0.933333333333333,1,0.5,0.565217391304348,"1","southpaw"
"29",36,26,164,163,177,163,112,112,17,21,0,3,5,13,10,1,14,0,1,0,0,0,1,0.875,0.294117647058824,0.541666666666667,"1","orthodox"
"283",20,31,170,166,170,168,117,118,1,9,1,5,1,2,-11,4,2,-1,0,0,0,0,0.5,0.642857142857143,0.5,0.142857142857143,"1","Unknown"
"35",27,31,168,165,170,173,126,126,32,36,9,11,21,23,-4,3,-3,0,0,0,0,0,0.780487804878049,0.765957446808511,0.51219512195122,0.48936170212766,"1","orthodox"
"129",25,26,175,178,175,180,130,130,19,17,4,2,5,8,-1,-3,-5,0,0,0,0,0,0.826086956521739,0.894736842105263,0.217391304347826,0.421052631578947,"1","orthodox"
"51",31,21,158,163,159,165,105,105,27,16,6,2,10,12,10,-5,-6,0,0,0,0,0,0.818181818181818,0.888888888888889,0.303030303030303,0.666666666666667,"1","orthodox"
"356",24,23,165,168,173,173,124,126,13,43,0,1,10,31,1,-3,0,-2,0,0,0,0,1,0.977272727272727,0.769230769230769,0.704545454545455,"1","orthodox"
"679",32,32,168,173,183,183,140,140,45,38,5,20,32,26,0,-5,0,0,0,0,0,0,0.9,0.655172413793103,0.64,0.448275862068966,"1","orthodox"
"238",29,38,189,193,196,201,223,241,43,23,1,14,26,0,-9,-4,-5,-18,0,1,0,1,0.977272727272727,0.621621621621622,0.590909090909091,0,"1","orthodox"
"382",24,23,170,171,170,173,144,146,74,70,13,16,31,19,1,-1,-3,-2,0,0,0,0,0.850574712643678,0.813953488372093,0.35632183908046,0.22093023255814,"1","orthodox"
"603",26,28,170,171,180,165,139,139,17,41,0,0,13,30,-2,-1,15,0,0,0,0,0,1,1,0.764705882352941,0.731707317073171,"1","southpaw"
"549",28,21,179,178,183,178,154,154,39,17,2,0,24,17,7,1,5,0,0,0,0,0,0.951219512195122,1,0.585365853658537,1,"1","southpaw"
"1020",22,25,170,182,173,185,141,137,11,21,8,1,3,14,-3,-12,-12,4,0,0,0,0,0.578947368421053,0.954545454545455,0.157894736842105,0.636363636363636,"1","orthodox"
"460",39,27,182,183,182,194,172,219,60,16,8,0,53,13,12,-1,-12,-47,1,0,0,1,0.882352941176471,1,0.779411764705882,0.8125,"1","orthodox"
"919",19,26,198,193,213,209,197,239,13,80,0,23,13,36,-7,5,4,-42,0,0,0,1,1,0.776699029126214,1,0.349514563106796,"1","orthodox"
"2332",26,27,175,173,183,178,130,129,14,11,4,13,10,7,-1,2,5,1,0,0,0,0,0.777777777777778,0.458333333333333,0.555555555555556,0.291666666666667,"1","orthodox"
"656",24,27,164,163,164,169,115,115,26,33,1,2,14,25,-3,1,-5,0,0,0,0,0,0.962962962962963,0.942857142857143,0.518518518518518,0.714285714285714,"1","southpaw"
"882",41,28,199,189,211,201,242,214,25,21,6,2,20,18,13,10,10,28,1,0,1,0,0.806451612903226,0.91304347826087,0.645161290322581,0.782608695652174,"1","orthodox"
"1009",30,24,170,159,175,163,126,125,39,13,11,3,20,6,6,11,12,1,0,0,0,0,0.78,0.8125,0.4,0.375,"1","Unknown"
"1017",34,24,173,180,175,180,142,142,20,24,11,0,12,17,10,-7,-5,0,0,0,0,0,0.645161290322581,1,0.387096774193548,0.708333333333333,"1","orthodox"
"97",24,26,173,168,174,173,126,126,14,22,0,1,11,18,-2,5,1,0,0,0,0,0,1,0.956521739130435,0.785714285714286,0.782608695652174,"1","southpaw"
"394",23,24,175,168,183,170,129,130,47,25,7,2,16,10,-1,7,13,-1,0,0,0,0,0.87037037037037,0.925925925925926,0.296296296296296,0.37037037037037,"1","orthodox"
"932",20,26,170,165,173,165,129,130,19,36,9,19,15,10,-6,5,8,-1,0,0,0,0,0.678571428571429,0.654545454545455,0.535714285714286,0.181818181818182,"1","orthodox"
"350",29,27,180,179,191,185,147,147,34,31,1,1,24,25,2,1,6,0,0,0,0,0,0.971428571428571,0.96875,0.685714285714286,0.78125,"1","orthodox"
"695",37,26,179,182,184,185,175,173,39,20,8,1,24,16,11,-3,-1,2,1,0,0,0,0.829787234042553,0.952380952380952,0.51063829787234,0.761904761904762,"1","orthodox"
"673",26,23,179,170,188,173,153,150,30,32,6,13,5,15,3,9,15,3,0,0,0,0,0.833333333333333,0.711111111111111,0.138888888888889,0.333333333333333,"1","southpaw"
"1036",25,28,183,171,191,184,155,153,18,43,5,6,4,28,-3,12,7,2,0,0,0,0,0.782608695652174,0.877551020408163,0.173913043478261,0.571428571428571,"1","orthodox"
"904",24,24,192,193,206,203,240,222,22,19,0,0,12,15,0,-1,3,18,0,0,1,0,1,1,0.545454545454545,0.789473684210526,"1","orthodox"
"5091",26,25,171,173,175,178,155,158,202,83,32,10,61,38,1,-2,-3,-3,0,0,0,0,0.863247863247863,0.89247311827957,0.260683760683761,0.408602150537634,"1","Unknown"
"664",22,19,165,173,165,173,138,139,25,52,3,6,4,10,3,-8,-8,-1,0,0,0,0,0.892857142857143,0.896551724137931,0.142857142857143,0.172413793103448,"1","southpaw"
"872",21,27,165,160,173,163,108,108,23,25,0,5,15,13,-6,5,10,0,0,0,0,0,1,0.833333333333333,0.652173913043478,0.433333333333333,"1","orthodox"
"738",24,26,189,178,191,180,178,172,36,68,8,12,22,21,-2,11,11,6,0,0,0,0,0.818181818181818,0.85,0.5,0.2625,"1","orthodox"
"4991",36,29,180,191,178,211,183,200,184,14,47,7,29,8,7,-11,-33,-17,1,0,0,1,0.796536796536797,0.666666666666667,0.125541125541126,0.380952380952381,"1","orthodox"
"504",25,22,179,182,182,187,179,177,129,52,26,11,11,34,3,-3,-5,2,0,0,0,0,0.832258064516129,0.825396825396825,0.0709677419354839,0.53968253968254,"1","orthodox"
"83",29,25,175,182,180,182,154,154,12,15,7,5,6,8,4,-7,-2,0,0,0,0,0,0.631578947368421,0.75,0.315789473684211,0.4,"1","orthodox"
"864",23,24,184,174,178,173,154,149,11,15,3,8,10,13,-1,10,5,5,0,0,0,0,0.785714285714286,0.652173913043478,0.714285714285714,0.565217391304348,"1","Unknown"
"532",28,30,164,168,160,173,128,137,167,110,41,29,15,52,-2,-4,-13,-9,0,0,0,0,0.802884615384615,0.79136690647482,0.0721153846153846,0.37410071942446,"1","orthodox"
"56",26,23,173,168,178,170,129,130,14,15,0,4,7,3,3,5,8,-1,0,0,0,0,1,0.789473684210526,0.5,0.157894736842105,"1","orthodox"
"633",28,27,173,164,180,170,139,140,25,54,3,4,9,32,1,9,10,-1,0,0,0,0,0.892857142857143,0.931034482758621,0.321428571428571,0.551724137931034,"1","Unknown"
"590",22,22,171,170,175,180,125,125,24,34,2,5,23,27,0,1,-5,0,0,0,0,0,0.923076923076923,0.871794871794872,0.884615384615385,0.692307692307692,"1","orthodox"
"69",34,24,173,173,183,170,145,145,3,5,4,0,1,4,10,0,13,0,0,0,0,0,0.428571428571429,1,0.142857142857143,0.8,"1","orthodox"
"4112",29,34,177,185,185,191,159,159,23,34,2,2,18,26,-5,-8,-6,0,0,0,0,0,0.92,0.944444444444444,0.72,0.722222222222222,"1","southpaw"
"601",21,23,170,168,170,178,132,132,19,42,1,8,5,13,-2,2,-8,0,0,0,0,0,0.95,0.84,0.25,0.26,"1","orthodox"
"758",21,24,173,175,173,183,133,129,15,111,6,35,10,68,-3,-2,-10,4,0,0,0,0,0.714285714285714,0.76027397260274,0.476190476190476,0.465753424657534,"1","orthodox"
"3661",31,21,169,173,180,177,135,142,148,35,9,5,95,12,10,-4,3,-7,0,0,0,0,0.942675159235669,0.875,0.605095541401274,0.3,"1","orthodox"
"722",22,22,184,185,188,191,164,178,23,5,5,1,15,4,0,-1,-3,-14,0,0,0,0,0.821428571428571,0.833333333333333,0.535714285714286,0.666666666666667,"1","Unknown"
"815",27,25,157,157,183,168,128,130,63,36,16,4,25,27,2,0,15,-2,0,0,0,0,0.79746835443038,0.9,0.316455696202532,0.675,"1","orthodox"
"576",32,26,161,160,168,163,119,119,63,28,16,4,30,8,6,1,5,0,0,0,0,0,0.79746835443038,0.875,0.379746835443038,0.25,"1","orthodox"
"333",30,30,169,171,175,169,140,140,40,81,1,0,17,68,0,-2,6,0,0,0,0,0,0.975609756097561,1,0.414634146341463,0.839506172839506,"1","southpaw"
"867",21,27,165,160,173,163,108,108,23,25,0,5,15,13,-6,5,10,0,0,0,0,0,1,0.833333333333333,0.652173913043478,0.433333333333333,"1","orthodox"
"593",27,30,170,180,170,185,147,147,32,36,0,5,26,26,-3,-10,-15,0,0,0,0,0,1,0.878048780487805,0.8125,0.634146341463415,"1","orthodox"
"935",36,27,152,168,165,160,105,105,40,25,5,3,30,11,9,-16,5,0,1,0,0,0,0.888888888888889,0.892857142857143,0.666666666666667,0.392857142857143,"1","orthodox"
"733",31,31,170,170,178,173,122,121,33,30,4,3,21,17,0,0,5,1,0,0,0,0,0.891891891891892,0.909090909090909,0.567567567567568,0.515151515151515,"1","orthodox"
"53",35,26,190,193,208,196,199,200,24,24,2,1,12,13,9,-3,12,-1,1,0,0,0,0.923076923076923,0.96,0.461538461538462,0.52,"1","orthodox"
"837",16,19,168,160,165,164,109,111,1,3,0,0,1,1,-3,8,1,-2,0,0,0,0,1,1,1,0.333333333333333,"1","orthodox"
"6651",33,25,154,159,160,173,111,111,60,26,5,6,15,17,8,-5,-13,0,0,0,0,0,0.923076923076923,0.8125,0.230769230769231,0.53125,"1","orthodox"
"831",20,34,166,165,170,165,127,131,76,94,5,25,14,19,-14,1,5,-4,0,0,0,0,0.938271604938272,0.789915966386555,0.172839506172839,0.159663865546218,"1","orthodox"
"493",22,30,171,173,175,178,145,145,150,115,20,24,42,22,-8,-2,-3,0,0,0,0,0,0.882352941176471,0.827338129496403,0.247058823529412,0.158273381294964,"1","Unknown"
"3201",26,43,189,185,191,191,170,169,34,48,0,5,30,32,-17,4,0,1,0,1,0,0,1,0.905660377358491,0.882352941176471,0.60377358490566,"1","orthodox"
"765",30,24,185,192,196,185,200,206,53,12,4,1,30,10,6,-7,11,-6,0,0,0,0,0.929824561403509,0.923076923076923,0.526315789473684,0.769230769230769,"1","orthodox"
"724",27,26,179,179,184,184,166,175,68,56,16,6,40,22,1,0,0,-9,0,0,0,0,0.80952380952381,0.903225806451613,0.476190476190476,0.354838709677419,"1","orthodox"
"712",37,29,187,183,188,208,174,175,40,16,4,2,21,7,8,4,-20,-1,1,0,0,0,0.909090909090909,0.888888888888889,0.477272727272727,0.388888888888889,"1","southpaw"
"54",32,32,190,187,208,191,197,198,21,35,1,1,11,24,0,3,17,-1,0,0,0,0,0.954545454545455,0.972222222222222,0.5,0.666666666666667,"1","orthodox"
"642",36,36,170,183,173,185,154,154,43,38,10,2,13,28,0,-13,-12,0,1,1,0,0,0.811320754716981,0.95,0.245283018867925,0.7,"1","orthodox"
"6",35,29,179,166,185,170,142,145,39,47,5,3,30,35,6,13,15,-3,1,0,0,0,0.886363636363636,0.94,0.681818181818182,0.7,"1","orthodox"
"5411",25,23,174,168,178,178,130,136,129,60,9,5,90,7,2,6,0,-6,0,0,0,0,0.934782608695652,0.923076923076923,0.652173913043478,0.107692307692308,"1","orthodox"
"258",25,26,173,170,182,170,132,131,5,5,0,10,1,1,-1,3,12,1,0,0,0,0,1,0.333333333333333,0.2,0.0666666666666667,"1","Unknown"
"50",28,28,192,191,193,193,242,225,20,15,2,0,15,12,0,1,0,17,0,0,1,0,0.909090909090909,1,0.681818181818182,0.8,"1","southpaw"
"479",24,26,183,184,180,183,182,196,35,21,1,0,26,13,-2,-1,-3,-14,0,0,0,0,0.972222222222222,1,0.722222222222222,0.619047619047619,"1","orthodox"
"2271",25,32,173,165,175,173,135,135,16,20,0,8,10,15,-7,8,2,0,0,0,0,0,1,0.714285714285714,0.625,0.535714285714286,"1","orthodox"
"850",22,23,175,188,183,191,212,224,38,52,11,11,24,20,-1,-13,-8,-12,0,0,0,0,0.775510204081633,0.825396825396825,0.489795918367347,0.317460317460317,"1","orthodox"
"961",37,28,171,171,173,173,157,157,27,74,0,4,24,63,9,0,0,0,1,0,0,0,1,0.948717948717949,0.888888888888889,0.807692307692308,"1","orthodox"
"630",31,21,171,178,187,180,142,140,41,36,7,2,26,23,10,-7,7,2,0,0,0,0,0.854166666666667,0.947368421052632,0.541666666666667,0.605263157894737,"1","orthodox"
"217",19,30,170,160,170,160,107,107,3,3,2,0,0,1,-11,10,10,0,0,0,0,0,0.6,1,0,0.333333333333333,"1","orthodox"
"294",18,21,179,171,179,174,140,140,2,1,1,1,0,0,-3,8,5,0,0,0,0,0,0.666666666666667,0.5,0,0,"1","southpaw"
"999",28,36,163,161,157,170,130,130,15,35,2,9,8,17,-8,2,-13,0,0,1,0,0,0.882352941176471,0.795454545454545,0.470588235294118,0.386363636363636,"1","orthodox"
"98",31,21,166,168,170,169,116,116,35,11,4,1,26,8,10,-2,1,0,0,0,0,0,0.897435897435897,0.916666666666667,0.666666666666667,0.666666666666667,"1","orthodox"
"91",32,27,165,164,178,168,126,126,44,25,4,0,35,13,5,1,10,0,0,0,0,0,0.916666666666667,1,0.729166666666667,0.52,"1","southpaw"
"863",22,23,185,184,194,178,154,168,2,13,1,5,2,10,-1,1,16,-14,0,0,0,0,0.666666666666667,0.722222222222222,0.666666666666667,0.555555555555556,"1","orthodox"
"715",30,28,187,185,203,198,212,220,25,20,7,9,17,14,2,2,5,-8,0,0,0,0,0.78125,0.689655172413793,0.53125,0.482758620689655,"1","orthodox"
"828",25,19,169,163,177,173,121,117,57,21,13,1,46,7,6,6,4,4,0,0,0,0,0.814285714285714,0.954545454545455,0.657142857142857,0.318181818181818,"1","orthodox"
"415",31,29,191,191,198,203,221,210,41,29,1,1,31,23,2,0,-5,11,0,0,0,0,0.976190476190476,0.966666666666667,0.738095238095238,0.766666666666667,"1","orthodox"
"452",33,26,169,171,180,172,132,132,157,43,10,14,100,26,7,-2,8,0,0,0,0,0,0.940119760479042,0.754385964912281,0.598802395209581,0.456140350877193,"1","orthodox"
"735",26,29,183,178,191,188,158,155,22,42,6,5,7,26,-3,5,3,3,0,0,0,0,0.785714285714286,0.893617021276596,0.25,0.553191489361702,"1","orthodox"
"142",28,22,165,160,165,171,115,115,20,17,0,2,16,12,6,5,-6,0,0,0,0,0,1,0.894736842105263,0.8,0.631578947368421,"1","orthodox"
"9691",36,28,196,187,208,198,243,236,52,31,2,3,43,27,8,9,10,7,1,0,0,0,0.962962962962963,0.911764705882353,0.796296296296296,0.794117647058823,"1","orthodox"
"973",24,25,173,175,182,178,135,135,24,21,3,2,12,12,-1,-2,4,0,0,0,0,0,0.888888888888889,0.91304347826087,0.444444444444444,0.521739130434783,"1","Unknown"
"292",21,28,183,180,183,180,148,148,3,0,1,1,1,0,-7,3,3,0,0,0,0,0,0.75,0,0.25,0,"1","orthodox"
"899",28,25,187,185,192,193,174,172,17,11,6,8,16,2,3,2,-1,2,0,0,0,0,0.739130434782609,0.578947368421053,0.695652173913043,0.105263157894737,"1","orthodox"
"37",29,34,156,168,168,176,122,121,22,21,0,5,15,13,-5,-12,-8,1,0,0,0,0,1,0.807692307692308,0.681818181818182,0.5,"1","orthodox"
"318",45,20,180,191,191,198,191,204,185,15,22,0,131,12,25,-11,-7,-13,1,0,0,0,0.893719806763285,1,0.632850241545894,0.8,"1","orthodox"
"575",24,24,173,173,188,185,147,145,39,21,1,3,14,8,0,0,3,2,0,0,0,0,0.975,0.875,0.35,0.333333333333333,"1","orthodox"
"371",24,23,163,163,165,170,133,136,95,59,11,5,30,4,1,0,-5,-3,0,0,0,0,0.89622641509434,0.921875,0.283018867924528,0.0625,"1","orthodox"
"63",27,32,168,166,173,164,115,115,36,30,3,1,15,24,-5,2,9,0,0,0,0,0,0.923076923076923,0.967741935483871,0.384615384615385,0.774193548387097,"1","southpaw"
"5982",26,20,172,173,175,173,126,126,32,27,6,2,15,18,6,-1,2,0,0,0,0,0,0.842105263157895,0.931034482758621,0.394736842105263,0.620689655172414,"1","orthodox"
"7421",24,24,192,193,206,203,222,240,22,19,0,0,12,15,0,-1,3,-18,0,0,0,1,1,1,0.545454545454545,0.789473684210526,"1","orthodox"
"753",27,40,180,170,185,178,139,139,27,34,2,9,19,25,-13,10,7,0,0,1,0,0,0.931034482758621,0.790697674418605,0.655172413793103,0.581395348837209,"1","orthodox"
"78",27,28,174,174,175,180,147,147,26,29,2,3,14,19,-1,0,-5,0,0,0,0,0,0.928571428571429,0.90625,0.5,0.59375,"1","southpaw"
"992",34,31,179,170,185,175,140,140,20,22,3,5,18,13,3,9,10,0,0,0,0,0,0.869565217391304,0.814814814814815,0.782608695652174,0.481481481481481,"1","orthodox"
"367",41,39,185,187,198,192,191,188,59,27,4,14,46,25,2,-2,6,3,1,1,0,0,0.936507936507937,0.658536585365854,0.73015873015873,0.609756097560976,"1","orthodox"
"8411",32,25,193,184,208,193,234,206,15,15,4,1,12,7,7,9,15,28,0,0,1,0,0.789473684210526,0.9375,0.631578947368421,0.4375,"1","orthodox"
"431",37,24,171,198,188,206,191,230,156,18,29,20,89,12,13,-27,-18,-39,1,0,0,1,0.843243243243243,0.473684210526316,0.481081081081081,0.315789473684211,"1","orthodox"
"858",34,31,187,193,192,203,190,188,23,26,10,1,22,13,3,-6,-11,2,0,0,0,0,0.696969696969697,0.962962962962963,0.666666666666667,0.481481481481481,"1","orthodox"
"907",25,25,179,193,183,188,184,189,13,2,2,0,7,1,0,-14,-5,-5,0,0,0,0,0.866666666666667,1,0.466666666666667,0.5,"1","orthodox"
"482",25,21,166,164,170,174,129,130,32,65,5,9,15,14,4,2,-4,-1,0,0,0,0,0.864864864864865,0.878378378378378,0.405405405405405,0.189189189189189,"1","orthodox"
"206",28,22,185,178,196,183,157,160,36,25,0,0,24,18,6,7,13,-3,0,0,0,0,1,1,0.666666666666667,0.72,"1","southpaw"
"622",22,24,175,179,191,180,148,155,26,64,3,7,15,26,-2,-4,11,-7,0,0,0,0,0.896551724137931,0.901408450704225,0.517241379310345,0.366197183098592,"1","orthodox"
"957",30,24,171,173,165,180,128,127,79,55,9,9,47,10,6,-2,-15,1,0,0,0,0,0.897727272727273,0.859375,0.534090909090909,0.15625,"1","southpaw"
"3851",31,33,173,173,175,180,159,160,55,45,4,14,24,21,-2,0,-5,-1,0,0,0,0,0.932203389830508,0.76271186440678,0.406779661016949,0.355932203389831,"1","orthodox"
"401",44,27,180,178,184,185,160,159,174,44,18,1,109,8,17,2,-1,1,1,0,0,0,0.90625,0.977777777777778,0.567708333333333,0.177777777777778,"1","orthodox"
"343",34,25,170,189,180,198,187,190,28,16,4,0,17,12,9,-19,-18,-3,0,0,0,0,0.875,1,0.53125,0.75,"1","orthodox"
"769",29,27,175,174,180,179,152,153,56,41,2,1,21,27,2,1,1,-1,0,0,0,0,0.96551724137931,0.976190476190476,0.362068965517241,0.642857142857143,"1","orthodox"
"480",19,32,183,185,180,182,168,177,13,80,0,21,8,22,-13,-2,-2,-9,0,0,0,0,1,0.792079207920792,0.615384615384615,0.217821782178218,"1","orthodox"
"588",21,22,189,188,206,191,200,203,24,30,3,10,20,8,-1,1,15,-3,0,0,0,0,0.888888888888889,0.75,0.740740740740741,0.2,"1","orthodox"
"982",40,37,185,193,196,216,232,204,9,29,21,9,4,21,3,-8,-20,28,1,1,1,0,0.3,0.763157894736842,0.133333333333333,0.552631578947368,"1","orthodox"
"81",19,25,170,173,170,170,124,125,11,10,2,0,10,9,-6,-3,0,-1,0,0,0,0,0.846153846153846,1,0.769230769230769,0.9,"1","Unknown"
"795",30,22,180,182,185,187,177,182,67,53,25,11,22,34,8,-2,-2,-5,0,0,0,0,0.728260869565217,0.828125,0.239130434782609,0.53125,"1","orthodox"
"568",35,39,170,192,180,199,235,222,28,52,5,2,17,49,-4,-22,-19,13,1,1,0,0,0.848484848484849,0.962962962962963,0.515151515151515,0.907407407407407,"1","orthodox"
"96",31,25,185,180,191,184,199,196,36,13,3,1,18,10,6,5,7,3,0,0,0,0,0.923076923076923,0.928571428571429,0.461538461538462,0.714285714285714,"1","orthodox"
"888",22,24,168,173,173,180,117,118,11,28,1,1,9,19,-2,-5,-7,-1,0,0,0,0,0.916666666666667,0.96551724137931,0.75,0.655172413793103,"1","orthodox"
"338",34,32,185,189,196,198,209,224,23,30,2,2,16,22,2,-4,-2,-15,0,0,0,1,0.92,0.9375,0.64,0.6875,"1","orthodox"
"1007",28,25,185,177,185,175,152,153,22,11,1,0,15,8,3,8,10,-1,0,0,0,0,0.956521739130435,1,0.652173913043478,0.727272727272727,"1","orthodox"
"153",30,25,179,175,182,176,139,138,6,7,0,0,1,6,5,4,6,1,0,0,0,0,1,1,0.166666666666667,0.857142857142857,"1","southpaw"
"702",39,20,163,168,168,175,139,133,56,13,12,1,42,9,19,-5,-7,6,1,0,0,0,0.823529411764706,0.928571428571429,0.617647058823529,0.642857142857143,"1","orthodox"
"767",29,28,165,180,173,183,131,131,53,31,7,0,36,15,1,-15,-10,0,0,0,0,0,0.883333333333333,1,0.6,0.483870967741935,"1","orthodox"
"667",21,26,180,173,188,180,161,162,69,109,16,14,20,25,-5,7,8,-1,0,0,0,0,0.811764705882353,0.886178861788618,0.235294117647059,0.203252032520325,"1","Unknown"
"420",30,30,169,171,175,169,140,140,40,81,1,0,17,68,0,-2,6,0,0,0,0,0,0.975609756097561,1,0.414634146341463,0.839506172839506,"1","southpaw"
"212",30,25,163,178,160,171,136,132,17,24,2,4,10,17,5,-15,-11,4,0,0,0,0,0.894736842105263,0.857142857142857,0.526315789473684,0.607142857142857,"1","orthodox"
"556",25,27,160,163,170,168,129,122,62,84,7,8,23,31,-2,-3,2,7,0,0,0,0,0.898550724637681,0.91304347826087,0.333333333333333,0.33695652173913,"1","Unknown"
"960",22,35,175,171,173,173,154,153,15,88,4,10,3,72,-13,4,0,1,0,1,0,0,0.789473684210526,0.897959183673469,0.157894736842105,0.73469387755102,"1","orthodox"
"9521",20,25,168,165,171,174,125,125,24,28,10,9,10,7,-5,3,-3,0,0,0,0,0,0.705882352941177,0.756756756756757,0.294117647058824,0.189189189189189,"1","orthodox"
"3171",33,22,166,180,170,184,145,140,135,44,17,1,91,30,11,-14,-14,5,0,0,0,0,0.888157894736842,0.977777777777778,0.598684210526316,0.666666666666667,"1","orthodox"
"835",32,31,179,171,187,176,135,156,40,84,21,42,15,11,1,8,11,-21,0,0,0,1,0.655737704918033,0.666666666666667,0.245901639344262,0.0873015873015873,"1","Unknown"
"453",31,21,169,173,180,177,135,142,148,35,9,5,95,12,10,-4,3,-7,0,0,0,0,0.942675159235669,0.875,0.605095541401274,0.3,"1","orthodox"
"698",29,28,166,170,171,178,122,122,50,29,2,2,36,20,1,-4,-7,0,0,0,0,0,0.961538461538462,0.935483870967742,0.692307692307692,0.645161290322581,"1","orthodox"
"26",32,33,168,179,168,180,140,140,25,28,4,6,18,23,-1,-11,-12,0,0,0,0,0,0.862068965517241,0.823529411764706,0.620689655172414,0.676470588235294,"1","orthodox"
"535",23,21,164,164,174,160,130,139,26,74,9,19,13,9,2,0,14,-9,0,0,0,0,0.742857142857143,0.795698924731183,0.371428571428571,0.0967741935483871,"1","Unknown"
"489",26,32,193,196,203,213,243,228,30,32,1,1,24,26,-6,-3,-10,15,0,0,1,0,0.967741935483871,0.96969696969697,0.774193548387097,0.787878787878788,"1","orthodox"
"807",24,23,178,178,184,183,161,162,60,105,12,2,17,49,1,0,1,-1,0,0,0,0,0.833333333333333,0.981308411214953,0.236111111111111,0.457943925233645,"1","Unknown"
"6771",38,31,185,178,188,183,220,210,42,29,12,13,26,18,7,7,5,10,1,0,0,0,0.777777777777778,0.69047619047619,0.481481481481481,0.428571428571429,"1","orthodox"
"496",27,24,185,189,193,206,189,203,45,38,5,7,31,28,3,-4,-13,-14,0,0,0,0,0.9,0.844444444444444,0.62,0.622222222222222,"1","orthodox"
"989",29,31,185,201,188,218,238,217,23,23,1,0,13,13,-2,-16,-30,21,0,0,1,0,0.958333333333333,1,0.541666666666667,0.565217391304348,"1","orthodox"
"709",33,28,178,179,180,193,144,147,154,54,58,9,81,34,5,-1,-13,-3,0,0,0,0,0.726415094339623,0.857142857142857,0.382075471698113,0.53968253968254,"1","orthodox"
"6491",23,23,170,178,178,180,133,135,78,50,13,5,38,5,0,-8,-2,-2,0,0,0,0,0.857142857142857,0.909090909090909,0.417582417582418,0.0909090909090909,"1","orthodox"
"823",25,25,187,187,192,188,177,178,8,18,2,1,7,12,0,0,4,-1,0,0,0,0,0.8,0.947368421052632,0.7,0.631578947368421,"1","orthodox"
"208",26,21,170,172,170,173,122,122,1,7,2,0,1,3,5,-2,-3,0,0,0,0,0,0.333333333333333,1,0.333333333333333,0.428571428571429,"1","orthodox"
"612",30,38,177,171,180,175,153,153,36,41,4,10,11,21,-8,6,5,0,0,1,0,0,0.9,0.803921568627451,0.275,0.411764705882353,"1","southpaw"
"670",28,25,185,185,198,188,168,168,18,34,4,0,16,26,3,0,10,0,0,0,0,0,0.818181818181818,1,0.727272727272727,0.764705882352941,"1","orthodox"
"423",30,34,178,189,180,198,218,218,45,33,2,3,39,24,-4,-11,-18,0,0,0,0,0,0.957446808510638,0.916666666666667,0.829787234042553,0.666666666666667,"1","orthodox"
"514",32,26,191,182,201,185,188,209,41,25,4,0,35,22,6,9,16,-21,0,0,0,1,0.911111111111111,1,0.777777777777778,0.88,"1","orthodox"
"393",19,32,183,185,180,182,168,177,13,80,0,21,8,22,-13,-2,-2,-9,0,0,0,0,1,0.792079207920792,0.615384615384615,0.217821782178218,"1","orthodox"
"468",31,22,170,170,170,183,170,161,120,72,18,12,54,43,9,0,-13,9,0,0,0,0,0.869565217391304,0.857142857142857,0.391304347826087,0.511904761904762,"1","orthodox"
"848",28,31,175,170,178,173,148,149,51,20,22,9,17,8,-3,5,5,-1,0,0,0,0,0.698630136986301,0.689655172413793,0.232876712328767,0.275862068965517,"1","orthodox"
"6751",30,37,188,188,188,198,218,247,33,46,2,4,29,36,-7,0,-10,-29,0,1,0,1,0.942857142857143,0.92,0.828571428571429,0.72,"1","southpaw"
"618",26,26,183,193,188,208,192,256,26,24,7,5,19,18,0,-10,-20,-64,0,0,0,1,0.787878787878788,0.827586206896552,0.575757575757576,0.620689655172414,"1","orthodox"
"891",33,22,160,160,168,168,112,112,31,16,9,1,27,4,11,0,0,0,0,0,0,0,0.775,0.941176470588235,0.675,0.235294117647059,"1","Unknown"
"833",35,22,171,171,176,175,139,136,110,34,54,9,14,21,13,0,1,3,1,0,0,0,0.670731707317073,0.790697674418605,0.0853658536585366,0.488372093023256,"1","orthodox"
"661",25,23,184,173,193,188,180,182,52,55,9,17,21,23,2,11,5,-2,0,0,0,0,0.852459016393443,0.763888888888889,0.344262295081967,0.319444444444444,"1","orthodox"
"984",40,37,185,193,196,216,232,204,9,29,21,9,4,21,3,-8,-20,28,1,1,1,0,0.3,0.763157894736842,0.133333333333333,0.552631578947368,"1","orthodox"
"985",24,27,173,170,183,178,143,143,45,14,2,2,40,12,-3,3,5,0,0,0,0,0,0.957446808510638,0.875,0.851063829787234,0.75,"1","orthodox"
"1481",24,19,168,174,183,174,126,125,19,14,2,0,8,12,5,-6,9,1,0,0,0,0,0.904761904761905,1,0.380952380952381,0.857142857142857,"1","orthodox"
"870",23,23,175,173,183,178,135,135,14,12,1,1,9,8,0,2,5,0,0,0,0,0,0.933333333333333,0.923076923076923,0.6,0.615384615384615,"1","orthodox"
"5831",31,31,168,169,173,173,134,134,75,29,18,13,31,18,0,-1,0,0,0,0,0,0,0.806451612903226,0.69047619047619,0.333333333333333,0.428571428571429,"1","orthodox"
"594",27,19,155,163,160,161,115,118,75,23,14,1,9,11,8,-8,-1,-3,0,0,0,0,0.842696629213483,0.958333333333333,0.101123595505618,0.458333333333333,"1","Unknown"
"263",22,19,173,175,173,185,135,135,4,4,2,2,0,2,3,-2,-12,0,0,0,0,0,0.666666666666667,0.666666666666667,0,0.333333333333333,"1","orthodox"
"46",21,32,170,163,173,168,123,122,13,30,0,14,10,25,-11,7,5,1,0,0,0,0,1,0.681818181818182,0.769230769230769,0.568181818181818,"1","orthodox"
"531",30,20,164,170,160,170,129,133,191,56,53,3,16,14,10,-6,-10,-4,0,0,0,0,0.782786885245902,0.949152542372881,0.0655737704918033,0.23728813559322,"1","orthodox"
"33",25,30,163,160,168,164,108,108,19,24,0,2,12,11,-5,3,4,0,0,0,0,0,1,0.923076923076923,0.631578947368421,0.423076923076923,"1","orthodox"
"506",20,23,179,178,182,180,168,168,57,46,12,5,7,14,-3,1,2,0,0,0,0,0,0.826086956521739,0.901960784313726,0.101449275362319,0.274509803921569,"1","orthodox"
"235",34,23,198,188,211,190,267,237,13,5,0,5,7,4,11,10,21,30,0,0,1,0,1,0.5,0.538461538461538,0.4,"1","orthodox"
"3091",21,19,174,183,175,186,154,154,0,0,1,1,0,0,2,-9,-11,0,0,0,0,0,0,0,0,0,"1","orthodox"
"7231",34,25,189,182,196,180,168,168,32,19,1,0,19,15,9,7,16,0,0,0,0,0,0.96969696969697,1,0.575757575757576,0.789473684210526,"1","southpaw"
"787",22,28,173,161,178,157,138,137,71,48,15,15,9,20,-6,12,21,1,0,0,0,0,0.825581395348837,0.761904761904762,0.104651162790698,0.317460317460317,"1","Unknown"
"5591",28,28,174,182,185,193,185,222,47,63,8,11,34,24,0,-8,-8,-37,0,0,0,1,0.854545454545454,0.851351351351351,0.618181818181818,0.324324324324324,"1","orthodox"
"874",24,26,175,189,183,185,216,206,49,36,16,21,32,16,-2,-14,-2,10,0,0,0,0,0.753846153846154,0.631578947368421,0.492307692307692,0.280701754385965,"1","orthodox"
"444",35,25,171,171,183,178,147,145,81,42,6,3,54,34,10,0,5,2,1,0,0,0,0.931034482758621,0.933333333333333,0.620689655172414,0.755555555555556,"1","orthodox"
"682",33,25,159,162,161,163,106,108,35,20,20,1,22,12,8,-3,-2,-2,0,0,0,0,0.636363636363636,0.952380952380952,0.4,0.571428571428571,"1","orthodox"
"461",36,24,182,183,182,194,167,206,55,10,7,0,48,8,12,-1,-12,-39,1,0,0,1,0.887096774193548,1,0.774193548387097,0.8,"1","orthodox"
"710",22,28,178,179,180,180,142,139,35,85,8,18,19,22,-6,-1,0,3,0,0,0,0,0.813953488372093,0.825242718446602,0.441860465116279,0.213592233009709,"1","orthodox"
"272",21,30,178,170,188,180,149,150,11,9,1,4,7,6,-9,8,8,-1,0,0,0,0,0.916666666666667,0.692307692307692,0.583333333333333,0.461538461538462,"1","orthodox"
"169",26,25,178,181,180,183,154,156,0,4,3,0,0,3,1,-3,-3,-2,0,0,0,0,0,1,0,0.75,"1","orthodox"
"3411",30,28,192,189,211,198,208,246,30,24,4,0,20,20,2,3,13,-38,0,0,0,1,0.882352941176471,1,0.588235294117647,0.833333333333333,"1","orthodox"
"534",23,18,164,168,160,178,130,126,101,28,22,4,10,2,5,-4,-18,4,0,0,0,0,0.821138211382114,0.875,0.0813008130081301,0.0625,"1","orthodox"
"516",33,26,185,179,182,178,175,169,82,68,21,6,22,34,7,6,4,6,0,0,0,0,0.796116504854369,0.918918918918919,0.213592233009709,0.459459459459459,"1","orthodox"
"139",24,21,181,183,185,184,168,137,1,2,0,0,0,1,3,-2,1,31,0,0,1,0,1,1,0,0.5,"1","orthodox"
"780",38,35,192,185,198,196,230,239,45,23,4,4,30,16,3,7,2,-9,1,1,0,0,0.918367346938776,0.851851851851852,0.612244897959184,0.592592592592593,"1","orthodox"
"278",29,32,168,170,180,170,125,126,18,47,0,11,13,33,-3,-2,10,-1,0,0,0,0,1,0.810344827586207,0.722222222222222,0.568965517241379,"1","southpaw"
"2151",26,33,185,173,193,183,161,163,19,28,1,7,9,16,-7,12,10,-2,0,0,0,0,0.95,0.8,0.45,0.457142857142857,"1","southpaw"
"996",35,35,183,188,185,201,209,225,22,9,13,3,16,5,0,-5,-16,-16,1,1,0,1,0.628571428571429,0.75,0.457142857142857,0.416666666666667,"1","orthodox"
"911",30,39,170,171,178,180,138,133,37,137,7,45,8,29,-9,-1,-2,5,0,1,0,0,0.840909090909091,0.752747252747253,0.181818181818182,0.159340659340659,"1","Unknown"
"4761",21,28,183,178,185,189,168,165,30,38,3,7,15,23,-7,5,-4,3,0,0,0,0,0.909090909090909,0.844444444444444,0.454545454545455,0.511111111111111,"1","orthodox"
"397",22,24,180,173,185,180,156,163,30,97,11,18,8,11,-2,7,5,-7,0,0,0,0,0.731707317073171,0.843478260869565,0.195121951219512,0.0956521739130435,"1","Unknown"
"1040",31,35,180,179,175,188,158,158,36,26,8,5,29,16,-4,1,-13,0,0,1,0,0,0.818181818181818,0.838709677419355,0.659090909090909,0.516129032258065,"1","orthodox"
"203",32,28,178,178,183,183,189,187,24,54,14,4,5,35,4,0,0,2,0,0,0,0,0.631578947368421,0.931034482758621,0.131578947368421,0.603448275862069,"1","orthodox"
"5291",21,23,182,180,185,187,168,162,43,36,10,3,8,18,-2,2,-2,6,0,0,0,0,0.811320754716981,0.923076923076923,0.150943396226415,0.461538461538462,"1","orthodox"
"596",19,21,166,155,168,160,112,115,39,27,7,3,18,3,-2,11,8,-3,0,0,0,0,0.847826086956522,0.9,0.391304347826087,0.1,"1","orthodox"
"926",21,23,175,173,188,178,126,126,3,6,0,0,3,5,-2,2,10,0,0,0,0,0,1,1,1,0.833333333333333,"1","southpaw"
"447",35,32,183,184,194,188,208,227,19,52,0,5,16,24,3,-1,6,-19,1,0,0,1,1,0.912280701754386,0.842105263157895,0.421052631578947,"1","orthodox"
"2681",25,34,191,188,201,201,248,240,15,19,0,7,12,11,-9,3,0,8,0,0,0,0,1,0.730769230769231,0.8,0.423076923076923,"1","orthodox"
"945",27,35,175,187,178,183,158,158,27,22,0,6,24,7,-8,-12,-5,0,0,1,0,0,1,0.785714285714286,0.888888888888889,0.25,"1","southpaw"
"772",30,27,171,172,178,175,145,145,28,32,0,5,19,21,3,-1,3,0,0,0,0,0,1,0.864864864864865,0.678571428571429,0.567567567567568,"1","orthodox"
"790",24,23,171,168,175,178,137,136,47,56,6,5,17,7,1,3,-3,1,0,0,0,0,0.886792452830189,0.918032786885246,0.320754716981132,0.114754098360656,"1","orthodox"
"731",23,27,174,173,183,173,151,154,35,98,9,18,8,17,-4,1,10,-3,0,0,0,0,0.795454545454545,0.844827586206897,0.181818181818182,0.146551724137931,"1","orthodox"
"358",45,34,170,169,168,175,157,160,96,58,11,3,68,28,11,1,-7,-3,1,0,0,0,0.897196261682243,0.950819672131147,0.635514018691589,0.459016393442623,"1","orthodox"
"100",23,29,177,175,175,174,140,140,22,23,2,3,13,15,-6,2,1,0,0,0,0,0,0.916666666666667,0.884615384615385,0.541666666666667,0.576923076923077,"1","orthodox"
"659",22,22,177,178,178,183,157,157,6,93,0,2,5,41,0,-1,-5,0,0,0,0,0,1,0.978947368421053,0.833333333333333,0.431578947368421,"1","orthodox"
"525",28,24,182,183,185,193,185,177,103,72,17,25,12,21,4,-1,-8,8,0,0,0,0,0.858333333333333,0.742268041237113,0.1,0.216494845360825,"1","orthodox"
"909",23,38,179,180,183,185,183,186,6,47,0,17,2,31,-15,-1,-2,-3,0,1,0,0,1,0.734375,0.333333333333333,0.484375,"1","orthodox"
"6631",32,24,185,173,185,179,178,183,10,27,1,3,4,25,8,12,6,-5,0,0,0,0,0.909090909090909,0.9,0.363636363636364,0.833333333333333,"1","orthodox"
"959",24,29,193,183,203,201,225,215,25,15,0,0,20,10,-5,10,2,10,0,0,0,0,1,1,0.8,0.666666666666667,"1","orthodox"
"49",26,34,171,174,177,175,139,140,24,19,3,1,19,18,-8,-3,2,-1,0,0,0,0,0.888888888888889,0.95,0.703703703703704,0.9,"1","southpaw"
"526",27,21,182,188,185,191,189,200,94,29,16,9,12,8,6,-6,-6,-11,0,0,0,0,0.854545454545454,0.763157894736842,0.109090909090909,0.210526315789474,"1","orthodox"
"199",19,21,170,175,178,177,124,124,4,6,0,0,3,3,-2,-5,1,0,0,0,0,0,1,1,0.75,0.5,"1","Unknown"
"974",19,19,173,175,178,173,137,132,28,21,1,3,20,15,0,-2,5,5,0,0,0,0,0.96551724137931,0.875,0.689655172413793,0.625,"1","orthodox"
"280",25,25,168,168,175,163,127,127,4,3,3,3,1,1,0,0,12,0,0,0,0,0,0.571428571428571,0.5,0.142857142857143,0.166666666666667,"1","orthodox"
"241",39,22,180,180,183,174,135,135,2,4,4,2,1,4,17,0,9,0,1,0,0,0,0.333333333333333,0.666666666666667,0.166666666666667,0.666666666666667,"1","orthodox"
"72",36,29,213,191,216,198,217,316,50,22,1,1,34,21,7,22,18,-99,1,0,0,1,0.980392156862745,0.956521739130435,0.666666666666667,0.91304347826087,"1","orthodox"
"421",24,35,180,189,193,198,217,231,31,35,1,3,25,25,-11,-9,-5,-14,0,1,0,0,0.96875,0.921052631578947,0.78125,0.657894736842105,"1","orthodox"
"547",28,24,170,164,168,163,125,124,22,30,1,0,14,28,4,6,5,1,0,0,0,0,0.956521739130435,1,0.608695652173913,0.933333333333333,"1","orthodox"
"3742",36,24,182,183,182,194,167,206,55,10,7,0,48,8,12,-1,-12,-39,1,0,0,1,0.887096774193548,1,0.774193548387097,0.8,"1","orthodox"
"321",43,36,185,180,191,185,173,173,48,44,4,0,32,32,7,5,6,0,1,1,0,0,0.923076923076923,1,0.615384615384615,0.727272727272727,"1","orthodox"
"662",25,25,175,178,183,188,161,164,19,22,7,0,9,17,0,-3,-5,-3,0,0,0,0,0.730769230769231,1,0.346153846153846,0.772727272727273,"1","Unknown"
"716",27,28,185,196,198,203,204,270,14,20,7,0,8,11,-1,-11,-5,-66,0,0,0,1,0.666666666666667,1,0.380952380952381,0.55,"1","orthodox"
"599",27,21,171,164,172,166,133,128,47,46,14,3,30,23,6,7,6,5,0,0,0,0,0.770491803278688,0.938775510204082,0.491803278688525,0.469387755102041,"1","Unknown"
"671",28,27,171,179,176,188,149,140,71,34,41,11,8,6,1,-8,-12,9,0,0,0,0,0.633928571428571,0.755555555555556,0.0714285714285714,0.133333333333333,"1","orthodox"
"430",34,25,170,189,180,198,187,190,28,16,4,0,17,12,9,-19,-18,-3,0,0,0,0,0.875,1,0.53125,0.75,"1","orthodox"
"1029",36,26,157,170,170,173,127,127,11,23,10,4,7,19,10,-13,-3,0,1,0,0,0,0.523809523809524,0.851851851851852,0.333333333333333,0.703703703703704,"1","orthodox"
"610",22,24,168,171,174,180,134,135,53,50,6,6,31,27,-2,-3,-6,-1,0,0,0,0,0.898305084745763,0.892857142857143,0.525423728813559,0.482142857142857,"1","orthodox"
"657",35,26,177,173,178,182,159,154,61,44,9,16,31,26,9,4,-4,5,1,0,0,0,0.871428571428571,0.733333333333333,0.442857142857143,0.433333333333333,"1","orthodox"
"466",42,25,178,184,183,192,142,141,77,17,7,3,62,11,17,-6,-9,1,1,0,0,0,0.916666666666667,0.85,0.738095238095238,0.55,"1","orthodox"
"47",20,22,168,163,168,174,108,108,11,12,1,0,6,10,-2,5,-6,0,0,0,0,0,0.916666666666667,1,0.5,0.833333333333333,"1","orthodox"
"1010",29,22,170,170,175,173,128,136,39,4,7,1,20,4,7,0,2,-8,0,0,0,0,0.847826086956522,0.8,0.434782608695652,0.8,"1","Unknown"
"739",35,28,179,170,177,178,178,192,29,35,5,2,23,24,7,9,-1,-14,1,0,0,0,0.852941176470588,0.945945945945946,0.676470588235294,0.648648648648649,"1","orthodox"
"362",36,21,171,171,183,175,158,158,79,26,16,1,21,11,15,0,8,0,1,0,0,0,0.831578947368421,0.962962962962963,0.221052631578947,0.407407407407407,"1","orthodox"
"188",30,34,193,193,189,203,238,268,23,47,1,4,14,41,-4,0,-14,-30,0,0,0,1,0.958333333333333,0.92156862745098,0.583333333333333,0.803921568627451,"1","orthodox"
"481",23,24,175,168,183,170,129,130,47,25,7,2,16,10,-1,7,13,-1,0,0,0,0,0.87037037037037,0.925925925925926,0.296296296296296,0.37037037037037,"1","orthodox"
"3011",20,21,168,163,180,165,111,110,6,6,0,0,6,6,-1,5,15,1,0,0,0,0,1,1,1,1,"1","orthodox"
"600",25,27,171,166,172,166,133,133,42,11,12,3,25,4,-2,5,6,0,0,0,0,0,0.777777777777778,0.785714285714286,0.462962962962963,0.285714285714286,"1","Unknown"
"929",24,24,162,168,163,170,122,122,15,26,3,1,9,16,0,-6,-7,0,0,0,0,0,0.833333333333333,0.962962962962963,0.5,0.592592592592593,"1","southpaw"
"805",25,24,178,178,184,183,157,158,64,115,16,2,18,52,1,0,1,-1,0,0,0,0,0.8,0.982905982905983,0.225,0.444444444444444,"1","Unknown"
"125",26,25,161,164,163,162,112,112,28,18,0,8,15,7,1,-3,1,0,0,0,0,0,1,0.692307692307692,0.535714285714286,0.269230769230769,"1","southpaw"
"471",20,24,168,170,170,170,135,135,36,107,4,6,12,22,-4,-2,0,0,0,0,0,0,0.9,0.946902654867257,0.3,0.194690265486726,"1","orthodox"
"73",27,27,193,191,189,198,198,197,28,20,1,1,21,19,0,2,-9,1,0,0,0,0,0.96551724137931,0.952380952380952,0.724137931034483,0.904761904761905,"1","orthodox"
"729",28,27,173,165,178,170,125,126,56,21,10,1,26,15,1,8,8,-1,0,0,0,0,0.848484848484849,0.954545454545455,0.393939393939394,0.681818181818182,"1","orthodox"
"9501",26,19,165,168,174,170,126,126,36,37,15,7,8,14,7,-3,4,0,0,0,0,0,0.705882352941177,0.840909090909091,0.156862745098039,0.318181818181818,"1","orthodox"
"75",26,22,180,178,183,183,136,137,21,24,0,3,18,12,4,2,0,-1,0,0,0,0,1,0.888888888888889,0.857142857142857,0.444444444444444,"1","orthodox"
"2861",19,21,170,163,173,173,123,123,2,1,0,0,1,0,-2,7,0,0,0,0,0,0,1,1,0.5,0,"1","orthodox"
"903",33,27,170,171,170,175,134,132,48,18,4,12,44,9,6,-1,-5,2,0,0,0,0,0.923076923076923,0.6,0.846153846153846,0.3,"1","orthodox"
"561",34,31,171,170,172,174,135,132,69,116,32,23,40,31,3,1,-2,3,0,0,0,0,0.683168316831683,0.834532374100719,0.396039603960396,0.223021582733813,"1","Unknown"
"975",33,24,175,183,183,173,155,152,22,7,57,0,16,4,9,-8,10,3,0,0,0,0,0.278481012658228,1,0.20253164556962,0.571428571428571,"1","orthodox"
"319",21,28,180,177,191,180,160,164,23,112,1,26,18,71,-7,3,11,-4,0,0,0,0,0.958333333333333,0.811594202898551,0.75,0.514492753623188,"1","orthodox"
"597",31,27,172,168,175,171,126,126,44,53,7,7,23,40,4,4,4,0,0,0,0,0,0.862745098039216,0.883333333333333,0.450980392156863,0.666666666666667,"1","orthodox"
"2951",21,17,173,167,173,168,106,108,0,1,1,0,0,0,4,6,5,-2,0,0,0,0,0,1,0,0,"1","Unknown"
"187",25,26,170,173,188,178,142,142,13,10,1,0,6,3,-1,-3,10,0,0,0,0,0,0.928571428571429,1,0.428571428571429,0.3,"1","orthodox"
"39",26,23,168,168,173,173,122,121,24,19,0,0,14,9,3,0,0,1,0,0,0,0,1,1,0.583333333333333,0.473684210526316,"1","orthodox"
"747",28,29,154,160,160,165,117,113,91,53,16,6,78,12,-1,-6,-5,4,0,0,0,0,0.850467289719626,0.898305084745763,0.728971962616822,0.203389830508475,"1","Unknown"
"737",25,22,189,193,191,209,180,194,37,50,11,6,22,24,3,-4,-18,-14,0,0,0,0,0.770833333333333,0.892857142857143,0.458333333333333,0.428571428571429,"1","orthodox"
"457",27,28,163,168,165,170,137,145,122,53,17,11,39,21,-1,-5,-5,-8,0,0,0,0,0.877697841726619,0.828125,0.280575539568345,0.328125,"1","orthodox"
"190",19,26,175,170,175,188,135,135,22,25,0,2,18,15,-7,5,-13,0,0,0,0,0,1,0.925925925925926,0.818181818181818,0.555555555555556,"1","southpaw"
"2841",28,23,167,175,173,175,118,118,2,1,3,0,0,1,5,-8,-2,0,0,0,0,0,0.4,1,0,1,"1","orthodox"
"326",30,32,177,185,185,191,160,160,27,32,5,2,19,25,-2,-8,-6,0,0,0,0,0,0.84375,0.941176470588235,0.59375,0.735294117647059,"1","Unknown"
"161",25,23,180,178,187,178,163,163,16,12,0,1,7,2,2,2,9,0,0,0,0,0,1,0.923076923076923,0.4375,0.153846153846154,"1","orthodox"
"7881",36,28,190,188,201,196,246,236,39,22,5,5,20,18,8,2,5,10,1,0,0,0,0.886363636363636,0.814814814814815,0.454545454545455,0.666666666666667,"1","orthodox"
"651",21,25,166,159,168,165,128,127,31,34,4,5,31,14,-4,7,3,1,0,0,0,0,0.885714285714286,0.871794871794872,0.885714285714286,0.358974358974359,"1","orthodox"
"1261",39,25,185,193,201,201,223,226,40,12,20,0,34,9,14,-8,0,-3,1,0,0,0,0.666666666666667,1,0.566666666666667,0.75,"1","orthodox"
"685",35,28,164,178,174,183,133,134,41,28,4,4,18,18,7,-14,-9,-1,1,0,0,0,0.911111111111111,0.875,0.4,0.5625,"1","southpaw"
"128",24,33,175,168,178,174,147,147,27,26,3,9,20,15,-9,7,4,0,0,0,0,0,0.9,0.742857142857143,0.666666666666667,0.428571428571429,"1","orthodox"
"851",34,30,185,178,193,191,215,201,18,19,9,6,11,16,4,7,2,14,0,0,0,0,0.666666666666667,0.76,0.407407407407407,0.64,"1","orthodox"
"778",40,32,192,188,198,196,231,229,46,32,6,9,31,26,8,4,2,2,1,0,0,0,0.884615384615385,0.780487804878049,0.596153846153846,0.634146341463415,"1","orthodox"
"381",31,22,170,170,170,183,170,161,120,72,18,12,54,43,9,0,-13,9,0,0,0,0,0.869565217391304,0.857142857142857,0.391304347826087,0.511904761904762,"1","orthodox"
"308",18,19,178,170,179,172,154,154,1,0,4,1,0,0,-1,8,7,0,0,0,0,0,0.2,0,0,0,"1","orthodox"
"200",24,25,170,179,175,170,127,127,29,19,0,3,14,12,-1,-9,5,0,0,0,0,0,1,0.863636363636364,0.482758620689655,0.545454545454545,"1","southpaw"
"655",24,20,174,178,178,185,146,147,10,12,0,1,3,3,4,-4,-7,-1,0,0,0,0,1,0.923076923076923,0.3,0.230769230769231,"1","orthodox"
"10051",39,28,168,170,165,173,139,132,70,24,9,6,38,20,11,-2,-8,7,1,0,0,0,0.886075949367089,0.8,0.481012658227848,0.666666666666667,"1","orthodox"
"768",29,34,178,175,178,175,164,164,26,27,4,6,22,22,-5,3,3,0,0,0,0,0,0.866666666666667,0.818181818181818,0.733333333333333,0.666666666666667,"1","orthodox"
"749",28,28,175,178,178,184,160,162,93,97,16,10,14,17,0,-3,-6,-2,0,0,0,0,0.853211009174312,0.906542056074766,0.128440366972477,0.158878504672897,"1","orthodox"
"365",33,26,169,171,180,172,132,132,157,43,10,14,100,26,7,-2,8,0,0,0,0,0,0.940119760479042,0.754385964912281,0.598802395209581,0.456140350877193,"1","orthodox"
"288",19,18,179,175,179,179,141,146,2,0,3,1,0,0,1,4,0,-5,0,0,0,0,0.4,0,0,0,"1","southpaw"
"912",35,26,171,169,180,176,140,141,120,65,37,39,23,24,9,2,4,-1,1,0,0,0,0.764331210191083,0.625,0.146496815286624,0.230769230769231,"1","orthodox"
"207",24,21,162,172,165,173,122,122,2,9,5,0,1,3,3,-10,-8,0,0,0,0,0,0.285714285714286,1,0.142857142857143,0.333333333333333,"1","orthodox"
"746",37,30,196,177,208,178,215,242,52,44,4,4,43,25,7,19,30,-27,1,0,0,1,0.928571428571429,0.916666666666667,0.767857142857143,0.520833333333333,"1","orthodox"
"775",27,25,171,184,175,185,161,162,43,25,14,4,24,13,2,-13,-10,-1,0,0,0,0,0.754385964912281,0.862068965517241,0.421052631578947,0.448275862068966,"1","orthodox"
"672",28,27,171,179,176,188,149,142,71,31,40,10,8,5,1,-8,-12,7,0,0,0,0,0.63963963963964,0.75609756097561,0.0720720720720721,0.121951219512195,"1","orthodox"
"818",32,42,191,188,193,208,236,253,27,50,3,8,15,36,-10,3,-15,-17,0,1,0,1,0.9,0.862068965517241,0.5,0.620689655172414,"1","orthodox"
"185",25,23,196,191,203,203,210,202,2,1,0,0,1,1,2,5,0,8,0,0,0,0,1,1,0.5,1,"1","orthodox"
"287",26,19,170,174,170,173,141,138,1,1,0,0,0,1,7,-4,-3,3,0,0,0,0,1,1,0,1,"1","orthodox"
"881",20,34,175,180,185,185,189,187,1,38,3,16,1,25,-14,-5,0,2,0,0,0,0,0.25,0.703703703703704,0.25,0.462962962962963,"1","Unknown"
"245",28,26,183,185,175,196,159,159,25,18,1,3,9,17,2,-2,-21,0,0,0,0,0,0.961538461538462,0.857142857142857,0.346153846153846,0.80952380952381,"1","orthodox"
"248",34,24,168,173,165,165,158,157,21,13,22,0,4,5,10,-5,0,1,0,0,0,0,0.488372093023256,1,0.0930232558139535,0.384615384615385,"1","orthodox"
"8491",22,28,164,170,174,170,135,135,21,69,5,30,13,20,-6,-6,4,0,0,0,0,0,0.807692307692308,0.696969696969697,0.5,0.202020202020202,"1","Unknown"
"741",26,24,192,188,206,198,222,218,24,21,2,0,13,11,2,4,8,4,0,0,0,0,0.923076923076923,1,0.5,0.523809523809524,"1","orthodox"
"7081",30,30,188,193,196,203,190,188,23,24,3,1,19,12,0,-5,-7,2,0,0,0,0,0.884615384615385,0.96,0.730769230769231,0.48,"1","orthodox"
"676",27,24,178,178,184,189,166,165,65,16,25,4,18,9,3,0,-5,1,0,0,0,0,0.722222222222222,0.8,0.2,0.45,"1","Unknown"
"607",27,19,171,180,180,183,137,137,68,22,10,2,33,8,8,-9,-3,0,0,0,0,0,0.871794871794872,0.916666666666667,0.423076923076923,0.333333333333333,"1","orthodox"
"182",22,20,170,173,172,173,129,126,2,5,0,1,1,3,2,-3,-1,3,0,0,0,0,1,0.833333333333333,0.5,0.5,"1","southpaw"
"474",26,32,188,183,198,185,190,201,21,83,2,10,16,46,-6,5,13,-11,0,0,0,0,0.91304347826087,0.89247311827957,0.695652173913043,0.494623655913978,"1","orthodox"
"1921",19,26,175,170,175,188,135,135,22,25,0,2,18,15,-7,5,-13,0,0,0,0,0,1,0.925925925925926,0.818181818181818,0.555555555555556,"1","southpaw"
"558",25,32,188,182,198,193,184,200,18,80,1,22,14,29,-7,6,5,-16,0,0,0,1,0.947368421052632,0.784313725490196,0.736842105263158,0.284313725490196,"1","orthodox"
"813",30,24,157,173,168,180,132,130,66,57,24,9,36,11,6,-16,-12,2,0,0,0,0,0.733333333333333,0.863636363636364,0.4,0.166666666666667,"1","Unknown"
"491",26,30,188,196,193,213,241,227,45,27,2,1,39,23,-4,-8,-20,14,0,0,0,0,0.957446808510638,0.964285714285714,0.829787234042553,0.821428571428571,"1","orthodox"
"759",27,23,178,183,183,189,176,175,56,26,10,2,12,18,4,-5,-6,1,0,0,0,0,0.848484848484849,0.928571428571429,0.181818181818182,0.642857142857143,"1","orthodox"
"163",23,26,178,170,178,173,141,141,17,8,1,13,9,2,-3,8,5,0,0,0,0,0,0.944444444444444,0.380952380952381,0.5,0.0952380952380952,"1","Unknown"
"650",21,21,170,173,178,178,135,134,52,81,9,4,21,9,0,-3,0,1,0,0,0,0,0.852459016393443,0.952941176470588,0.344262295081967,0.105882352941176,"1","orthodox"
"74",26,25,179,182,184,180,171,169,12,18,3,1,5,12,1,-3,4,2,0,0,0,0,0.8,0.947368421052632,0.333333333333333,0.631578947368421,"1","orthodox"
"195",36,31,183,180,173,185,160,160,37,21,1,6,24,12,5,3,-12,0,1,0,0,0,0.973684210526316,0.777777777777778,0.631578947368421,0.444444444444444,"1","southpaw"
"378",37,35,170,170,175,170,135,135,36,48,3,4,22,35,2,0,5,0,1,1,0,0,0.923076923076923,0.923076923076923,0.564102564102564,0.673076923076923,"1","southpaw"
"146",32,22,171,168,170,170,135,141,9,8,8,0,6,6,10,3,0,-6,0,0,0,0,0.529411764705882,1,0.352941176470588,0.75,"1","southpaw"
"839",41,25,193,191,208,193,270,215,39,20,13,1,29,10,16,2,15,55,1,0,1,0,0.75,0.952380952380952,0.557692307692308,0.476190476190476,"1","orthodox"
"216",25,40,171,168,175,173,152,153,13,38,3,7,2,22,-15,3,2,-1,0,1,0,0,0.8125,0.844444444444444,0.125,0.488888888888889,"1","orthodox"
"3592",38,33,170,178,168,188,158,160,85,35,7,1,61,25,5,-8,-20,-2,1,0,0,0,0.923913043478261,0.972222222222222,0.66304347826087,0.694444444444444,"1","orthodox"
"1026",28,25,165,170,173,180,130,130,22,40,2,8,15,30,3,-5,-7,0,0,0,0,0,0.916666666666667,0.833333333333333,0.625,0.625,"1","southpaw"
"717",22,24,185,194,198,203,218,220,4,5,3,0,3,5,-2,-9,-5,-2,0,0,0,0,0.571428571428571,1,0.428571428571429,1,"1","orthodox"
"513",22,29,180,184,183,196,175,175,21,36,3,1,20,19,-7,-4,-13,0,0,0,0,0,0.875,0.972972972972973,0.833333333333333,0.513513513513513,"1","orthodox"
"546",26,18,160,164,168,174,123,125,59,39,10,3,11,9,8,-4,-6,-2,0,0,0,0,0.855072463768116,0.928571428571429,0.159420289855072,0.214285714285714,"1","orthodox"
"440",29,22,180,179,183,185,135,133,32,18,0,0,16,16,7,1,-2,2,0,0,0,0,1,1,0.5,0.888888888888889,"1","orthodox"
"231",24,21,191,175,196,183,265,264,34,5,6,2,27,2,3,16,13,1,0,0,0,0,0.85,0.714285714285714,0.675,0.285714285714286,"1","orthodox"
"844",20,24,170,170,173,168,118,120,16,18,0,0,13,5,-4,0,5,-2,0,0,0,0,1,1,0.8125,0.277777777777778,"1","orthodox"
"554",22,30,175,171,173,178,136,140,68,75,8,22,33,12,-8,4,-5,-4,0,0,0,0,0.894736842105263,0.77319587628866,0.434210526315789,0.123711340206186,"1","orthodox"
"845",19,23,164,161,164,165,113,115,7,62,0,6,7,26,-4,3,-1,-2,0,0,0,0,1,0.911764705882353,1,0.382352941176471,"1","Unknown"
"133",32,26,171,180,179,188,168,168,40,28,5,0,27,24,6,-9,-9,0,0,0,0,0,0.888888888888889,1,0.6,0.857142857142857,"1","orthodox"
"811",24,31,179,178,203,193,167,192,57,71,16,9,41,29,-7,1,10,-25,0,0,0,1,0.780821917808219,0.8875,0.561643835616438,0.3625,"1","Unknown"
"324",29,34,177,185,185,191,159,159,23,34,2,2,18,26,-5,-8,-6,0,0,0,0,0,0.92,0.944444444444444,0.72,0.722222222222222,"1","southpaw"
"289",30,34,193,196,204,211,261,237,22,12,2,3,19,11,-4,-3,-7,24,0,0,1,0,0.916666666666667,0.8,0.791666666666667,0.733333333333333,"1","orthodox"
"67",26,32,173,175,173,177,140,140,31,33,0,1,23,23,-6,-2,-4,0,0,0,0,0,1,0.970588235294118,0.741935483870968,0.676470588235294,"1","orthodox"
"372",29,33,163,165,168,165,108,107,14,48,1,0,6,36,-4,-2,3,1,0,0,0,0,0.933333333333333,1,0.4,0.75,"1","orthodox"
"922",31,34,171,173,180,178,140,139,22,34,0,9,17,25,-3,-2,2,1,0,0,0,0,1,0.790697674418605,0.772727272727273,0.581395348837209,"1","orthodox"
"147",17,21,172,168,176,170,133,133,1,5,0,0,0,5,-4,4,6,0,0,0,0,0,1,1,0,1,"1","Unknown"
"750",32,25,183,198,191,208,192,199,47,36,5,4,29,18,7,-15,-17,-7,0,0,0,0,0.903846153846154,0.9,0.557692307692308,0.45,"1","orthodox"
"441",29,22,170,179,170,185,135,134,36,16,3,0,26,15,7,-9,-15,1,0,0,0,0,0.923076923076923,1,0.666666666666667,0.9375,"1","orthodox"
"262",18,29,181,179,181,182,139,142,0,1,1,0,0,0,-11,2,-1,-3,0,0,0,0,0,1,0,0,"1","orthodox"
"696",27,21,163,165,169,166,118,119,50,33,9,7,9,19,6,-2,3,-1,0,0,0,0,0.847457627118644,0.825,0.152542372881356,0.475,"1","Unknown"
"261",28,18,167,167,168,168,111,108,1,3,0,1,0,0,10,0,0,3,0,0,0,0,1,0.75,0,0,"1","orthodox"
"1015",33,28,175,177,183,175,159,155,22,12,58,0,16,9,5,-2,8,4,0,0,0,0,0.275,1,0.2,0.75,"1","orthodox"
"801",27,25,188,185,206,188,242,221,25,5,5,5,19,5,2,3,18,21,0,0,1,0,0.833333333333333,0.5,0.633333333333333,0.5,"1","orthodox"
"285",24,32,162,160,165,165,122,122,2,1,4,3,1,0,-8,2,0,0,0,0,0,0,0.333333333333333,0.25,0.166666666666667,0,"1","orthodox"
"637",34,26,182,193,188,206,212,235,32,4,9,0,20,4,8,-11,-18,-23,0,0,0,1,0.780487804878049,1,0.48780487804878,1,"1","orthodox"
"832",27,23,178,184,184,185,157,163,65,9,23,0,18,6,4,-6,-1,-6,0,0,0,0,0.738636363636364,1,0.204545454545455,0.666666666666667,"1","Unknown"
"820",34,26,188,188,196,208,231,231,17,17,5,4,12,11,8,0,-12,0,0,0,0,0,0.772727272727273,0.80952380952381,0.545454545454545,0.523809523809524,"1","orthodox"
"68",27,30,168,170,163,170,117,117,20,21,2,1,5,14,-3,-2,-7,0,0,0,0,0,0.909090909090909,0.954545454545455,0.227272727272727,0.636363636363636,"1","orthodox"
"3141",44,27,180,178,184,185,160,159,174,44,18,1,109,8,17,2,-1,1,1,0,0,0,0.90625,0.977777777777778,0.567708333333333,0.177777777777778,"1","orthodox"
"757",27,21,165,163,169,168,118,118,23,14,0,3,15,10,6,2,1,0,0,0,0,0,1,0.823529411764706,0.652173913043478,0.588235294117647,"1","orthodox"
"7",28,19,159,166,160,170,112,112,32,23,1,1,23,14,9,-7,-10,0,0,0,0,0,0.96969696969697,0.958333333333333,0.696969696969697,0.583333333333333,"1","Unknown"
"678",26,31,178,182,183,185,159,159,24,44,1,1,19,42,-5,-4,-2,0,0,0,0,0,0.96,0.977777777777778,0.76,0.933333333333333,"1","orthodox"
"606",39,27,170,188,180,203,196,193,38,15,8,1,23,12,12,-18,-23,3,1,0,0,0,0.826086956521739,0.9375,0.5,0.75,"1","orthodox"
"164",24,25,170,168,166,175,121,122,23,15,2,5,18,6,-1,2,-9,-1,0,0,0,0,0.92,0.75,0.72,0.3,"1","orthodox"
"998",34,34,180,183,193,185,194,190,31,21,8,8,18,15,0,-3,8,4,0,0,0,0,0.794871794871795,0.724137931034483,0.461538461538462,0.517241379310345,"1","Unknown"
"616",32,28,177,178,180,188,158,158,43,40,4,4,31,25,4,-1,-8,0,0,0,0,0,0.914893617021277,0.909090909090909,0.659574468085106,0.568181818181818,"1","orthodox"
"595",24,22,155,165,160,163,112,118,54,57,6,8,6,21,2,-10,-3,-6,0,0,0,0,0.9,0.876923076923077,0.1,0.323076923076923,"1","Unknown"
"335",29,35,188,189,198,198,214,223,39,34,1,3,31,24,-6,-1,0,-9,0,1,0,0,0.975,0.918918918918919,0.775,0.648648648648649,"1","southpaw"
"752",34,38,171,182,179,196,165,168,41,47,6,5,28,28,-4,-11,-17,-3,0,1,0,0,0.872340425531915,0.903846153846154,0.595744680851064,0.538461538461538,"1","orthodox"
"174",31,23,168,168,175,170,135,135,38,31,1,0,32,15,8,0,5,0,0,0,0,0,0.974358974358974,1,0.82051282051282,0.483870967741935,"1","orthodox"
"79",32,28,185,182,194,185,173,173,32,23,3,4,18,14,4,3,9,0,0,0,0,0,0.914285714285714,0.851851851851852,0.514285714285714,0.518518518518518,"1","southpaw"
"30",20,27,163,174,163,180,107,108,14,12,0,1,8,8,-7,-11,-17,-1,0,0,0,0,1,0.923076923076923,0.571428571428571,0.615384615384615,"1","orthodox"
"766",29,27,187,185,196,196,200,198,0,40,1,2,0,25,2,2,0,2,0,0,0,0,0,0.952380952380952,0,0.595238095238095,"1","orthodox"
"143",37,32,179,193,191,213,234,224,22,10,9,0,18,8,5,-14,-22,10,1,0,0,0,0.709677419354839,1,0.580645161290323,0.8,"1","orthodox"
"197",29,22,188,202,198,201,260,205,3,6,0,0,3,5,7,-14,-3,55,0,0,1,0,1,1,1,0.833333333333333,"1","Unknown"
"375",30,33,185,182,185,182,167,184,10,53,0,7,4,46,-3,3,3,-17,0,0,0,1,1,0.883333333333333,0.4,0.766666666666667,"1","orthodox"
"152",33,32,194,191,208,194,236,249,39,26,8,5,31,14,1,3,14,-13,0,0,0,0,0.829787234042553,0.838709677419355,0.659574468085106,0.451612903225806,"1","orthodox"
"553",27,27,175,168,173,173,135,133,120,50,16,11,57,19,0,7,0,2,0,0,0,0,0.882352941176471,0.819672131147541,0.419117647058824,0.311475409836066,"1","orthodox"
"225",25,31,163,163,165,165,115,115,27,28,2,6,20,21,-6,0,0,0,0,0,0,0,0.931034482758621,0.823529411764706,0.689655172413793,0.617647058823529,"1","southpaw"
"327",30,32,182,191,185,198,212,209,30,43,1,2,25,31,-2,-9,-13,3,0,0,0,0,0.967741935483871,0.955555555555556,0.806451612903226,0.688888888888889,"1","orthodox"
"352",26,23,174,179,173,185,140,140,41,22,0,0,31,20,3,-5,-12,0,0,0,0,0,1,1,0.75609756097561,0.909090909090909,"1","orthodox"
"62",27,29,168,168,173,176,118,118,36,16,4,0,15,10,-2,0,-3,0,0,0,0,0,0.9,1,0.375,0.625,"1","southpaw"
"846",29,23,163,178,163,180,131,140,56,55,19,11,10,7,6,-15,-17,-9,0,0,0,0,0.746666666666667,0.833333333333333,0.133333333333333,0.106060606060606,"1","orthodox"
"913",28,20,171,168,180,168,138,134,81,14,20,6,8,5,8,3,12,4,0,0,0,0,0.801980198019802,0.7,0.0792079207920792,0.25,"1","orthodox"
"9631",27,22,177,173,185,178,160,160,17,20,1,3,14,13,5,4,7,0,0,0,0,0,0.944444444444444,0.869565217391304,0.777777777777778,0.565217391304348,"1","southpaw"
"304",37,39,178,180,175,183,135,135,1,1,5,3,1,0,-2,-2,-8,0,1,1,0,0,0.166666666666667,0.25,0.166666666666667,0,"1","orthodox"
"687",27,24,175,178,185,185,160,158,32,64,5,8,15,25,3,-3,0,2,0,0,0,0,0.864864864864865,0.888888888888889,0.405405405405405,0.347222222222222,"1","Unknown"
"211",24,23,173,178,183,180,139,140,13,6,4,0,4,3,1,-5,3,-1,0,0,0,0,0.764705882352941,1,0.235294117647059,0.5,"1","orthodox"
"6321",23,21,175,171,191,175,148,148,56,49,12,3,33,18,2,4,16,0,0,0,0,0,0.823529411764706,0.942307692307692,0.485294117647059,0.346153846153846,"1","orthodox"
"3491",21,24,173,184,180,188,158,158,32,18,4,0,4,8,-3,-11,-8,0,0,0,0,0,0.888888888888889,1,0.111111111111111,0.444444444444444,"1","orthodox"
"243",18,19,167,155,168,157,109,109,4,2,1,0,0,0,-1,12,11,0,0,0,0,0,0.8,1,0,0,"1","orthodox"
"994",34,32,191,188,196,193,244,229,49,47,0,4,33,38,2,3,3,15,0,0,1,0,1,0.92156862745098,0.673469387755102,0.745098039215686,"1","orthodox"
"761",44,24,173,178,178,183,150,149,42,23,26,1,18,16,20,-5,-5,1,1,0,0,0,0.617647058823529,0.958333333333333,0.264705882352941,0.666666666666667,"1","orthodox"
"417",22,30,188,185,193,193,198,192,24,48,0,7,20,33,-8,3,0,6,0,0,0,0,1,0.872727272727273,0.833333333333333,0.6,"1","orthodox"
"171",26,19,181,178,183,185,152,154,5,5,0,0,3,0,7,3,-2,-2,0,0,0,0,1,1,0.6,0,"1","orthodox"
"897",41,23,170,180,175,193,136,136,45,12,8,2,37,9,18,-10,-18,0,1,0,0,0,0.849056603773585,0.857142857142857,0.69811320754717,0.642857142857143,"1","orthodox"
"792",22,29,178,170,178,178,133,132,76,33,2,3,65,29,-7,8,0,1,0,0,0,0,0.974358974358974,0.916666666666667,0.833333333333333,0.805555555555556,"1","orthodox"
"86",24,22,165,168,165,184,127,126,9,13,2,0,4,9,2,-3,-19,1,0,0,0,0,0.818181818181818,1,0.363636363636364,0.692307692307692,"1","Unknown"
"10181",34,28,178,179,178,183,154,154,42,23,5,6,28,13,6,-1,-5,0,0,0,0,0,0.893617021276596,0.793103448275862,0.595744680851064,0.448275862068966,"1","orthodox"
"690",30,25,163,173,165,180,122,122,42,39,2,2,31,25,5,-10,-15,0,0,0,0,0,0.954545454545455,0.951219512195122,0.704545454545455,0.609756097560976,"1","orthodox"
"627",24,22,175,175,185,180,139,147,23,30,8,0,9,14,2,0,5,-8,0,0,0,0,0.741935483870968,1,0.290322580645161,0.466666666666667,"1","orthodox"
"1401",26,24,183,175,185,170,145,147,20,14,1,5,12,8,2,8,15,-2,0,0,0,0,0.952380952380952,0.736842105263158,0.571428571428571,0.421052631578947,"1","orthodox"
"797",40,28,188,180,206,193,252,217,55,14,13,13,45,14,12,8,13,35,1,0,1,0,0.808823529411765,0.518518518518518,0.661764705882353,0.518518518518518,"1","orthodox"
"416",28,32,187,188,184,193,207,182,62,54,10,1,13,46,-4,-1,-9,25,0,0,1,0,0.861111111111111,0.981818181818182,0.180555555555556,0.836363636363636,"1","orthodox"
"736",26,27,178,173,188,175,154,153,38,44,1,1,23,32,-1,5,13,1,0,0,0,0,0.974358974358974,0.977777777777778,0.58974358974359,0.711111111111111,"1","orthodox"
"329",28,32,187,188,184,193,207,182,62,54,10,1,13,46,-4,-1,-9,25,0,0,1,0,0.861111111111111,0.981818181818182,0.180555555555556,0.836363636363636,"1","orthodox"
"404",33,22,166,180,170,184,145,140,135,44,17,1,91,30,11,-14,-14,5,0,0,0,0,0.888157894736842,0.977777777777778,0.598684210526316,0.666666666666667,"1","orthodox"
"8241",28,36,172,166,175,178,130,130,43,32,6,4,28,14,-8,6,-3,0,0,1,0,0,0.877551020408163,0.888888888888889,0.571428571428571,0.388888888888889,"1","orthodox"
"562",29,24,170,171,174,170,135,135,96,27,14,9,28,7,5,-1,4,0,0,0,0,0,0.872727272727273,0.75,0.254545454545455,0.194444444444444,"1","Unknown"
"727",31,26,191,191,198,208,240,230,41,22,2,1,27,15,5,0,-10,10,0,0,0,0,0.953488372093023,0.956521739130435,0.627906976744186,0.652173913043478,"1","orthodox"
"230",27,36,183,179,191,188,160,160,26,40,0,3,18,29,-9,4,3,0,0,1,0,0,1,0.930232558139535,0.692307692307692,0.674418604651163,"1","orthodox"
"310",20,33,178,180,178,183,148,148,12,36,4,24,8,32,-13,-2,-5,0,0,0,0,0,0.75,0.6,0.5,0.533333333333333,"1","orthodox"
"360",35,32,183,184,194,188,208,227,19,52,0,5,16,24,3,-1,6,-19,1,0,0,1,1,0.912280701754386,0.842105263157895,0.421052631578947,"1","orthodox"
"71",30,23,179,175,170,178,130,130,28,15,4,1,14,9,7,4,-8,0,0,0,0,0,0.875,0.9375,0.4375,0.5625,"1","orthodox"
"537",18,23,164,156,168,152,108,108,14,22,1,8,11,11,-5,8,16,0,0,0,0,0,0.933333333333333,0.733333333333333,0.733333333333333,0.366666666666667,"1","orthodox"
"222",21,22,178,167,178,167,129,129,5,9,4,3,1,3,-1,11,11,0,0,0,0,0,0.555555555555556,0.75,0.111111111111111,0.25,"1","orthodox"
"987",25,26,168,178,178,178,160,160,16,36,4,4,13,31,-1,-10,0,0,0,0,0,0,0.8,0.9,0.65,0.775,"1","orthodox"
"7211",27,37,170,170,175,180,132,130,17,55,1,6,6,37,-10,0,-5,2,0,1,0,0,0.944444444444444,0.901639344262295,0.333333333333333,0.60655737704918,"1","orthodox"
"8751",32,21,185,198,196,208,198,208,13,19,13,3,9,10,11,-13,-12,-10,0,0,0,0,0.5,0.863636363636364,0.346153846153846,0.454545454545455,"1","orthodox"
"5081",19,26,179,180,182,187,167,171,41,57,8,7,6,31,-7,-1,-5,-4,0,0,0,0,0.836734693877551,0.890625,0.122448979591837,0.484375,"1","orthodox"
"55",25,30,186,190,191,208,194,196,37,19,1,1,27,10,-5,-4,-17,-2,0,0,0,0,0.973684210526316,0.95,0.710526315789474,0.5,"1","orthodox"
"502",27,22,179,182,182,187,178,177,172,81,33,9,13,28,5,-3,-5,1,0,0,0,0,0.839024390243902,0.9,0.0634146341463415,0.311111111111111,"1","orthodox"
"193",35,30,175,168,174,183,139,140,21,58,2,2,14,33,5,7,-9,-1,1,0,0,0,0.91304347826087,0.966666666666667,0.608695652173913,0.55,"1","orthodox"
"619",30,29,178,179,189,180,155,164,50,118,10,19,27,32,1,-1,9,-9,0,0,0,0,0.833333333333333,0.861313868613139,0.45,0.233576642335766,"1","orthodox"
"120",37,27,179,178,185,183,148,148,33,17,6,3,19,8,10,1,2,0,1,0,0,0,0.846153846153846,0.85,0.487179487179487,0.4,"1","orthodox"
"57",29,31,188,178,194,171,198,198,10,10,0,0,6,3,-2,10,23,0,0,0,0,0,1,1,0.6,0.3,"1","orthodox"
"255",19,22,180,183,180,186,158,155,0,2,1,1,0,1,-3,-3,-6,3,0,0,0,0,0,0.666666666666667,0,0.333333333333333,"1","orthodox"
"7641",31,19,173,176,188,183,142,142,31,20,6,0,20,14,12,-3,5,0,0,0,0,0,0.837837837837838,1,0.540540540540541,0.7,"1","orthodox"
"175",33,29,180,181,183,192,174,172,19,15,1,1,4,10,4,-1,-9,2,0,0,0,0,0.95,0.9375,0.2,0.625,"1","orthodox"
"4491",36,21,171,171,183,175,158,158,79,26,16,1,21,11,15,0,8,0,1,0,0,0,0.831578947368421,0.962962962962963,0.221052631578947,0.407407407407407,"1","orthodox"
"90",25,21,183,175,185,175,147,146,15,9,1,2,12,3,4,8,10,1,0,0,0,0,0.9375,0.818181818181818,0.75,0.272727272727273,"1","Unknown"
"2591",26,30,178,177,180,180,154,154,0,1,1,0,0,1,-4,1,0,0,0,0,0,0,0,1,0,1,"1","orthodox"
"7141",24,30,185,185,203,198,215,209,20,23,0,9,16,16,-6,0,5,6,0,0,0,0,1,0.71875,0.8,0.5,"1","orthodox"
"842",27,30,165,173,173,183,135,135,46,34,5,17,31,23,-3,-8,-10,0,0,0,0,0,0.901960784313726,0.666666666666667,0.607843137254902,0.450980392156863,"1","orthodox"
"151",20,24,168,170,169,172,121,124,0,3,1,0,0,0,-4,-2,-3,-3,0,0,0,0,0,1,0,0,"1","orthodox"
"896",26,27,178,173,188,175,153,154,38,44,1,1,23,32,-1,5,13,-1,0,0,0,0,0.974358974358974,0.977777777777778,0.58974358974359,0.711111111111111,"1","orthodox"
"1002",29,35,171,178,173,185,149,149,32,21,3,11,9,12,-6,-7,-12,0,0,1,0,0,0.914285714285714,0.65625,0.257142857142857,0.375,"1","orthodox"
"2361",20,25,162,165,163,175,127,129,7,20,1,9,7,17,-5,-3,-12,-2,0,0,0,0,0.875,0.689655172413793,0.875,0.586206896551724,"1","orthodox"
"224",26,17,168,179,162,183,129,128,1,3,2,0,1,1,9,-11,-21,1,0,0,0,0,0.333333333333333,1,0.333333333333333,0.333333333333333,"1","orthodox"
"64",27,25,164,168,168,173,115,115,46,30,3,3,35,12,2,-4,-5,0,0,0,0,0,0.938775510204082,0.909090909090909,0.714285714285714,0.363636363636364,"1","orthodox"
"339",25,31,196,189,206,198,217,246,34,29,0,1,29,22,-6,7,8,-29,0,0,0,1,1,0.966666666666667,0.852941176470588,0.733333333333333,"1","orthodox"
"5",33,39,166,170,170,170,147,143,54,54,4,6,38,39,-6,-4,0,4,0,1,0,0,0.931034482758621,0.9,0.655172413793103,0.65,"1","southpaw"
"80",30,24,187,185,191,194,175,174,31,22,0,0,21,15,6,2,-3,1,0,0,0,0,1,1,0.67741935483871,0.681818181818182,"1","orthodox"
"978",33,27,191,198,201,206,238,312,22,22,4,6,17,14,6,-7,-5,-74,0,0,0,1,0.846153846153846,0.785714285714286,0.653846153846154,0.5,"1","orthodox"
"924",19,23,166,169,170,170,122,123,26,18,1,2,15,4,-4,-3,0,-1,0,0,0,0,0.962962962962963,0.9,0.555555555555556,0.2,"1","orthodox"
"517",32,24,183,185,188,182,180,192,41,41,9,12,27,8,8,-2,6,-12,0,0,0,0,0.82,0.773584905660377,0.54,0.150943396226415,"1","orthodox"
"578",18,27,166,165,168,168,116,114,31,130,4,31,15,11,-9,1,0,2,0,0,0,0,0.885714285714286,0.807453416149068,0.428571428571429,0.0683229813664596,"1","orthodox"
"9301",33,29,170,175,180,183,135,135,29,16,4,2,23,8,4,-5,-3,0,0,0,0,0,0.878787878787879,0.888888888888889,0.696969696969697,0.444444444444444,"1","orthodox"
"2911",23,30,183,185,188,190,177,174,19,20,2,4,14,10,-7,-2,-2,3,0,0,0,0,0.904761904761905,0.833333333333333,0.666666666666667,0.416666666666667,"1","Unknown"
"337",30,34,178,189,180,198,215,222,45,32,1,3,39,23,-4,-11,-18,-7,0,0,0,0,0.978260869565217,0.914285714285714,0.847826086956522,0.657142857142857,"1","orthodox"
"257",21,26,175,178,172,178,138,140,3,1,1,0,3,0,-5,-3,-6,-2,0,0,0,0,0.75,1,0.75,0,"1","orthodox"
"1012",24,26,185,185,193,188,163,168,10,11,7,1,2,6,-2,0,5,-5,0,0,0,0,0.588235294117647,0.916666666666667,0.117647058823529,0.5,"1","orthodox"
"183",32,27,176,163,178,163,139,139,35,26,1,0,21,14,5,13,15,0,0,0,0,0,0.972222222222222,1,0.583333333333333,0.538461538461538,"1","orthodox"
"889",30,26,187,183,192,183,175,175,19,26,8,2,18,15,4,4,9,0,0,0,0,0,0.703703703703704,0.928571428571429,0.666666666666667,0.535714285714286,"1","orthodox"
"383",29,34,173,168,180,183,154,153,25,27,4,3,15,16,-5,5,-3,1,0,0,0,0,0.862068965517241,0.9,0.517241379310345,0.533333333333333,"1","southpaw"
"728",23,23,171,168,170,173,135,135,27,54,7,8,7,22,0,3,-3,0,0,0,0,0,0.794117647058823,0.870967741935484,0.205882352941176,0.354838709677419,"1","orthodox"
"8431",22,29,180,188,193,198,212,212,27,38,0,1,21,31,-7,-8,-5,0,0,0,0,0,1,0.974358974358974,0.777777777777778,0.794871794871795,"1","orthodox"
"167",35,25,170,160,178,170,137,137,12,2,7,4,7,0,10,10,8,0,1,0,0,0,0.631578947368421,0.333333333333333,0.368421052631579,0,"1","orthodox"
"861",29,25,178,184,175,178,155,149,19,15,6,9,14,10,4,-6,-3,6,0,0,0,0,0.76,0.625,0.56,0.416666666666667,"1","Unknown"
"571",20,28,187,178,184,184,168,162,40,92,8,9,6,17,-8,9,0,6,0,0,0,0,0.833333333333333,0.910891089108911,0.125,0.168316831683168,"1","orthodox"
"620",29,26,179,175,180,185,162,165,113,65,17,5,32,34,3,4,-5,-3,0,0,0,0,0.869230769230769,0.928571428571429,0.246153846153846,0.485714285714286,"1","orthodox"
"293",18,27,179,175,179,175,139,139,2,6,2,0,0,2,-9,4,4,0,0,0,0,0,0.5,1,0,0.333333333333333,"1","southpaw"
"400",26,22,171,173,183,183,130,130,33,20,2,0,25,15,4,-2,0,0,0,0,0,0,0.942857142857143,1,0.714285714285714,0.75,"1","orthodox"
"4751",30,37,183,183,185,188,182,194,71,49,5,16,39,31,-7,0,-3,-12,0,1,0,0,0.934210526315789,0.753846153846154,0.513157894736842,0.476923076923077,"1","orthodox"
"422",29,35,188,189,198,198,214,223,39,34,1,3,31,24,-6,-1,0,-9,0,1,0,0,0.975,0.918918918918919,0.775,0.648648648648649,"1","southpaw"
"834",32,24,171,178,176,178,138,137,96,13,47,2,12,9,8,-7,-2,1,0,0,0,0,0.671328671328671,0.866666666666667,0.0839160839160839,0.6,"1","orthodox"
"877",24,25,183,173,188,193,172,180,29,131,12,38,3,75,-1,10,-5,-8,0,0,0,0,0.707317073170732,0.775147928994083,0.0731707317073171,0.443786982248521,"1","Unknown"
"315",41,26,180,175,184,175,159,161,149,29,11,8,97,24,15,5,9,-2,1,0,0,0,0.93125,0.783783783783784,0.60625,0.648648648648649,"1","orthodox"
"127",26,22,173,178,175,173,135,135,19,13,2,4,13,6,4,-5,2,0,0,0,0,0,0.904761904761905,0.764705882352941,0.619047619047619,0.352941176470588,"1","orthodox"
"908",24,38,179,180,183,185,183,186,8,48,1,17,2,31,-14,-1,-2,-3,0,1,0,0,0.888888888888889,0.738461538461539,0.222222222222222,0.476923076923077,"1","orthodox"
"134",22,21,168,163,175,173,118,120,9,5,0,1,4,0,1,5,2,-2,0,0,0,0,1,0.833333333333333,0.444444444444444,0,"1","Unknown"
"625",27,27,173,179,175,185,146,147,31,41,0,6,20,36,0,-6,-10,-1,0,0,0,0,1,0.872340425531915,0.645161290322581,0.765957446808511,"1","orthodox"
"1941",20,27,168,165,183,165,118,118,16,14,0,4,6,11,-7,3,18,0,0,0,0,0,1,0.777777777777778,0.375,0.611111111111111,"1","orthodox"
"4",21,22,168,171,171,175,117,117,20,14,2,0,10,6,-1,-3,-4,0,0,0,0,0,0.909090909090909,1,0.454545454545455,0.428571428571429,"1","orthodox"
"1021",28,24,188,183,198,198,202,222,22,19,3,5,18,17,4,5,0,-20,0,0,0,1,0.88,0.791666666666667,0.72,0.708333333333333,"1","orthodox"
"800",33,28,188,191,206,208,228,239,34,25,9,3,27,18,5,-3,-2,-11,0,0,0,0,0.790697674418605,0.892857142857143,0.627906976744186,0.642857142857143,"1","orthodox"
"740",28,25,170,185,178,196,175,175,34,14,1,0,23,4,3,-15,-18,0,0,0,0,0,0.971428571428571,1,0.657142857142857,0.285714285714286,"1","orthodox"
"542",31,28,170,165,174,173,130,139,117,94,25,10,31,19,3,5,1,-9,0,0,0,0,0.823943661971831,0.903846153846154,0.21830985915493,0.182692307692308,"1","Unknown"
"840",36,25,193,191,208,208,249,227,19,21,7,1,14,14,11,2,0,22,1,0,1,0,0.730769230769231,0.954545454545455,0.538461538461538,0.636363636363636,"1","orthodox"
"530",20,30,182,175,185,183,166,163,38,86,8,25,7,40,-10,7,2,3,0,0,0,0,0.826086956521739,0.774774774774775,0.152173913043478,0.36036036036036,"1","orthodox"
"290",17,18,178,170,178,173,139,139,1,1,0,0,0,0,-1,8,5,0,0,0,0,0,1,1,0,0,"1","orthodox"
"605",38,22,178,173,188,188,198,180,112,47,22,15,69,21,16,5,0,18,1,0,1,0,0.835820895522388,0.758064516129032,0.514925373134328,0.338709677419355,"1","orthodox"
"776",41,40,192,188,198,206,237,255,46,55,9,14,31,45,1,4,-8,-18,1,1,0,1,0.836363636363636,0.797101449275362,0.563636363636364,0.652173913043478,"1","orthodox"
"954",19,24,168,165,171,174,125,125,17,24,6,4,7,7,-5,3,-3,0,0,0,0,0,0.739130434782609,0.857142857142857,0.304347826086957,0.25,"1","orthodox"
"485",30,26,177,177,180,174,153,154,41,37,2,4,30,23,4,0,6,-1,0,0,0,0,0.953488372093023,0.902439024390244,0.697674418604651,0.560975609756098,"1","orthodox"
"988",31,32,188,191,194,193,242,242,26,34,1,3,19,30,-1,-3,1,0,0,0,0,0,0.962962962962963,0.918918918918919,0.703703703703704,0.810810810810811,"1","orthodox"
"793",25,27,170,175,178,175,136,136,25,15,0,0,23,8,-2,-5,3,0,0,0,0,0,1,1,0.92,0.533333333333333,"1","southpaw"
"118",36,29,191,198,194,211,238,231,31,19,12,1,15,15,7,-7,-17,7,1,0,0,0,0.720930232558139,0.95,0.348837209302326,0.75,"1","orthodox"
"914",28,25,170,185,178,196,175,175,34,14,1,0,23,4,3,-15,-18,0,0,0,0,0,0.971428571428571,1,0.657142857142857,0.285714285714286,"1","orthodox"
"707",27,25,183,178,180,183,160,159,21,30,1,2,10,20,2,5,-3,1,0,0,0,0,0.954545454545455,0.9375,0.454545454545455,0.625,"1","orthodox"
"785",29,24,191,189,201,208,230,225,28,23,1,0,19,20,5,2,-7,5,0,0,0,0,0.96551724137931,1,0.655172413793103,0.869565217391304,"1","orthodox"
"774",27,33,170,171,174,175,160,154,43,57,6,16,32,35,-6,-1,-1,6,0,0,0,0,0.877551020408163,0.780821917808219,0.653061224489796,0.479452054794521,"1","orthodox"
"638",26,26,182,182,188,197,176,168,20,35,3,4,16,27,0,0,-9,8,0,0,0,0,0.869565217391304,0.897435897435897,0.695652173913043,0.692307692307692,"1","orthodox"
"6111",27,25,168,166,174,168,138,147,77,65,13,11,40,38,2,2,6,-9,0,0,0,0,0.855555555555556,0.855263157894737,0.444444444444444,0.5,"1","orthodox"
"521",39,28,160,170,165,180,118,118,60,17,3,2,41,10,11,-10,-15,0,1,0,0,0,0.952380952380952,0.894736842105263,0.650793650793651,0.526315789473684,"1","orthodox"
"1891",23,24,168,168,168,183,122,122,15,16,0,0,9,7,-1,0,-15,0,0,0,0,0,1,1,0.6,0.4375,"1","orthodox"
"577",31,21,179,175,180,185,146,146,106,43,27,9,28,19,10,4,-5,0,0,0,0,0,0.796992481203007,0.826923076923077,0.210526315789474,0.365384615384615,"1","orthodox"
"668",25,23,173,178,180,184,158,157,105,66,12,1,25,13,2,-5,-4,1,0,0,0,0,0.897435897435897,0.985074626865672,0.213675213675214,0.194029850746269,"1","Unknown"
"459",29,33,163,165,168,165,108,107,14,48,1,0,6,36,-4,-2,3,1,0,0,0,0,0.933333333333333,1,0.4,0.75,"1","orthodox"
"555",30,26,170,189,180,193,173,174,19,22,1,0,12,16,4,-19,-13,-1,0,0,0,0,0.95,1,0.6,0.727272727272727,"1","orthodox"
"8061",30,24,175,178,191,183,157,153,111,114,25,2,61,52,6,-3,8,4,0,0,0,0,0.816176470588235,0.982758620689655,0.448529411764706,0.448275862068966,"1","orthodox"
"1301",32,30,178,180,183,188,174,171,39,39,5,1,24,33,2,-2,-5,3,0,0,0,0,0.886363636363636,0.975,0.545454545454545,0.825,"1","southpaw"
"232",30,26,188,182,190,180,256,256,23,15,10,0,16,12,4,6,10,0,0,0,0,0,0.696969696969697,1,0.484848484848485,0.8,"1","southpaw"
"405",45,20,180,191,191,198,191,204,185,15,22,0,131,12,25,-11,-7,-13,1,0,0,0,0.893719806763285,1,0.632850241545894,0.8,"1","orthodox"
"443",24,23,165,168,173,173,124,126,13,43,0,1,10,31,1,-3,0,-2,0,0,0,0,1,0.977272727272727,0.769230769230769,0.704545454545455,"1","orthodox"
"784",26,30,189,191,208,201,234,236,31,17,1,2,26,12,-4,-2,7,-2,0,0,0,0,0.96875,0.894736842105263,0.8125,0.631578947368421,"1","orthodox"
"438",27,26,176,179,183,185,147,147,48,30,2,0,28,24,1,-3,-2,0,0,0,0,0,0.96,1,0.56,0.8,"1","orthodox"
"7911",22,31,191,193,208,208,222,231,21,13,0,1,21,11,-9,-2,0,-9,0,0,0,0,1,0.928571428571429,1,0.785714285714286,"1","orthodox"
"802",38,41,177,188,179,203,198,195,51,42,3,14,28,29,-3,-11,-24,3,1,1,0,0,0.944444444444444,0.75,0.518518518518518,0.517857142857143,"1","orthodox"
"303",22,23,186,180,186,175,173,175,1,9,1,1,0,7,-1,6,11,-2,0,0,0,0,0.5,0.9,0,0.7,"1","orthodox"
"58",28,27,174,170,178,183,129,130,23,23,2,7,16,16,1,4,-5,-1,0,0,0,0,0.92,0.766666666666667,0.64,0.533333333333333,"1","orthodox"
"296",32,28,188,188,196,188,251,289,8,4,4,1,6,4,4,0,8,-38,0,0,0,1,0.666666666666667,0.8,0.5,0.8,"1","southpaw"
"10131",23,22,185,172,188,178,155,155,1,2,0,1,0,1,1,13,10,0,0,0,0,0,1,0.666666666666667,0,0.333333333333333,"1","southpaw"
"1014",28,38,178,170,188,178,135,135,26,46,3,3,15,40,-10,8,10,0,0,1,0,0,0.896551724137931,0.938775510204082,0.517241379310345,0.816326530612245,"1","orthodox"
"150",25,23,175,178,175,185,147,147,30,16,4,3,21,15,2,-3,-10,0,0,0,0,0,0.882352941176471,0.842105263157895,0.617647058823529,0.789473684210526,"1","southpaw"
"477",24,20,175,183,191,185,160,151,52,23,6,2,32,11,4,-8,6,9,0,0,0,0,0.896551724137931,0.92,0.551724137931034,0.44,"1","orthodox"
"1841",34,30,170,170,180,170,132,134,29,14,5,0,23,8,4,0,10,-2,0,0,0,0,0.852941176470588,1,0.676470588235294,0.571428571428571,"1","orthodox"
"7891",35,29,190,191,201,183,248,233,34,19,4,3,19,18,6,-1,18,15,1,0,1,0,0.894736842105263,0.863636363636364,0.5,0.818181818181818,"1","orthodox"
"910",30,38,187,191,203,193,218,225,25,36,6,5,17,25,-8,-4,10,-7,0,1,0,0,0.806451612903226,0.878048780487805,0.548387096774194,0.609756097560976,"1","orthodox"
"527",27,21,182,188,185,191,189,200,94,28,15,9,12,8,6,-6,-6,-11,0,0,0,0,0.862385321100917,0.756756756756757,0.110091743119266,0.216216216216216,"1","orthodox"
"313",26,22,171,173,183,183,130,130,33,20,2,0,25,15,4,-2,0,0,0,0,0,0,0.942857142857143,1,0.714285714285714,0.75,"1","orthodox"
"1004",32,26,177,178,183,191,160,174,22,16,20,1,12,13,6,-1,-8,-14,0,0,0,0,0.523809523809524,0.941176470588235,0.285714285714286,0.764705882352941,"1","Unknown"
"589",24,26,171,171,175,175,130,129,33,18,3,4,32,14,-2,0,0,1,0,0,0,0,0.916666666666667,0.818181818181818,0.888888888888889,0.636363636363636,"1","orthodox"
"879",21,32,175,179,185,187,186,165,2,38,6,20,1,14,-11,-4,-2,21,0,0,1,0,0.25,0.655172413793103,0.125,0.241379310344828,"1","Unknown"
"512",20,22,171,163,175,165,129,130,123,32,13,12,40,14,-2,8,10,-1,0,0,0,0,0.904411764705882,0.727272727272727,0.294117647058824,0.318181818181818,"1","Unknown"
"354",29,22,170,179,170,185,135,134,36,16,3,0,26,15,7,-9,-15,1,0,0,0,0,0.923076923076923,1,0.666666666666667,0.9375,"1","orthodox"
"242",25,25,163,158,168,160,114,115,2,7,1,1,1,0,0,5,8,-1,0,0,0,0,0.666666666666667,0.875,0.333333333333333,0,"1","southpaw"
"636",34,28,188,185,196,183,190,190,30,37,4,1,26,24,6,3,13,0,0,0,0,0,0.882352941176471,0.973684210526316,0.764705882352941,0.631578947368421,"1","orthodox"
"425",34,32,185,189,196,198,209,224,23,30,2,2,16,22,2,-4,-2,-15,0,0,0,1,0.92,0.9375,0.64,0.6875,"1","orthodox"
"455",29,30,170,170,175,173,126,126,22,24,0,1,15,17,-1,0,2,0,0,0,0,0,1,0.96,0.681818181818182,0.68,"1","orthodox"
"27",26,27,170,179,173,180,135,135,18,20,0,1,10,16,-1,-9,-7,0,0,0,0,0,1,0.952380952380952,0.555555555555556,0.761904761904762,"1","orthodox"
"264",26,19,168,170,162,171,137,126,1,1,1,2,1,0,7,-2,-9,11,0,0,0,0,0.5,0.333333333333333,0.5,0,"1","orthodox"
"4921",34,25,173,173,178,178,146,158,180,78,38,10,28,36,9,0,0,-12,0,0,0,0,0.825688073394495,0.886363636363636,0.128440366972477,0.409090909090909,"1","orthodox"
"2671",30,33,191,191,198,201,228,239,17,36,0,6,9,29,-3,0,-3,-11,0,0,0,0,1,0.857142857142857,0.529411764705882,0.69047619047619,"1","orthodox"
"9801",33,28,191,191,199,201,228,230,41,10,6,2,39,6,5,0,-2,-2,0,0,0,0,0.872340425531915,0.833333333333333,0.829787234042553,0.5,"1","orthodox"
"462",30,33,185,182,185,182,167,184,10,53,0,7,4,46,-3,3,3,-17,0,0,0,1,1,0.883333333333333,0.4,0.766666666666667,"1","orthodox"
"626",26,26,171,156,180,163,127,128,71,124,17,21,7,49,0,15,17,-1,0,0,0,0,0.806818181818182,0.855172413793103,0.0795454545454545,0.337931034482759,"1","orthodox"
"507",20,26,179,187,182,193,168,172,55,54,10,12,7,21,-6,-8,-11,-4,0,0,0,0,0.846153846153846,0.818181818181818,0.107692307692308,0.318181818181818,"1","orthodox"
"8621",28,24,178,184,175,178,159,158,16,14,3,6,11,10,4,-6,-3,1,0,0,0,0,0.842105263157895,0.7,0.578947368421053,0.5,"1","Unknown"
"6891",38,26,174,175,183,185,160,168,25,24,10,4,20,12,12,-1,-2,-8,1,0,0,0,0.714285714285714,0.857142857142857,0.571428571428571,0.428571428571429,"1","southpaw"
"154",21,30,178,170,188,180,150,149,11,9,1,4,7,6,-9,8,8,1,0,0,0,0,0.916666666666667,0.692307692307692,0.583333333333333,0.461538461538462,"1","orthodox"
"1031",35,27,170,171,180,179,135,135,29,20,6,3,23,15,8,-1,1,0,1,0,0,0,0.828571428571429,0.869565217391304,0.657142857142857,0.652173913043478,"1","orthodox"
"648",24,27,166,170,165,178,139,135,40,117,12,22,16,63,-3,-4,-13,4,0,0,0,0,0.769230769230769,0.841726618705036,0.307692307692308,0.453237410071942,"1","Unknown"
"821",28,32,173,175,183,180,154,155,26,59,10,16,18,24,-4,-2,3,-1,0,0,0,0,0.722222222222222,0.786666666666667,0.5,0.32,"1","orthodox"
"145",28,22,165,160,165,171,115,115,20,17,0,2,16,12,6,5,-6,0,0,0,0,0,1,0.894736842105263,0.8,0.631578947368421,"1","orthodox"
"186",23,22,175,183,189,191,157,155,13,9,0,1,10,7,1,-8,-2,2,0,0,0,0,1,0.9,0.769230769230769,0.7,"1","orthodox"
"15",30,29,188,183,195,191,198,199,38,24,2,0,26,15,1,5,4,-1,0,0,0,0,0.95,1,0.65,0.625,"1","orthodox"
"825",33,30,175,185,180,191,163,163,35,9,1,6,19,8,3,-10,-11,0,0,0,0,0,0.972222222222222,0.6,0.527777777777778,0.533333333333333,"1","southpaw"
"334",24,35,180,189,193,198,217,231,31,35,1,3,25,25,-11,-9,-5,-14,0,1,0,0,0.96875,0.921052631578947,0.78125,0.657894736842105,"1","orthodox"
"948",29,24,166,163,168,157,129,127,59,25,9,1,58,17,5,3,11,2,0,0,0,0,0.867647058823529,0.961538461538462,0.852941176470588,0.653846153846154,"1","orthodox"
"905",22,21,165,166,165,170,119,119,13,10,1,0,11,10,1,-1,-5,0,0,0,0,0,0.928571428571429,1,0.785714285714286,1,"1","orthodox"
"279",21,27,170,165,170,175,130,130,16,29,2,8,11,17,-6,5,-5,0,0,0,0,0,0.888888888888889,0.783783783783784,0.611111111111111,0.459459459459459,"1","orthodox"
"25",27,25,165,168,169,174,130,129,34,27,1,0,18,20,2,-3,-5,1,0,0,0,0,0.971428571428571,1,0.514285714285714,0.740740740740741,"1","orthodox"
"168",26,19,181,178,183,185,152,154,5,5,0,0,3,0,7,3,-2,-2,0,0,0,0,1,1,0.6,0,"1","orthodox"
"1039",30,23,191,189,196,188,203,225,73,30,11,13,61,17,7,2,8,-22,0,0,0,1,0.869047619047619,0.697674418604651,0.726190476190476,0.395348837209302,"1","orthodox"
"732",25,25,165,163,174,163,130,125,26,41,5,4,7,14,0,2,11,5,0,0,0,0,0.838709677419355,0.911111111111111,0.225806451612903,0.311111111111111,"1","orthodox"
"399",33,28,171,173,178,183,139,140,39,33,6,0,30,22,5,-2,-5,-1,0,0,0,0,0.866666666666667,1,0.666666666666667,0.666666666666667,"1","orthodox"
"159",27,29,170,168,168,175,122,121,27,14,2,6,9,9,-2,2,-7,1,0,0,0,0,0.931034482758621,0.7,0.310344827586207,0.45,"1","orthodox"
"389",21,28,183,178,185,189,168,165,30,38,3,7,15,23,-7,5,-4,3,0,0,0,0,0.909090909090909,0.844444444444444,0.454545454545455,0.511111111111111,"1","orthodox"
"756",26,31,171,183,175,188,160,159,25,33,5,1,13,25,-5,-12,-13,1,0,0,0,0,0.833333333333333,0.970588235294118,0.433333333333333,0.735294117647059,"1","orthodox"
"604",17,27,180,174,185,173,147,147,8,13,1,0,4,6,-10,6,12,0,0,0,0,0,0.888888888888889,1,0.444444444444444,0.461538461538462,"1","orthodox"
"883",32,27,187,185,190,180,154,154,29,39,2,7,16,23,5,2,10,0,0,0,0,0,0.935483870967742,0.847826086956522,0.516129032258065,0.5,"1","Unknown"
"406",21,28,180,177,191,180,160,164,23,112,1,26,18,71,-7,3,11,-4,0,0,0,0,0.958333333333333,0.811594202898551,0.75,0.514492753623188,"1","orthodox"
"609",30,24,178,171,180,180,136,144,130,53,36,6,68,28,6,7,0,-8,0,0,0,0,0.783132530120482,0.898305084745763,0.409638554216867,0.474576271186441,"1","orthodox"
"432",34,25,171,188,188,193,198,203,130,40,19,6,75,22,9,-17,-5,-5,0,0,0,0,0.87248322147651,0.869565217391304,0.503355704697987,0.478260869565217,"1","orthodox"
"730",31,26,199,188,211,183,180,230,14,39,2,9,11,30,5,11,28,-50,0,0,0,1,0.875,0.8125,0.6875,0.625,"1","orthodox"
"873",24,22,175,187,183,222,216,185,49,46,17,13,32,15,2,-12,-39,31,0,0,1,0,0.742424242424242,0.779661016949153,0.484848484848485,0.254237288135593,"1","orthodox"
"646",23,21,163,157,166,159,130,131,73,46,17,12,7,11,2,6,7,-1,0,0,0,0,0.811111111111111,0.793103448275862,0.0777777777777778,0.189655172413793,"1","orthodox"
"368",27,32,184,185,196,198,174,173,30,49,0,3,18,40,-5,-1,-2,1,0,0,0,0,1,0.942307692307692,0.6,0.769230769230769,"1","orthodox"
"7441",22,28,183,185,183,193,195,197,26,25,1,5,15,12,-6,-2,-10,-2,0,0,0,0,0.962962962962963,0.833333333333333,0.555555555555556,0.4,"1","orthodox"
"436",21,24,173,184,180,188,158,158,32,18,4,0,4,8,-3,-11,-8,0,0,0,0,0,0.888888888888889,1,0.111111111111111,0.444444444444444,"1","orthodox"
"859",32,28,187,193,192,203,190,189,22,21,9,1,21,11,4,-6,-11,1,0,0,0,0,0.709677419354839,0.954545454545455,0.67741935483871,0.5,"1","orthodox"
"613",32,35,200,195,201,210,239,254,22,33,0,3,13,20,-3,5,-9,-15,0,1,0,1,1,0.916666666666667,0.590909090909091,0.555555555555556,"1","orthodox"
"323",40,26,185,180,191,189,160,160,46,23,2,0,32,17,14,5,2,0,1,0,0,0,0.958333333333333,1,0.666666666666667,0.739130434782609,"1","orthodox"
"1022",28,28,168,169,173,173,134,135,34,28,1,1,19,20,0,-1,0,-1,0,0,0,0,0.971428571428571,0.96551724137931,0.542857142857143,0.689655172413793,"1","Unknown"
"826",27,22,169,163,177,173,123,116,71,75,18,1,54,26,5,6,4,7,0,0,0,0,0.797752808988764,0.986842105263158,0.606741573033708,0.342105263157895,"1","orthodox"
"348",25,29,173,184,180,188,165,166,154,49,9,0,26,10,-4,-11,-8,-1,0,0,0,0,0.94478527607362,1,0.159509202453988,0.204081632653061,"1","orthodox"
"701",26,28,179,173,191,188,174,172,52,101,11,23,25,42,-2,6,3,2,0,0,0,0,0.825396825396825,0.814516129032258,0.396825396825397,0.338709677419355,"1","Unknown"
"700",27,23,157,168,168,170,115,115,19,12,9,0,8,7,4,-11,-2,0,0,0,0,0,0.678571428571429,1,0.285714285714286,0.583333333333333,"1","orthodox"
"503",26,19,179,180,182,192,180,179,164,28,29,3,12,17,7,-1,-10,1,0,0,0,0,0.849740932642487,0.903225806451613,0.0621761658031088,0.548387096774194,"1","orthodox"
"829",26,30,177,177,180,185,159,160,22,21,0,3,15,17,-4,0,-5,-1,0,0,0,0,1,0.875,0.681818181818182,0.708333333333333,"1","southpaw"
"141",37,23,171,170,175,178,147,147,62,26,10,3,53,17,14,1,-3,0,1,0,0,0,0.861111111111111,0.896551724137931,0.736111111111111,0.586206896551724,"1","orthodox"
"501",25,31,188,179,191,182,190,202,16,221,0,44,9,18,-6,9,9,-12,0,0,0,0,1,0.833962264150943,0.5625,0.0679245283018868,"1","orthodox"
"4701",22,25,168,170,170,178,141,138,47,108,6,19,18,58,-3,-2,-8,3,0,0,0,0,0.886792452830189,0.850393700787402,0.339622641509434,0.456692913385827,"1","orthodox"
"119",36,21,162,163,163,163,108,108,13,8,6,0,7,5,15,-1,0,0,1,0,0,0,0.684210526315789,1,0.368421052631579,0.625,"1","southpaw"
"111",33,23,170,171,168,165,142,143,18,17,1,2,11,12,10,-1,3,-1,0,0,0,0,0.947368421052632,0.894736842105263,0.578947368421053,0.631578947368421,"1","orthodox"
"376",19,26,165,165,175,173,130,128,46,72,16,7,16,15,-7,0,2,2,0,0,0,0,0.741935483870968,0.911392405063291,0.258064516129032,0.189873417721519,"1","orthodox"
"997",35,27,183,196,185,208,214,230,22,9,10,0,16,7,8,-13,-23,-16,1,0,0,1,0.6875,1,0.5,0.777777777777778,"1","orthodox"
"934",28,23,170,169,178,170,122,123,28,19,1,2,20,5,5,1,8,-1,0,0,0,0,0.96551724137931,0.904761904761905,0.689655172413793,0.238095238095238,"1","orthodox"
"177",21,23,171,170,182,178,136,136,13,6,0,0,12,4,-2,1,4,0,0,0,0,0,1,1,0.923076923076923,0.666666666666667,"1","orthodox"
"3841",20,24,168,170,170,170,135,135,36,107,4,6,12,22,-4,-2,0,0,0,0,0,0,0.9,0.946902654867257,0.3,0.194690265486726,"1","orthodox"
"351",27,26,176,179,183,185,147,147,48,30,2,0,28,24,1,-3,-2,0,0,0,0,0,0.96,1,0.56,0.8,"1","orthodox"
"454",41,39,185,187,198,192,191,188,59,27,4,14,46,25,2,-2,6,3,1,1,0,0,0.936507936507937,0.658536585365854,0.73015873015873,0.609756097560976,"1","orthodox"
"585",28,23,168,168,173,171,134,131,61,51,12,24,24,22,5,0,2,3,0,0,0,0,0.835616438356164,0.68,0.328767123287671,0.293333333333333,"1","orthodox"
"669",21,22,173,170,180,170,150,152,57,37,4,7,14,20,-1,3,10,-2,0,0,0,0,0.934426229508197,0.840909090909091,0.229508196721311,0.454545454545455,"1","Unknown"
"426",25,31,196,189,206,198,217,246,34,29,0,1,29,22,-6,7,8,-29,0,0,0,1,1,0.966666666666667,0.852941176470588,0.733333333333333,"1","orthodox"
"353",29,22,180,179,183,185,135,133,32,18,0,0,16,16,7,1,-2,2,0,0,0,0,1,1,0.5,0.888888888888889,"1","orthodox"
"108",32,26,193,191,208,213,223,227,11,9,7,0,5,4,6,2,-5,-4,0,0,0,0,0.611111111111111,1,0.277777777777778,0.444444444444444,"1","orthodox"
"822",37,26,187,185,188,193,190,190,31,15,10,0,20,12,11,2,-5,0,1,0,0,0,0.75609756097561,1,0.48780487804878,0.8,"1","orthodox"
"6451",24,23,160,157,168,159,126,125,101,56,16,12,29,13,1,3,9,1,0,0,0,0,0.863247863247863,0.823529411764706,0.247863247863248,0.191176470588235,"1","southpaw"
"31",29,26,163,165,168,168,108,108,26,20,2,4,15,14,3,-2,0,0,0,0,0,0,0.928571428571429,0.833333333333333,0.535714285714286,0.583333333333333,"1","orthodox"
"16",30,24,163,168,165,169,115,114,17,24,0,1,8,16,6,-5,-4,1,0,0,0,0,1,0.96,0.470588235294118,0.64,"1","southpaw"
"7181",27,29,164,170,166,170,137,136,74,79,19,33,34,20,-2,-6,-4,1,0,0,0,0,0.795698924731183,0.705357142857143,0.365591397849462,0.178571428571429,"1","Unknown"
"743",21,32,178,171,178,180,135,133,73,37,1,7,65,26,-11,7,-2,2,0,0,0,0,0.986486486486487,0.840909090909091,0.878378378378378,0.590909090909091,"1","orthodox"
"9001",33,27,170,171,170,175,134,132,48,18,4,12,44,9,6,-1,-5,2,0,0,0,0,0.923076923076923,0.6,0.846153846153846,0.3,"1","orthodox"
"1491",32,37,174,170,178,178,138,141,23,38,1,19,12,22,-5,4,0,-3,0,1,0,0,0.958333333333333,0.666666666666667,0.5,0.385964912280702,"1","southpaw"
"488",30,22,170,168,173,178,121,122,28,39,1,0,17,27,8,2,-5,-1,0,0,0,0,0.96551724137931,1,0.586206896551724,0.692307692307692,"1","orthodox"
"1562",22,25,174,175,180,180,134,134,10,12,1,1,7,6,-3,-1,0,0,0,0,0,0,0.909090909090909,0.923076923076923,0.636363636363636,0.461538461538462,"1","Unknown"
"719",22,24,170,174,180,173,135,135,18,37,0,0,13,29,-2,-4,7,0,0,0,0,0,1,1,0.722222222222222,0.783783783783784,"1","orthodox"
"85",23,32,163,168,170,168,123,122,12,35,0,29,7,18,-9,-5,2,1,0,0,0,0,1,0.546875,0.583333333333333,0.28125,"1","orthodox"
"122",27,34,173,180,183,188,148,148,20,34,2,5,15,28,-7,-7,-5,0,0,0,0,0,0.909090909090909,0.871794871794872,0.681818181818182,0.717948717948718,"1","orthodox"
"414",30,32,182,191,185,198,212,209,30,43,1,2,25,31,-2,-9,-13,3,0,0,0,0,0.967741935483871,0.955555555555556,0.806451612903226,0.688888888888889,"1","orthodox"
"331",27,32,171,171,168,169,140,140,32,90,3,1,18,75,-5,0,-1,0,0,0,0,0,0.914285714285714,0.989010989010989,0.514285714285714,0.824175824175824,"1","orthodox"
"691",23,27,173,163,180,160,125,127,33,18,1,18,22,11,-4,10,20,-2,0,0,0,0,0.970588235294118,0.5,0.647058823529412,0.305555555555556,"1","orthodox"
"330",22,30,188,185,193,193,198,192,24,48,0,7,20,33,-8,3,0,6,0,0,0,0,1,0.872727272727273,0.833333333333333,0.6,"1","orthodox"
"539",30,23,163,160,168,163,118,116,47,42,1,3,37,17,7,3,5,2,0,0,0,0,0.979166666666667,0.933333333333333,0.770833333333333,0.377777777777778,"1","orthodox"
"693",27,25,170,171,175,178,130,130,44,28,3,1,23,23,2,-1,-3,0,0,0,0,0,0.936170212765957,0.96551724137931,0.48936170212766,0.793103448275862,"1","orthodox"
"617",28,27,177,169,180,178,147,145,34,54,1,2,26,43,1,8,2,2,0,0,0,0,0.971428571428571,0.964285714285714,0.742857142857143,0.767857142857143,"1","orthodox"
"796",41,35,188,201,206,208,256,243,56,29,14,5,46,27,6,-13,-2,13,1,1,0,0,0.8,0.852941176470588,0.657142857142857,0.794117647058823,"1","orthodox"
"9721",28,28,193,193,203,201,238,216,24,27,1,0,18,24,0,0,2,22,0,0,1,0,0.96,1,0.72,0.888888888888889,"1","orthodox"
"602",26,25,165,165,175,165,105,105,27,20,1,0,18,14,1,0,10,0,0,0,0,0,0.964285714285714,1,0.642857142857143,0.7,"1","southpaw"
"1041",23,30,157,170,168,178,111,111,17,13,4,3,7,8,-7,-13,-10,0,0,0,0,0,0.80952380952381,0.8125,0.333333333333333,0.5,"1","orthodox"
"2541",23,31,183,179,186,180,158,159,6,5,1,4,3,4,-8,4,6,-1,0,0,0,0,0.857142857142857,0.555555555555556,0.428571428571429,0.444444444444444,"1","orthodox"
"866",22,27,159,165,157,173,112,112,15,36,6,3,8,22,-5,-6,-16,0,0,0,0,0,0.714285714285714,0.923076923076923,0.380952380952381,0.564102564102564,"1","orthodox"
"608",22,25,168,171,174,180,135,134,58,57,8,8,33,30,-3,-3,-6,1,0,0,0,0,0.878787878787879,0.876923076923077,0.5,0.461538461538462,"1","orthodox"
"465",37,35,170,170,175,170,135,135,36,48,3,4,22,35,2,0,5,0,1,1,0,0,0.923076923076923,0.923076923076923,0.564102564102564,0.673076923076923,"1","southpaw"
"363",31,34,183,183,188,191,167,168,23,28,1,3,14,18,-3,0,-3,-1,0,0,0,0,0.958333333333333,0.903225806451613,0.583333333333333,0.580645161290323,"1","southpaw"
"95",22,22,164,158,169,164,107,107,12,9,0,0,7,9,0,6,5,0,0,0,0,0,1,1,0.583333333333333,1,"1","orthodox"
"923",37,32,170,173,183,178,143,142,33,30,17,8,14,21,5,-3,5,1,1,0,0,0,0.66,0.789473684210526,0.28,0.552631578947368,"1","orthodox"
"986",22,27,182,180,183,185,170,175,14,10,3,0,8,8,-5,2,-2,-5,0,0,0,0,0.823529411764706,1,0.470588235294118,0.8,"1","orthodox"
"226",26,27,160,157,163,163,115,115,23,18,4,5,16,11,-1,3,0,0,0,0,0,0,0.851851851851852,0.782608695652174,0.592592592592593,0.478260869565217,"1","orthodox"
"1030",26,30,170,178,173,175,152,156,35,21,6,7,15,15,-4,-8,-2,-4,0,0,0,0,0.853658536585366,0.75,0.365853658536585,0.535714285714286,"1","Unknown"
"643",36,35,171,183,180,185,153,154,37,37,2,2,31,28,1,-12,-5,-1,1,1,0,0,0.948717948717949,0.948717948717949,0.794871794871795,0.717948717948718,"1","orthodox"
"429",25,27,191,189,199,198,212,213,24,22,0,0,24,18,-2,2,1,-1,0,0,0,0,1,1,1,0.818181818181818,"1","orthodox"
"386",34,24,183,188,185,203,191,192,89,23,14,3,49,11,10,-5,-18,-1,0,0,0,0,0.864077669902913,0.884615384615385,0.475728155339806,0.423076923076923,"1","orthodox"
"202",40,23,191,192,201,195,229,243,36,14,6,2,27,9,17,-1,6,-14,1,0,0,0,0.857142857142857,0.875,0.642857142857143,0.5625,"1","orthodox"
"11",42,25,168,183,183,187,153,153,34,21,5,0,19,16,17,-15,-4,0,1,0,0,0,0.871794871794872,1,0.487179487179487,0.761904761904762,"1","orthodox"
"392",24,26,183,184,180,183,182,196,35,21,1,0,26,13,-2,-1,-3,-14,0,0,0,0,0.972222222222222,1,0.722222222222222,0.619047619047619,"1","orthodox"
"7941",21,22,182,182,187,187,166,172,68,56,4,11,23,35,-1,0,0,-6,0,0,0,0,0.944444444444444,0.835820895522388,0.319444444444444,0.522388059701492,"1","Unknown"
"977",34,35,196,191,208,201,240,226,21,28,0,5,12,23,-1,5,7,14,0,1,0,0,1,0.848484848484849,0.571428571428571,0.696969696969697,"1","orthodox"
"311",35,29,170,173,173,183,146,147,43,36,9,0,13,24,6,-3,-10,-1,1,0,0,0,0.826923076923077,1,0.25,0.666666666666667,"1","orthodox"
"762",36,27,173,180,188,183,152,149,38,23,19,2,24,14,9,-7,5,3,1,0,0,0,0.666666666666667,0.92,0.421052631578947,0.56,"1","orthodox"
"551",36,28,185,183,185,194,210,183,11,17,3,0,5,14,8,2,-9,27,1,0,1,0,0.785714285714286,1,0.357142857142857,0.823529411764706,"1","orthodox"
"640",29,30,168,163,160,165,118,118,33,47,1,7,16,35,-1,5,-5,0,0,0,0,0,0.970588235294118,0.87037037037037,0.470588235294118,0.648148148148148,"1","Unknown"
"918",32,27,169,179,170,188,147,147,65,44,7,3,46,27,5,-10,-18,0,0,0,0,0,0.902777777777778,0.936170212765957,0.638888888888889,0.574468085106383,"1","Unknown"
"763",25,28,160,163,152,165,115,115,37,14,4,0,26,7,-3,-3,-13,0,0,0,0,0,0.902439024390244,1,0.634146341463415,0.5,"1","southpaw"
"18",25,27,174,175,180,183,140,139,26,29,1,1,18,15,-2,-1,-3,1,0,0,0,0,0.962962962962963,0.966666666666667,0.666666666666667,0.5,"1","orthodox"
"165",29,27,171,170,173,183,141,142,42,20,6,7,23,4,2,1,-10,-1,0,0,0,0,0.875,0.740740740740741,0.479166666666667,0.148148148148148,"1","orthodox"
"5151",25,29,191,182,201,188,176,180,11,45,1,2,7,23,-4,9,13,-4,0,0,0,0,0.916666666666667,0.957446808510638,0.583333333333333,0.48936170212766,"1","orthodox"
"115",32,28,163,166,169,166,122,122,46,32,3,2,36,19,4,-3,3,0,0,0,0,0,0.938775510204082,0.941176470588235,0.73469387755102,0.558823529411765,"1","orthodox"
"116",38,23,166,165,178,168,127,130,34,15,6,0,15,9,15,1,10,-3,1,0,0,0,0.85,1,0.375,0.6,"1","orthodox"
"538",16,20,164,160,168,164,109,107,4,4,0,0,4,1,-4,4,4,2,0,0,0,0,1,1,1,0.25,"1","orthodox"
"89",36,26,191,187,201,188,244,273,41,12,8,0,31,7,10,4,13,-29,1,0,0,1,0.836734693877551,1,0.63265306122449,0.583333333333333,"1","orthodox"
"979",42,29,185,191,196,201,233,216,11,14,29,2,4,10,13,-6,-5,17,1,0,1,0,0.275,0.875,0.1,0.625,"1","orthodox"
"990",31,29,185,180,198,185,167,165,36,24,7,4,26,23,2,5,13,2,0,0,0,0,0.837209302325581,0.857142857142857,0.604651162790698,0.821428571428571,"1","orthodox"
"357",35,25,171,171,183,178,147,145,81,42,6,3,54,34,10,0,5,2,1,0,0,0,0.931034482758621,0.933333333333333,0.620689655172414,0.755555555555556,"1","orthodox"
"205",24,22,178,178,183,183,159,159,29,26,1,0,19,19,2,0,0,0,0,0,0,0,0.966666666666667,1,0.633333333333333,0.730769230769231,"1","southpaw"
"274",19,28,168,168,173,168,130,130,8,7,0,6,8,1,-9,0,5,0,0,0,0,0,1,0.538461538461538,1,0.0769230769230769,"1","orthodox"
"494",27,24,173,179,178,182,135,134,79,39,17,2,18,12,3,-6,-4,1,0,0,0,0,0.822916666666667,0.951219512195122,0.1875,0.292682926829268,"1","orthodox"
"463",19,26,165,165,175,173,130,128,46,72,16,7,16,15,-7,0,2,2,0,0,0,0,0.741935483870968,0.911392405063291,0.258064516129032,0.189873417721519,"1","orthodox"
"181",20,25,173,165,173,171,129,130,6,3,1,3,4,3,-5,8,2,-1,0,0,0,0,0.857142857142857,0.5,0.571428571428571,0.5,"1","orthodox"
"771",35,30,171,170,178,170,140,140,39,20,3,1,28,15,5,1,8,0,1,0,0,0,0.928571428571429,0.952380952380952,0.666666666666667,0.714285714285714,"1","orthodox"
"483",36,29,190,189,206,193,223,205,48,28,1,0,34,19,7,1,13,18,1,0,1,0,0.979591836734694,1,0.693877551020408,0.678571428571429,"1","orthodox"
"827",26,21,169,163,177,173,121,116,66,64,15,1,52,24,5,6,4,5,0,0,0,0,0.814814814814815,0.984615384615385,0.641975308641975,0.369230769230769,"1","orthodox"
"28",26,29,179,179,180,170,134,133,18,26,0,4,14,14,-3,0,10,1,0,0,0,0,1,0.866666666666667,0.777777777777778,0.466666666666667,"1","orthodox"
"854",22,26,169,179,165,180,140,140,97,77,12,12,53,20,-4,-10,-15,0,0,0,0,0,0.889908256880734,0.865168539325843,0.486238532110092,0.224719101123595,"1","orthodox"
"196",35,35,166,168,165,174,133,133,26,23,1,12,17,13,0,-2,-9,0,1,1,0,0,0.962962962962963,0.657142857142857,0.62962962962963,0.371428571428571,"1","orthodox"
"484",22,24,180,173,185,180,156,163,30,97,11,18,8,11,-2,7,5,-7,0,0,0,0,0.731707317073171,0.843478260869565,0.195121951219512,0.0956521739130435,"1","Unknown"
"895",25,29,175,173,183,175,154,153,35,55,1,2,22,38,-4,2,8,1,0,0,0,0,0.972222222222222,0.964912280701754,0.611111111111111,0.666666666666667,"1","southpaw"
"816",33,27,177,175,183,175,156,155,22,19,22,5,12,12,6,2,8,1,0,0,0,0,0.5,0.791666666666667,0.272727272727273,0.5,"1","Unknown"
"634",28,23,165,175,165,180,126,126,35,19,1,1,10,12,5,-10,-15,0,0,0,0,0,0.972222222222222,0.95,0.277777777777778,0.6,"1","orthodox"
"694",32,24,166,171,171,178,130,130,57,26,4,1,40,22,8,-5,-7,0,0,0,0,0,0.934426229508197,0.962962962962963,0.655737704918033,0.814814814814815,"1","orthodox"
"1037",27,21,165,168,170,168,115,115,40,14,15,0,31,11,6,-3,2,0,0,0,0,0,0.727272727272727,1,0.563636363636364,0.785714285714286,"1","orthodox"
"703",39,22,163,178,168,178,139,140,55,12,11,0,41,5,17,-15,-10,-1,1,0,0,0,0.833333333333333,1,0.621212121212121,0.416666666666667,"1","orthodox"
"17",25,27,187,185,192,173,159,163,24,22,0,0,12,7,-2,2,19,-4,0,0,0,0,1,1,0.5,0.318181818181818,"1","orthodox"
"160",32,33,183,183,183,190,230,225,13,25,5,4,9,20,-1,0,-7,5,0,0,0,0,0.722222222222222,0.862068965517241,0.5,0.689655172413793,"1","orthodox"
"2471",30,30,173,183,165,188,159,159,25,18,4,10,11,12,0,-10,-23,0,0,0,0,0,0.862068965517241,0.642857142857143,0.379310344827586,0.428571428571429,"1","orthodox"
"121",30,41,203,196,208,207,250,259,15,37,1,3,13,25,-11,7,1,-9,0,1,0,0,0.9375,0.925,0.8125,0.625,"1","orthodox"
"180",20,23,170,165,170,168,135,135,4,0,1,2,2,0,-3,5,2,0,0,0,0,0,0.8,0,0.4,0,"1","southpaw"
"433",31,33,179,171,191,188,202,220,66,119,12,15,54,70,-2,8,3,-18,0,0,0,1,0.846153846153846,0.888059701492537,0.692307692307692,0.522388059701492,"1","orthodox"
"684",23,30,165,168,173,165,114,114,30,40,1,0,27,24,-7,-3,8,0,0,0,0,0,0.967741935483871,1,0.870967741935484,0.6,"1","orthodox"
"631",23,23,171,160,187,165,136,136,17,24,1,2,11,19,0,11,22,0,0,0,0,0,0.944444444444444,0.923076923076923,0.611111111111111,0.730769230769231,"1","orthodox"
"312",33,28,171,173,178,183,139,140,39,33,6,0,30,22,5,-2,-5,-1,0,0,0,0,0.866666666666667,1,0.666666666666667,0.666666666666667,"1","orthodox"
"809",34,24,185,193,193,208,199,222,39,48,10,6,23,29,10,-8,-15,-23,0,0,0,1,0.795918367346939,0.888888888888889,0.469387755102041,0.537037037037037,"1","orthodox"
"510",25,24,171,173,175,178,145,154,190,58,31,9,50,25,1,-2,-3,-9,0,0,0,0,0.85972850678733,0.865671641791045,0.226244343891403,0.373134328358209,"1","Unknown"
"734",28,28,166,170,168,173,122,122,34,26,1,0,17,16,0,-4,-5,0,0,0,0,0,0.971428571428571,1,0.485714285714286,0.615384615384615,"1","orthodox"
"412",34,33,177,185,180,191,160,160,47,33,6,2,34,25,1,-8,-11,0,0,0,0,0,0.886792452830189,0.942857142857143,0.641509433962264,0.714285714285714,"1","orthodox"
"4462",38,33,170,178,168,188,158,160,85,35,7,1,61,25,5,-8,-20,-2,1,0,0,0,0.923913043478261,0.972222222222222,0.66304347826087,0.694444444444444,"1","orthodox"
"540",24,26,185,183,189,193,192,182,214,31,10,8,108,10,-2,2,-4,10,0,0,0,0,0.955357142857143,0.794871794871795,0.482142857142857,0.256410256410256,"1","orthodox"
"699",35,33,191,183,203,201,225,210,41,57,5,7,33,55,2,8,2,15,1,0,1,0,0.891304347826087,0.890625,0.717391304347826,0.859375,"1","orthodox"
"137",22,25,180,178,180,170,148,148,12,10,0,2,10,5,-3,2,10,0,0,0,0,0,1,0.833333333333333,0.833333333333333,0.416666666666667,"1","orthodox"
"345",34,25,171,188,188,193,198,203,130,40,19,6,75,22,9,-17,-5,-5,0,0,0,0,0.87248322147651,0.869565217391304,0.503355704697987,0.478260869565217,"1","orthodox"
"956",24,25,160,163,163,155,120,121,57,4,8,1,21,1,-1,-3,8,-1,0,0,0,0,0.876923076923077,0.8,0.323076923076923,0.2,"1","orthodox"
"570",27,24,175,173,183,184,159,161,33,24,10,1,12,16,3,2,-1,-2,0,0,0,0,0.767441860465116,0.96,0.27906976744186,0.64,"1","Unknown"
"92",32,31,171,170,182,168,139,140,18,16,2,0,7,10,1,1,14,-1,0,0,0,0,0.9,1,0.35,0.625,"1","orthodox"
"660",23,23,183,173,187,180,155,159,98,77,6,11,49,16,0,10,7,-4,0,0,0,0,0.942307692307692,0.875,0.471153846153846,0.181818181818182,"1","Unknown"
"1035",27,25,168,175,165,178,131,131,8,8,0,1,3,4,2,-7,-13,0,0,0,0,0,1,0.888888888888889,0.375,0.444444444444444,"1","orthodox"
"419",31,32,171,173,169,173,140,140,89,48,0,2,75,39,-1,-2,-4,0,0,0,0,0,1,0.96,0.842696629213483,0.78,"1","orthodox"
"1011",26,36,160,165,165,157,114,115,20,35,1,7,14,29,-10,-5,8,-1,0,1,0,0,0.952380952380952,0.833333333333333,0.666666666666667,0.69047619047619,"1","orthodox"
"1028",40,25,175,175,183,178,165,165,49,6,10,0,46,2,15,0,5,0,1,0,0,0,0.830508474576271,1,0.779661016949153,0.333333333333333,"1","orthodox"
"614",26,23,173,168,188,169,135,135,24,28,1,2,15,24,3,5,19,0,0,0,0,0,0.96,0.933333333333333,0.6,0.8,"1","orthodox"
"860",30,26,178,184,175,178,155,148,25,17,7,11,17,10,4,-6,-3,7,0,0,0,0,0.78125,0.607142857142857,0.53125,0.357142857142857,"1","Unknown"
"65",31,22,173,161,176,162,115,115,36,18,12,4,24,7,9,12,14,0,0,0,0,0,0.75,0.818181818181818,0.5,0.318181818181818,"1","southpaw"
"940",37,25,183,183,191,188,176,180,12,19,2,3,4,5,12,0,3,-4,1,0,0,0,0.857142857142857,0.863636363636364,0.285714285714286,0.227272727272727,"1","southpaw"
"543",21,27,165,163,173,168,120,126,23,92,3,9,5,33,-6,2,5,-6,0,0,0,0,0.884615384615385,0.910891089108911,0.192307692307692,0.326732673267327,"1","Unknown"
"458",24,23,163,163,165,170,133,136,95,59,11,5,30,4,1,0,-5,-3,0,0,0,0,0.89622641509434,0.921875,0.283018867924528,0.0625,"1","orthodox"
"705",37,18,175,182,183,187,178,165,108,23,42,2,52,9,19,-7,-4,13,1,0,0,0,0.72,0.92,0.346666666666667,0.36,"1","orthodox"
"191",19,26,175,170,175,188,135,135,22,25,0,2,18,15,-7,5,-13,0,0,0,0,0,1,0.925925925925926,0.818181818181818,0.555555555555556,"1","southpaw"
"836",32,30,179,171,187,176,134,155,40,82,20,42,15,11,2,8,11,-21,0,0,0,1,0.666666666666667,0.661290322580645,0.25,0.0887096774193548,"1","Unknown"
"2731",37,24,168,175,178,180,147,149,14,15,15,3,12,11,13,-7,-2,-2,1,0,0,0,0.482758620689655,0.833333333333333,0.413793103448276,0.611111111111111,"1","orthodox"
"782",25,25,165,160,173,160,112,112,33,30,2,1,22,23,0,5,13,0,0,0,0,0,0.942857142857143,0.967741935483871,0.628571428571429,0.741935483870968,"1","orthodox"
"781",26,26,192,191,198,196,217,216,18,24,1,0,12,20,0,1,2,1,0,0,0,0,0.947368421052632,1,0.631578947368421,0.833333333333333,"1","orthodox"
"901",36,25,187,191,192,198,190,188,26,16,12,1,24,13,11,-4,-6,2,1,0,0,0,0.684210526315789,0.941176470588235,0.631578947368421,0.764705882352941,"1","orthodox"
"105",28,35,173,180,171,188,146,148,23,30,1,9,7,19,-7,-7,-17,-2,0,1,0,0,0.958333333333333,0.769230769230769,0.291666666666667,0.487179487179487,"1","southpaw"
"592",23,20,157,168,160,178,133,133,70,57,15,4,25,8,3,-11,-18,0,0,0,0,0,0.823529411764706,0.934426229508197,0.294117647058824,0.131147540983607,"1","Unknown"
"869",24,26,175,189,183,185,216,206,49,36,16,21,32,16,-2,-14,-2,10,0,0,0,0,0.753846153846154,0.631578947368421,0.492307692307692,0.280701754385965,"1","orthodox"
"5451",28,26,175,170,183,175,152,153,68,105,5,1,26,50,2,5,8,-1,0,0,0,0,0.931506849315068,0.990566037735849,0.356164383561644,0.471698113207547,"1","orthodox"
"229",19,23,173,170,175,170,121,120,1,3,0,0,0,0,-4,3,5,1,0,0,0,0,1,1,0,0,"1","orthodox"
"209",42,25,163,163,173,160,138,132,11,10,49,5,2,4,17,0,13,6,1,0,0,0,0.183333333333333,0.666666666666667,0.0333333333333333,0.266666666666667,"1","orthodox"
"949",29,23,173,175,173,178,135,135,16,18,12,0,9,14,6,-2,-5,0,0,0,0,0,0.571428571428571,1,0.321428571428571,0.777777777777778,"1","orthodox"
"544",26,34,173,175,178,183,158,160,90,106,13,11,39,36,-8,-2,-5,-2,0,0,0,0,0.87378640776699,0.905982905982906,0.378640776699029,0.307692307692308,"1","orthodox"
"1000",26,21,178,171,178,165,146,144,23,16,7,5,11,5,5,7,13,2,0,0,0,0,0.766666666666667,0.761904761904762,0.366666666666667,0.238095238095238,"1","Unknown"
"442",25,37,170,165,175,173,130,130,41,37,2,3,23,26,-12,5,2,0,0,1,0,0,0.953488372093023,0.925,0.534883720930233,0.65,"1","orthodox"
"876",21,28,175,163,170,160,126,127,19,21,0,21,15,14,-7,12,10,-1,0,0,0,0,1,0.5,0.789473684210526,0.333333333333333,"1","orthodox"
"439",26,23,174,179,173,185,140,140,41,22,0,0,31,20,3,-5,-12,0,0,0,0,0,1,1,0.75609756097561,0.909090909090909,"1","orthodox"
"704",30,24,163,163,164,163,125,126,75,33,12,4,41,10,6,0,1,-1,0,0,0,0,0.862068965517241,0.891891891891892,0.471264367816092,0.27027027027027,"1","orthodox"
"591",20,21,171,170,175,180,126,126,20,29,1,5,19,22,-1,1,-5,0,0,0,0,0,0.952380952380952,0.852941176470588,0.904761904761905,0.647058823529412,"1","orthodox"
"953",25,25,165,163,174,163,125,130,26,41,5,4,7,14,0,2,11,-5,0,0,0,0,0.838709677419355,0.911111111111111,0.225806451612903,0.311111111111111,"1","orthodox"
"451",22,20,171,174,183,183,151,151,17,24,1,2,6,7,2,-3,0,0,0,0,0,0,0.944444444444444,0.923076923076923,0.333333333333333,0.269230769230769,"1","orthodox"
"464",18,21,165,164,175,160,133,130,44,67,15,18,16,8,-3,1,15,3,0,0,0,0,0.745762711864407,0.788235294117647,0.271186440677966,0.0941176470588235,"1","orthodox"
"271",18,17,188,175,190,175,175,171,4,1,3,0,2,1,1,13,15,4,0,0,0,0,0.571428571428571,1,0.285714285714286,1,"1","orthodox"
"528",22,20,182,185,185,189,170,173,50,109,12,8,10,40,2,-3,-4,-3,0,0,0,0,0.806451612903226,0.931623931623932,0.161290322580645,0.341880341880342,"1","orthodox"
"109",28,35,173,180,171,188,146,148,23,30,1,9,7,19,-7,-7,-17,-2,0,1,0,0,0.958333333333333,0.769230769230769,0.291666666666667,0.487179487179487,"1","southpaw"
"8681",24,22,175,187,183,222,216,185,49,46,17,13,32,15,2,-12,-39,31,0,0,1,0,0.742424242424242,0.779661016949153,0.484848484848485,0.254237288135593,"1","orthodox"
"93",26,30,168,171,168,182,140,140,17,15,0,1,11,7,-4,-3,-14,0,0,0,0,0,1,0.9375,0.647058823529412,0.4375,"1","orthodox"
"563",25,27,166,168,174,170,115,115,25,26,0,1,24,16,-2,-2,4,0,0,0,0,0,1,0.962962962962963,0.96,0.592592592592593,"1","orthodox"
"8081",21,28,175,180,183,188,185,220,31,61,9,37,18,16,-7,-5,-5,-35,0,0,0,1,0.775,0.622448979591837,0.45,0.163265306122449,"1","orthodox"
"8191",39,36,188,193,208,203,233,220,41,20,7,3,31,17,3,-5,5,13,1,1,0,0,0.854166666666667,0.869565217391304,0.645833333333333,0.739130434782609,"1","orthodox"
"865",23,23,175,173,183,178,135,135,14,12,1,1,9,8,0,2,5,0,0,0,0,0,0.933333333333333,0.923076923076923,0.6,0.615384615384615,"1","orthodox"
"10341",28,25,193,188,208,193,255,201,36,27,8,5,25,23,3,5,15,54,0,0,1,0,0.818181818181818,0.84375,0.568181818181818,0.71875,"1","orthodox"
"770",42,23,171,175,178,170,149,149,48,13,9,5,34,8,19,-4,8,0,1,0,0,0,0.842105263157895,0.722222222222222,0.596491228070175,0.444444444444444,"1","orthodox"
"581",32,26,168,170,173,173,140,136,75,31,20,2,31,15,6,-2,0,4,0,0,0,0,0.789473684210526,0.939393939393939,0.326315789473684,0.454545454545455,"1","orthodox"
"878",22,25,180,183,188,193,201,178,42,77,19,30,23,22,-3,-3,-5,23,0,0,1,0,0.688524590163934,0.719626168224299,0.377049180327869,0.205607476635514,"1","Unknown"
"915",29,24,180,185,190,196,169,168,5,9,0,0,4,3,5,-5,-6,1,0,0,0,0,1,1,0.8,0.333333333333333,"1","Unknown"
"965",24,25,170,179,175,170,127,127,29,19,0,3,14,12,-1,-9,5,0,0,0,0,0,1,0.863636363636364,0.482758620689655,0.545454545454545,"1","southpaw"
"234",28,37,188,193,190,203,254,252,20,25,9,17,13,11,-9,-5,-13,2,0,1,0,0,0.689655172413793,0.595238095238095,0.448275862068966,0.261904761904762,"1","southpaw"
"587",22,28,189,180,206,188,204,195,26,60,5,37,22,16,-6,9,18,9,0,0,0,0,0.838709677419355,0.618556701030928,0.709677419354839,0.164948453608247,"1","orthodox"
"325",34,33,177,185,180,191,160,160,47,33,6,2,34,25,1,-8,-11,0,0,0,0,0,0.886792452830189,0.942857142857143,0.641509433962264,0.714285714285714,"1","orthodox"
"40",29,30,169,177,174,183,147,147,28,27,2,8,22,17,-1,-8,-9,0,0,0,0,0,0.933333333333333,0.771428571428571,0.733333333333333,0.485714285714286,"1","orthodox"
"370",27,28,163,168,165,170,137,145,122,53,17,11,39,21,-1,-5,-5,-8,0,0,0,0,0.877697841726619,0.828125,0.280575539568345,0.328125,"1","orthodox"
"688",27,24,175,178,185,185,158,158,30,62,4,7,15,24,3,-3,0,0,0,0,0,0,0.882352941176471,0.898550724637681,0.441176470588235,0.347826086956522,"1","Unknown"
"970",40,38,193,198,201,203,242,228,41,25,6,4,33,16,2,-5,-2,14,1,1,0,0,0.872340425531915,0.862068965517241,0.702127659574468,0.551724137931034,"1","orthodox"
"77",25,25,170,180,170,183,138,139,15,13,0,6,7,5,0,-10,-13,-1,0,0,0,0,1,0.684210526315789,0.466666666666667,0.263157894736842,"1","orthodox"
"210",27,30,175,178,178,180,140,140,17,17,6,6,3,5,-3,-3,-2,0,0,0,0,0,0.739130434782609,0.739130434782609,0.130434782608696,0.217391304347826,"1","orthodox"
"7731",24,26,189,178,191,180,172,178,36,68,8,12,22,21,-2,11,11,-6,0,0,0,0,0.818181818181818,0.85,0.5,0.2625,"1","orthodox"
"697",33,27,166,167,171,171,130,130,61,37,5,6,43,27,6,-1,0,0,0,0,0,0,0.924242424242424,0.86046511627907,0.651515151515151,0.627906976744186,"1","orthodox"
"937",21,25,163,165,165,168,108,108,23,17,3,4,18,13,-4,-2,-3,0,0,0,0,0,0.884615384615385,0.80952380952381,0.692307692307692,0.619047619047619,"1","orthodox"
"260",25,28,163,167,168,168,112,111,1,1,0,1,1,0,-3,-4,0,1,0,0,0,0,1,0.5,1,0,"1","southpaw"
"641",27,37,183,183,185,185,154,154,21,40,0,3,5,29,-10,0,0,0,0,1,0,0,1,0.930232558139535,0.238095238095238,0.674418604651163,"1","orthodox"
"1024",28,28,168,169,173,173,134,135,34,28,1,1,19,20,0,-1,0,-1,0,0,0,0,0.971428571428571,0.96551724137931,0.542857142857143,0.689655172413793,"1","Unknown"
"966",31,35,178,191,183,208,250,228,31,31,13,5,18,23,-4,-13,-25,22,0,1,1,0,0.704545454545455,0.861111111111111,0.409090909090909,0.638888888888889,"1","orthodox"
"170",23,23,165,164,164,170,118,118,28,42,1,1,20,27,0,1,-6,0,0,0,0,0,0.96551724137931,0.976744186046512,0.689655172413793,0.627906976744186,"1","southpaw"
"947",28,23,163,173,157,182,134,134,38,21,4,2,24,11,5,-10,-25,0,0,0,0,0,0.904761904761905,0.91304347826087,0.571428571428571,0.478260869565217,"1","orthodox"
"407",26,43,189,185,191,191,170,169,34,48,0,5,30,32,-17,4,0,1,0,1,0,0,1,0.905660377358491,0.882352941176471,0.60377358490566,"1","orthodox"
"387",26,32,188,183,198,185,190,201,21,83,2,10,16,46,-6,5,13,-11,0,0,0,0,0.91304347826087,0.89247311827957,0.695652173913043,0.494623655913978,"1","orthodox"
"328",31,29,191,191,198,203,221,210,41,29,1,1,31,23,2,0,-5,11,0,0,0,0,0.976190476190476,0.966666666666667,0.738095238095238,0.766666666666667,"1","orthodox"
"566",31,48,195,192,203,199,253,230,36,75,0,4,30,68,-17,3,4,23,0,1,1,0,1,0.949367088607595,0.833333333333333,0.860759493670886,"1","orthodox"
"569",26,22,166,157,170,160,126,124,72,28,3,4,66,20,4,9,10,2,0,0,0,0,0.96,0.875,0.88,0.625,"1","orthodox"
"777",40,30,192,193,198,201,239,238,46,31,7,3,31,27,10,-1,-3,1,1,0,0,0,0.867924528301887,0.911764705882353,0.584905660377358,0.794117647058823,"1","orthodox"
"666",29,31,170,184,178,178,175,175,38,40,2,0,27,30,-2,-14,0,0,0,0,0,0,0.95,1,0.675,0.75,"1","orthodox"
"653",48,29,174,180,178,183,148,148,31,27,3,3,19,18,19,-6,-5,0,1,0,0,0,0.911764705882353,0.9,0.558823529411765,0.6,"1","orthodox"
"523",33,22,182,185,185,198,191,191,118,59,28,25,13,14,11,-3,-13,0,0,0,0,0,0.808219178082192,0.702380952380952,0.089041095890411,0.166666666666667,"1","orthodox"
